出現形	正解	予測
副腎原発神経芽腫	副腎神経芽腫	紅斑性間擦疹
Ｗｅｎｃｋｅｂａｃｈ型房室ブロック	ウェンケバッハ型第２度房室ブロック	膀胱白板症
痰貯留多	喀痰	肺活量減少
皮膚リンパ腫	菌状息肉症	糖原病
個細胞壊死	壊死	多尿
左大腿骨顆上骨折	大腿骨外顆骨折	多尿
病原性大腸菌Ｏ−１５７感染性腸炎	病原性大腸菌感染症	胸膜播種
口腔粘膜浮腫	浮腫	視路疾患
腟粘膜発赤	発赤	完全大血管転位症１型
レム睡眠行動異常症	レム睡眠行動障害	肺活量減少
閉塞性膵炎	膵炎	眼瞼異物残留
脱髄性疾患	脱髄疾患	床形態歯周治療用装置破損
多発性脾膿瘍	脾膿瘍	前足部痛
間質性肺水腫	肺水腫	ＨＴＬＶ−１感染症
無動性無言	無動性無言症	内側半月板断裂
舌扁平上皮癌	舌癌	ＴＦＣＣ損傷
両側肺門部浸潤影	胸部異常陰影	手掌部皮下腫瘤
軽度悪心	悪心	内側半月板断裂
慢性活動性ＥＢウルス感染症	ＥＢウイルス感染症	化膿性リンパ節炎
蛋白尿減少	蛋白尿	胸膜播種
脳障害	脳症	内反小趾
中心性奬液性網脈絡膜症	中心性漿液性網脈絡膜症	産科的創傷の血腫
左一側性反回神経麻痺	一側性反回神経麻痺	グラム陽性桿菌感染症
イレウス様	イレウス	胸膜播種
膵炎併発	膵炎	視路疾患
ｈｅｍｏｐｈａｇｏｃｙｔｉｃ　ｓｙｎｄｒｏｍｅ	血球貪食症候群	胸膜播種
抗癌剤漏出	薬剤漏出性皮膚障害	線維筋痛症
水痘帯状疱疹	帯状疱疹	化膿性リンパ節炎
ｓｙｓｔｅｍｉｃ　ｍａｓｔｏｃｙｔｏｓｉｓ	肥満細胞腫症	胸膜播種
発汗多量	多汗症	化膿性リンパ節炎
早発黄疸	早発性黄疸	大動脈弁狭窄症兼僧帽弁閉鎖不全症兼三尖弁閉鎖不全症
急性細菌性気管支炎	急性気管支炎	膀胱白板症
右上葉肺小細胞癌	上葉肺大細胞癌	抗生物質起因性腸炎
腟癌１期	腟癌	抗生物質起因性腸炎
会陰部発赤	発赤	化膿性リンパ節炎
嚥下時痛軽度	嚥下痛	症候性そう痒症
左顔面血管腫	顔面血管腫	若年者キーンベック病
鼻汁多く	鼻汁	気道閉塞
口腔内出血痕	口腔出血	内反小趾
ＳＩＡＤ	抗利尿ホルモン不適合分泌症候群	胸膜播種
夜両足痛	足痛	症候性そう痒症
左後頭葉梗塞	脳梗塞	産科的創傷の血腫
左内眼角基底細胞癌	眼角基底細胞癌	若年者キーンベック病
難治性イレウス	イレウス	胸膜播種
副鼻腔腫瘍	鼻副鼻腔腫瘍	大動脈弁狭窄症兼三尖弁閉鎖不全症
大腸菌菌血症	菌血症	胸膜播種
右前頭葉出血	脳出血	内反小趾
左膝部痛	膝窩部痛	エーテル中毒症
仙椎陳旧性骨折	陳旧性骨折	第４趾有棘細胞癌
乳癌既往	乳癌	抗生物質起因性腸炎
軽度咽頭発赤	咽頭発赤	内反小趾
痙攣起	痙攣	内反小趾
下肢浮腫圧痕	下肢浮腫	内反小趾
左側頬部腫脹	頬部腫脹	大動脈弁狭窄症兼三尖弁閉鎖不全症
心室中隔穿孔	心室中隔欠損症	近視
四肢浮腫軽度	四肢浮腫	内反小趾
大腸ポリープ　ポリペク後	大腸ポリープ	胸膜播種
腰椎椎体椎間板炎	腰椎椎間板炎	総胆管のう腫
左下葉肺炎悪化	大葉性肺炎	網膜静脈血栓症
ぼんやり感持続	反応性低下	症候性そう痒症
右鼠径部痛	鼡径部痛	大動脈弁狭窄症兼僧帽弁閉鎖不全症兼三尖弁閉鎖不全症
皮疹不変	発疹	内反小趾
創部痛	術創部痛	内反小趾
軽度右気胸	気胸	症候性そう痒症
腸閉塞歴	イレウス	無症候性原発性胆汁性肝硬変
左大腿骨骨折	大腿骨骨折	多尿
紅斑局面多発	紅斑症	多尿
下部進行食道癌	食道癌	抗生物質起因性腸炎
無γグロブリン血症	無ガンマグロブリン血症	傍矢状洞髄膜腫
子宮頸管ポリープ切除	子宮頚管ポリープ	産科的創傷の血腫
手首疼痛	疼痛	症候性そう痒症
ｓｐｌｅｎｉｃ　ｍａｒｇｉｎａｌ　ｚｏｎｅ　ｌｙｍｐｈｏｍａ	脾辺縁帯リンパ腫	胸膜播種
体動時息ぎれ	労作時呼吸困難	内反小趾
一部浮腫	浮腫	内反小趾
ふらつき注意	よろめき歩行	膀胱白板症
左中耳炎	中耳炎	大動脈弁狭窄症兼僧帽弁閉鎖不全症兼三尖弁閉鎖不全症
胃食道逆流症状	胃食道逆流症	気道閉塞
両側卵巣子宮内膜症性嚢胞	卵巣子宮内膜症のう胞	肝門部リンパ節転移
新出肝転移	転移性肝癌	前足部痛
脊椎カリエス	脊椎結核	床形態歯周治療用装置破損
行動障害	素行障害	症候性そう痒症
妊娠性糖尿病	妊娠糖尿病	視路疾患
小豆大紅斑	紅斑症	内反小趾
ＦＳＧＳ	巣状糸球体硬化症	視路疾患
左寛骨臼骨折	寛骨臼骨折	第４趾有棘細胞癌
原発性両眼内悪性リンパ腫	眼窩悪性リンパ腫	正中頚のう胞
腹腔鏡補助下子宮筋腫核	子宮筋腫	前足部痛
両下肢静脈血栓	下肢静脈血栓症	内反小趾
神経根障害	神経根炎	大動脈弁狭窄症兼僧帽弁閉鎖不全症兼三尖弁閉鎖不全症
クモ膜下出血	くも膜下出血	内反小趾
後鼻汁症候群	後鼻漏	気道閉塞
糖尿病性腎症１期	腎性糖尿	眼瞼異物残留
左臀部慢性膿皮症	慢性膿皮症	足底部打撲傷
メサンギウム増殖性腎炎	メサンギウム増殖性糸球体腎炎	化膿性リンパ節炎
左前頭葉心原性脳梗塞	心原性脳塞栓症	産科的創傷の血腫
閉塞性尿路感染	尿路感染症	温熱じんま疹
顔面蝶形紅斑	ＬＥ蝶形皮疹	多尿
上行結腸癌肝転移	転移性肝癌	前足部痛
仙骨部色素沈着	色素異常症	多尿
肥満糖尿病	糖尿病	視路疾患
左肩痛み	肩部筋痛	内反小趾
ＰＳＶＴ発作	発作性上室頻拍	化膿性リンパ節炎
顎変形症術後顎変形症	顎変形症	内反小趾
ＤＭＮ　２期	糖尿病	胸膜播種
労作時胸部絞扼感	胸内苦悶	大動脈弁狭窄症兼僧帽弁閉鎖不全症兼三尖弁閉鎖不全症
右膝変形	変形性膝関節症	多尿
指趾潰瘍	趾皮膚潰瘍	多尿
２型食道癌	食道癌	突発性咽頭出血
骨性腫瘤	腫瘤	第４趾有棘細胞癌
外傷性脊髄損傷	脊髄損傷	産科的創傷の血腫
下肢結節性紅斑	結節性紅斑	多尿
左動眼神経麻痺	動眼神経麻痺	大動脈弁狭窄症兼僧帽弁閉鎖不全症兼三尖弁閉鎖不全症
家族性海綿状血管腫	海綿状血管腫	糖原病
術中直腸損傷	直腸損傷	顎下腺萎縮
下肢動脈瘤	下肢の動脈瘤	内反小趾
精神病様症状	精神病	化膿性リンパ節炎
項頸部痛	頚部痛	内反小趾
頸部白斑	白斑	内反小趾
左大腿骨転子部粉砕骨折	転子下骨折	多尿
最近眠気	非器質性過眠症	症候性そう痒症
ＶＨＤ	心臓弁膜症	胸膜播種
夜頻尿	夜間頻尿症	視路疾患
回盲部炎	回盲部憩室炎	膀胱白板症
重症肺血栓塞栓症	肺塞栓症	子宮線維症
左歯痛	歯痛	症候性そう痒症
腹膜播種切除	腹膜播種	肝腫瘤
右乳突蜂巣	乳様突起炎	内反小趾
右肺尖部気胸	気胸	斜台部脊索腫
骨盤内子宮内膜症	子宮内膜症	急性小腸虚血
左頬部痛	頬部痛	角膜上皮損傷
局麻薬アレルギー	薬物過敏症	化膿性リンパ節炎
肺クリプトコックス症	急性肺クリプトコッカス症	胸膜播種
右肩関節亜脱臼半横指	肩関節亜脱臼	第４趾有棘細胞癌
慢性蕁麻疹	慢性じんま疹	膀胱白板症
マラセチア毛嚢炎	マラセチア毛包炎	ＨＴＬＶ−１感染症
高分化型漿液性腺癌	癌	突発性咽頭出血
腫瘍床	腫瘍	床形態歯周治療用装置破損
左膀胱尿管逆流症	膀胱尿管逆流	眼瞼異物残留
外側疼痛	疼痛	症候性そう痒症
卵巣癌再発卵巣癌	卵巣癌	若年者キーンベック病
錐体路病変	錐体外路系疾患	慢性歯肉炎
リンパ球性白血病	リンパ性白血病	急性小腸虚血
クラミジア感染	クラミジア感染症	先天性限局白皮症
奬液性嚢胞腺腫	膵漿液性のう胞腺腫	突発性咽頭出血
夜間倦怠感	倦怠感	症候性そう痒症
脳血栓塞栓症	脳血管閉塞性脳梗塞	手掌部皮下腫瘤
左リウマチ性肘関節症	関節リウマチ・膝関節	甲状腺出血
右下腿潰瘍感染	下腿皮膚潰瘍	多尿
気分不快時	悪心	症候性そう痒症
問題なし前立腺肥大	前立腺肥大症	視路疾患
急性パルボウイルスＢ１９感染症	パルボウイルス感染症	膀胱白板症
脂肪性腫瘤	脂肪腫	中指屈筋腱癒着
ウィルス性肺炎	肺炎	むちうち損傷
類円形紅斑	紅斑症	内反小趾
書字不能	書痙	症候性そう痒症
肺動脈狭窄	肺動脈狭窄症	顔面メルケル細胞癌
夜間不眠状態	不眠症	躁病発作
熱型	発熱	肺活量減少
骨盤内充実性腫瘍	骨盤腫瘍	床形態歯周治療用装置破損
夢遊病	夢遊症	化膿性リンパ節炎
脊髄小脳変性症６型	脊髄小脳変性症	慢性歯肉炎
左内頚動脈閉塞	内頚動脈閉塞症	産科的創傷の血腫
両側角乾燥性結膜炎	結膜炎	慢性肺気腫
脳虚血症状	脳虚血症	内側半月板断裂
微熱持続	微熱	膀胱白板症
夕方浮腫	浮腫	視路疾患
眼性疲労	眼精疲労	大動脈弁狭窄症兼僧帽弁閉鎖不全症兼三尖弁閉鎖不全症
直腸肛門奇形	鎖肛	胸膜播種
右大腿部腫瘍	大腿悪性軟部腫瘍	床形態歯周治療用装置破損
頚椎症神経根症	頚椎症性神経根症	産科的創傷の血腫
壊死性遊走性紅斑	遊走性紅斑	膀胱白板症
睡眠障害招くリスク	睡眠障害	化膿性リンパ節炎
上大静脈血栓	静脈血栓症	内反小趾
骨盤内ＬＮ転移	骨盤内リンパ節転移	床形態歯周治療用装置破損
ＰＫＤ	多発性のう胞腎	多尿
分水嶺脳梗塞	脳梗塞	産科的創傷の血腫
上皮性腫瘍	腫瘤	足底部打撲傷
大球性正色素貧血	大球性貧血	慢性歯肉炎
挙上空腸穿孔	腸穿孔	胸膜播種
腸管アメーバ感染症	腸アメーバ症	膀胱乳頭腫
放射線性皮膚炎	放射線皮膚炎	足底部打撲傷
肛門周囲びらん	外痔びらん	ヘルペスウイルス性湿疹
髄膜炎徴候	髄膜炎	流産後尿細管壊死
胸部不快	胸内苦悶	症候性そう痒症
下葉肺炎	肺炎	むちうち損傷
右足根部粉砕骨折	粉砕骨折	多尿
蛋白漏出胃腸症	蛋白漏出性胃腸症	胸膜播種
左大脳陳旧性ラクナ梗塞	陳旧性ラクナ梗塞	産科的創傷の血腫
出血多量	急性大量出血	内側半月板断裂
腹水多量	腹水症	膀胱白板症
腸間膜リンパ管腫	リンパ管腫	臍帯卵膜付着による新生児の障害
右卵巣悪性腫瘍	卵巣悪性腫瘍	臍帯卵膜付着による新生児の障害
糖尿病（２型）	２型糖尿病	胸膜播種
化膿性胸鎖関節炎	化膿性関節炎・胸鎖関節	床形態歯周治療用装置破損
右乳腺線維腫症	線維腫	肝門部リンパ節転移
肺野鬱血像	肺野異常陰影	完全大血管転位症１型
児嘔気	嘔気	視路疾患
尿閉歴	尿閉	眼瞼異物残留
陰嚢びらん	陰のうびらん	視路疾患
精神的ショック	ショック	甲状腺出血
右上腕骨外側上顆炎	外側上顆炎	淋菌性腹膜炎
子宮頚上皮内癌	子宮頚部上皮内癌	足底部打撲傷
難治性非定型性抗酸菌症	非結核性抗酸菌症	肺活量減少
軽度腹水	腹水症	総胆管のう腫
湿疹様	湿疹	斜台部脊索腫
大後頭孔狭窄	軟骨形成不全症	第４趾有棘細胞癌
熱型変化	発熱	肺活量減少
右無機能腎	無機能腎	視路疾患
月経痛コントロール不十分	月経痛	内反小趾
左鎖骨下動脈閉塞	鎖骨下動脈閉塞症	産科的創傷の血腫
右ＤＶＴ	深部静脈血栓症	斜台部脊索腫
非特異的胸痛	胸痛	症候性そう痒症
Ａｅｒｏｍｏｎａｓ　ｈｙｄｒｏｐｈｉｌａ敗血症	敗血症	甲状腺出血
重症細菌性敗血症	敗血症	膀胱白板症
逆行性健忘	逆向性健忘	症候性そう痒症
腹直筋膜下血腫	筋肉内血腫	床形態歯周治療用装置破損
関連腎臓病	腎疾患	無機質代謝障害
認知症様症状	認知症	化膿性リンパ節炎
顎骨骨折	下顎骨骨折	多尿
高度大動脈弁狭窄	大動脈弁狭窄症	内反小趾
右顔面骨骨折	顔面骨骨折	多尿
炎症性粉瘤	粉瘤	多尿
左腰部疼痛	腰痛症	内反小趾
ＨＣＶ重複感染症	Ｃ型肝炎ウイルス感染	化膿性リンパ節炎
脂質異常症（＋）	脂質異常症	視路疾患
上腹部圧痛	腹部圧痛	エーテル中毒症
両側椎骨動脈瘤	椎骨動脈瘤	産科的創傷の血腫
非ケトン性高血糖	高血糖高浸透圧症候群	膀胱白板症
Ｙｅｒｓｉｎｉａ腸炎	エルシニア腸炎	胸膜播種
声帯浮腫	声帯炎	内反小趾
誤嚥性肺炎併発	誤嚥性肺炎	肺活量減少
咳嗽持続	咳	症候性そう痒症
左側下顎骨嚢胞	顎骨のう胞	サイトメガロウイルス脊髄炎
右末梢前庭障害	末梢前庭障害	グラム陽性桿菌感染症
胆管閉鎖症	胆管閉塞症	眼瞼異物残留
閉塞性動脈硬化症　症状	閉塞性動脈硬化症	産科的創傷の血腫
洞不全	洞不全症候群	突発性咽頭出血
特発性リンパ浮腫	リンパ浮腫	突発性咽頭出血
シャント吻合部狭窄	透析シャント狭窄	アフラトキシン中毒
無気力	無力症	内側半月板断裂
胸骨炎	胸骨周囲炎	床形態歯周治療用装置破損
ナッツアレルギー	ピーナッツアレルギー	膀胱白板症
甲状腺乳頭癌術後再発	甲状腺乳頭癌	若年者キーンベック病
上肢疼痛	疼痛	症候性そう痒症
Ｔｕｒｎｅｒ症候群	ターナー症候群	肺活量減少
肝臓機能障害用	肝機能障害	視路疾患
左心不全徴候	心不全	症候性そう痒症
ＩＰＭＮ癌化	膵管内乳頭粘液性腺癌	抗生物質起因性腸炎
後発頚部転移	頚部転移性腫瘍	産科的創傷の血腫
下痢治	下痢症	外陰損傷
朝方疼痛	疼痛	症候性そう痒症
蜂窩肺形成	蜂窩織炎	胸膜播種
右ＩＣＡ高度狭窄	内頚動脈狭窄症	化膿性リンパ節炎
膵体部嚢胞	膵のう胞	前足部痛
右気管支狭窄	気管支狭窄症	内反小趾
非ヘルペス性辺縁系脳炎	辺縁系脳炎	肺活量減少
無症候性ＶＴ	心室頻拍	化膿性リンパ節炎
好酸球増多	好酸球増加症	化膿性リンパ節炎
口腔清掃	個人衛生の著しいレベル低下	膀胱白板症
両下腿皮膚潰瘍	下腿皮膚潰瘍	多尿
無石性胆嚢炎	胆のう炎	視路疾患
ｓ型ポリープ	ポリープ	静脈瘤性動脈瘤
時折頭痛	頭痛	内反小趾
関節リウマチ発症	関節リウマチ	多尿
残像腫瘍	腫瘍	若年者キーンベック病
両顎下腺腫大	顎下腺肥大	足底部打撲傷
夜間中途覚醒時	睡眠障害	大動脈弁狭窄症兼僧帽弁閉鎖不全症兼三尖弁閉鎖不全症
今朝頭痛	頭痛	内反小趾
眼球偏移	眼球偏位	慢性歯肉炎
腹腔内癒着高度	腹膜癒着	症候性そう痒症
右母指多指症	多指症	症候性そう痒症
薬剤性骨髄抑制	骨髄機能低下	床形態歯周治療用装置破損
肥満	肥満症	視路疾患
網膜中心動脈閉塞	網膜中心動脈閉塞症	産科的創傷の血腫
中枢神経悪性リンパ腫再発	悪性リンパ腫	急性小腸虚血
旅行者下痢症	下痢症	膀胱白板症
右声帯ポリープ	声帯ポリープ	化膿性リンパ節炎
非Ｂ非Ｃ型肝硬変	肝硬変症	視路疾患
頭部皮下結節	皮下結節	多尿
足がむくみ	下肢浮腫	内反小趾
下肢潰瘍	下肢皮膚潰瘍	多尿
難治性胸腹水	難治性腹水	総胆管のう腫
幻覚症状	幻覚	化膿性リンパ節炎
異常腫瘤	腫瘤	内反小趾
未破裂脳動脈瘤コイル塞栓	未破裂脳動脈瘤	産科的創傷の血腫
左下顎骨慢性骨髄炎	慢性顎骨骨髄炎	流産後尿細管壊死
左側頭葉膠芽腫	側頭葉膠芽腫	前足部痛
脳血管障害性パーキンソニズム	脳血管障害性パーキンソン症候群	慢性歯肉炎
右後角脳室内出血	脳室内出血	内反小趾
難治性浮腫	高度浮腫	視路疾患
Ｇｒａｎｕｌｏｍａｔｏｓｉｓ　ｗｉｔｈ　ｐｏｌｙａｎｇｉｉｔｉｓ	多発血管炎性肉芽腫症	胸膜播種
再発脊索腫	脊索腫	糖原病
Ｃ型肝硬変症	Ｃ型肝硬変	眼瞼異物残留
左踵部悪性黒色腫	踵部悪性黒色腫	若年者キーンベック病
未分化癌	癌	抗生物質起因性腸炎
両側副腎悪性リンパ腫	悪性リンパ腫	前腕血栓性静脈炎
帯状疱疹無	帯状疱疹	斜台部脊索腫
左膝痛み	膝関節痛	内反小趾
右下腿痛	下腿痛	症候性そう痒症
気管支喘息症状	気管支喘息	症候性そう痒症
大腿骨内顆骨壊死	特発性大腿骨内顆骨壊死	多尿
炎症性貧血	貧血	総胆管のう腫
両下肢掻痒感	皮膚そう痒症	角膜上皮損傷
右後頭葉脳挫傷	脳挫傷	産科的創傷の血腫
女性化乳房	女性化乳房症	内反小趾
ｍａｓｓ　ｌｅｓｉｏｎ	腫瘤	化膿性リンパ節炎
右大脳半球多発脳梗塞	多発性脳梗塞	産科的創傷の血腫
大動脈弁膜症	大動脈弁弁膜症	産科的創傷の血腫
鎮静困難	興奮状態	症候性そう痒症
再発腫瘤近傍	腫瘤	第４趾有棘細胞癌
右下腿麻痺	下肢麻痺	内反小趾
切除不能多発性肝転移	転移性肝腫瘍	螺旋状食道
腹腔内膿瘍形成	膿瘍	床形態歯周治療用装置破損
発作性上室性頻拍	発作性上室頻拍	甲状腺出血
筋肉痛生	筋肉痛	内反小趾
腰椎滑り症	腰椎すべり症	総胆管のう腫
淡血性胸水	血性胸水	視路疾患
腎被膜下出血	外傷性腎被膜下血腫	視路疾患
仙骨部褥瘡痕	仙骨部褥瘡	糖原病
左肝腫瘍	肝腫瘍	床形態歯周治療用装置破損
非Ｃｌｏｓｔｒｉｄｉｕｍ性ガス壊疽	ガス壊疽	多尿
リンパ腺腫脹	リンパ節腫大	糖原病
心室二段脈	心室性二段脈	産科的創傷の血腫
鼻腔腫瘍摘出	鼻腔腫瘍	肝腫瘤
疼痛時頓用	疼痛	症候性そう痒症
多房性膿瘍	膿瘍	床形態歯周治療用装置破損
右耳介後部痛	耳痛症	角膜上皮損傷
左胸壁腫瘍切除	胸壁腫瘍	多尿
無呼吸症候群	無呼吸発作	症候性そう痒症
右尿管癌	尿管癌	突発性咽頭出血
出血過多	出血	内側半月板断裂
甲状腺嚢腫	甲状腺のう胞	前足部痛
両側浸出性中耳炎	滲出性中耳炎	大動脈弁狭窄症兼僧帽弁閉鎖不全症兼三尖弁閉鎖不全症
覚醒度	麻酔覚醒遅延	症候性そう痒症
高血糖	高血糖症	膀胱白板症
有意弁膜症	弁膜炎	グラム陽性桿菌感染症
胸痛無	胸痛	総胆管のう腫
右下肺野無気肺	無気肺	化膿性リンパ節炎
小脳性失調	小脳性運動失調症	膀胱白板症
好酸球増多症	好酸球増加症	化膿性リンパ節炎
右腎明細胞肉腫	腎明細胞肉腫	前足部痛
甲状腺左葉濾胞腺腫	濾胞性甲状腺腺腫	前足部痛
下位運動ニューロン徴候	運動ニューロン疾患	症候性そう痒症
主幹動脈狭窄	脳動脈狭窄症	産科的創傷の血腫
創部皮下血腫	外傷性皮下血腫	床形態歯周治療用装置破損
掻痒感軽減	そう痒	総胆管のう腫
両肺小結節影	肺野異常陰影	２型糖尿病・関節合併症あり
造影剤アレルギー歴	薬物過敏症	肺活量減少
左眼鼻涙管閉塞症	鼻涙管閉鎖症	気道閉塞
慢性的な抑うつ気分	うつ状態	症候性そう痒症
鼻部異物肉芽腫	皮膚異物肉芽腫	内反小趾
遠隔ＬＮ転移	リンパ節転移	胸膜播種
子宮がん	子宮癌	食道瘢痕
Ｂｉｃｋｅｒｓｔａｆｆ型脳幹脳炎	ビッカースタッフ脳幹脳炎	慢性歯肉炎
睾丸腫脹	精巣腫脹	第４趾有棘細胞癌
右中皮腫	中皮腫	足底部打撲傷
ジベル薔薇色粃糠疹	ジベルばら色粃糠疹	大動脈弁狭窄症兼三尖弁閉鎖不全症
脳実質外腫瘍	腫瘍	若年者キーンベック病
抑鬱感	気うつ	視路疾患
扁桃腺腫大	扁桃肥大	突発性咽頭出血
口内出血	口腔出血	内反小趾
右上方視野欠損	視野欠損	静脈内膜炎
両側臼蓋形成不全症	臼蓋形成不全	内反小趾
進行肝癌	肝癌	前腕血栓性静脈炎
噴門部狭窄	胃狭窄	胸膜播種
突発性腎出血	腎出血	手掌部皮下腫瘤
前股関節症	股関節症	甲状腺出血
多発肝嚢胞	多発性肝のう胞	前腕血栓性静脈炎
過換気状態	過換気症	内側半月板断裂
傍大動脈ＬＮ	大動脈周囲リンパ節転移	慢性歯肉炎
左椎骨動脈低形成	骨髄低形成	内反小趾
左房拡張	心拡大	内反小趾
サルモネラ菌感染症	サルモネラ感染症	皮下唇裂
両側性多発性嚢胞腎	多発性のう胞腎	前腕血栓性静脈炎
化学物質アレルギー	アレルギー	肺活量減少
右手指腫脹	手指腫脹	多尿
右足背発赤	発赤	完全大血管転位症１型
脊柱管高度狭窄	脊柱管狭窄症	気道閉塞
右急性網膜壊死	急性網膜壊死	産科的創傷の血腫
皮膚硬化がまだかなり	新生児皮膚硬化症	内反小趾
口腔内乾燥軽度	口腔乾燥症	斜台部脊索腫
下肢筋痛	下肢筋肉痛	内反小趾
蠕動不良	異常腸音	症候性そう痒症
四肢腱反射亢進	反射亢進	内反小趾
黒色丘疹	丘疹	腎脂肪腫
胸部陰影	胸部異常陰影	完全大血管転位症１型
クモ膜下嚢胞	くも膜のう胞	突発性咽頭出血
２次性糖尿病	二次性糖尿病	視路疾患
Ｈａｅｍｏｐｈｉｌｕｓ　ｉｎｆｌｕｅｎｚａｅ敗血症	敗血症	甲状腺出血
慢性期疼痛	慢性疼痛	症候性そう痒症
右上葉原発肺小細胞癌	小細胞肺癌	抗生物質起因性腸炎
出血源不詳	出血	内側半月板断裂
一般細菌感染	細菌感染症	化膿性リンパ節炎
急性小脳失調症	急性小脳性失調症	サイトメガロウイルス脊髄炎
浸潤癌化所見	癌	抗生物質起因性腸炎
痔核脱出	痔核	第４趾有棘細胞癌
重症膵炎	膵炎	視路疾患
痛みアリ	疼痛	症候性そう痒症
左心室内血栓症	心室内血栓症	手掌部皮下腫瘤
右足疼痛	疼痛	大動脈弁狭窄症兼僧帽弁閉鎖不全症兼三尖弁閉鎖不全症
増殖前網膜症	網膜症	膀胱内異物
傍神経節腫瘍	傍神経節腫	若年者キーンベック病
小腸膀胱瘻	膀胱皮膚瘻	新生児一過性低血糖症
左小細胞肺癌	小細胞肺癌	抗生物質起因性腸炎
少量左胸水	胸水貯留	総胆管のう腫
多発ＨＣＣ再発	肝細胞癌	第４趾有棘細胞癌
結核性嚢腫	結核	床形態歯周治療用装置破損
右大腿骨外顆骨折	大腿骨外顆骨折	多尿
巨大膵仮性嚢胞	仮性膵のう胞	突発性咽頭出血
大腿腫脹	下腿腫脹	内反小趾
全身性ＣＭＶ感染症	サイトメガロウイルス感染症	視路疾患
多発肝内転移	転移性肝腫瘍	手掌有棘細胞癌
右外耳道炎	外耳炎	大動脈弁狭窄症兼僧帽弁閉鎖不全症兼三尖弁閉鎖不全症
両下肢圧痕性浮腫	クインケ浮腫	内反小趾
下部腸間膜動脈出血	動脈性出血	第４趾有棘細胞癌
ＩｇＭ型Ｍ蛋白	単クローン性免疫グロブリン血症	蚕蝕性角膜潰瘍
喘息発作様症状	気管支喘息発作	内反小趾
分食道癌	食道癌	抗生物質起因性腸炎
多少便秘気味	便秘症	膀胱白板症
ポリープ状病変	ポリープ	胸膜播種
既往高血圧	高血圧症	内側半月板断裂
右リウマチ性膝関節症	関節リウマチ・膝関節	多尿
急性骨髄性白血病（ＡＭＬ）	急性骨髄性白血病	急性小腸虚血
腹水大量	腹水症	膀胱白板症
全身皮膚発赤	発赤	多尿
多発肺嚢胞	肺のう胞	胸膜播種
右小脳橋角部腫瘍	小脳橋角部腫瘍	産科的創傷の血腫
右眼網膜静脈分枝閉塞症	網膜静脈分枝閉塞症	産科的創傷の血腫
右脛骨腓骨開放骨折	脛骨腓骨開放骨折	多尿
左側卵巣腫瘍	卵巣腫瘍	臍帯卵膜付着による新生児の障害
口腔内びらん	口唇びらん	内反小趾
紅斑熱群リケッチア症	リケッチア感染症	膀胱白板症
ＩＴＰ	特発性血小板減少性紫斑病	胸膜播種
気管支喘息小発作	気管支喘息発作	内反小趾
解離性動脈瘤破裂	解離性動脈瘤	産科的創傷の血腫
左眼窩内腫瘍	眼窩腫瘍	若年者キーンベック病
肺外小細胞癌	小細胞肺癌	抗生物質起因性腸炎
高度大動脈弁狭窄症	大動脈弁狭窄症	内反小趾
ｂｒｅａｋｔｈｒｏｕｇｈ　ｈｅｐａｔｉｔｉｓ	肝炎	膀胱白板症
左室圧排	右室肥大	内側半月板断裂
両側声帯外転障害	声帯外転筋麻痺	大動脈弁狭窄症兼僧帽弁閉鎖不全症兼三尖弁閉鎖不全症
一部水疱形成	水疱症	内反小趾
糖尿病潰瘍	糖尿病性潰瘍	床形態歯周治療用装置破損
飲みこみにくさ	嚥下障害	視路疾患
左腎低形成	低形成腎	眼瞼異物残留
左母趾疼痛	母趾痛	症候性そう痒症
副腎ヒストプラズマ感染症	真菌症	化膿性リンパ節炎
右眼糖尿病網膜症	糖尿病網膜症	化膿性リンパ節炎
下肢浮腫左	下肢浮腫	内反小趾
両松葉杖歩行	歩行障害	膀胱白板症
冠動脈狭窄３枝病変	狭心症３枝病変	第４趾有棘細胞癌
遺伝性低尿酸血症	低尿酸血症	顔面メルケル細胞癌
低アルドステロン血症	低アルドステロン症	胸膜播種
小腸皮膚瘻	皮膚瘻	大動脈弁狭窄症兼三尖弁閉鎖不全症
重度僧帽弁狭窄症	僧帽弁狭窄症	外耳道母斑細胞母斑
非細菌性血栓性疣贅	疣贅	床形態歯周治療用装置破損
特発性腸間膜血腫	血腫	前足部痛
脳原発性悪性リンパ腫	脳悪性リンパ腫	産科的創傷の血腫
抜管後両側反回神経麻痺	両側性反回神経麻痺	アフラトキシン中毒
肝骨転移	骨転移癌	床形態歯周治療用装置破損
乳腺線維腫症	線維腫	糖原病
術後左反回神経麻痺	反回神経麻痺	大動脈弁狭窄症兼僧帽弁閉鎖不全症兼三尖弁閉鎖不全症
無症候性髄膜腫	髄膜腫	若年者キーンベック病
左肺下葉肺癌	下葉肺癌	ＨＴＬＶ−１感染症
アルコール離脱症候群	アルコール離脱状態	胸膜播種
左腸骨骨肉腫	腸骨軟骨肉腫	床形態歯周治療用装置破損
脳梁低形成	脳梁形成不全	内反小趾
表皮内水疱形成	先天性表皮水疱症	内反小趾
後頚部圧痛	圧痛	内反小趾
不定愁訴様	不定愁訴症	気道閉塞
良性胆道狭窄	胆管狭窄症	眼瞼異物残留
左下葉非小細胞肺癌	下葉非小細胞肺癌	抗生物質起因性腸炎
ＣＫＤ　腎硬化症	腎硬化症	眼瞼異物残留
前頭葉出血	出血	内反小趾
有茎性乳頭状腫瘍	腫瘍	若年者キーンベック病
理解困難	言語理解障害	内側半月板断裂
スメア異常	腟スメア細胞診陽性	化膿性リンパ節炎
腹腔内敗血症	敗血症	膀胱白板症
膵尾部腫大	膵腫大	若年者キーンベック病
過呼吸状態	過換気症	肺活量減少
右肺門部原発肺小細胞癌	小細胞肺癌	抗生物質起因性腸炎
胃癌骨髄癌腫症	骨髄転移	若年者キーンベック病
眼乾燥感	ドライアイ	膀胱白板症
内側縦束症候群	核間性眼筋麻痺	産科的創傷の血腫
両足関節炎	足関節炎	総胆管のう腫
夜低血糖	低血糖	肺活量減少
左上下肢軽度麻痺	四肢麻痺	内反小趾
下肢痙性	痙性対麻痺	内反小趾
皮疹状況	発疹	角膜上皮損傷
不適応	適応障害	症候性そう痒症
陰茎部痛	陰茎部疼痛	内反小趾
髄外形質細胞腫	骨外性形質細胞腫	若年者キーンベック病
ｍａｌｉｇｎａｎｔ　ｌｙｍｐｈｏｍａ	悪性リンパ腫	突発性咽頭出血
重症ＡＧＨＤ	重症成人成長ホルモン分泌不全	内反小趾
両白内障	白内障	類宦官症
腎結石	腎結石症	前足部痛
湿疹性病変	湿疹	化膿性リンパ節炎
穿刺部発赤	発赤	完全大血管転位症１型
時々背部痛	背部痛	エーテル中毒症
手内筋萎縮	筋萎縮症	多尿
腎機能悪化	腎機能低下	視路疾患
尾てい骨骨折	尾骨骨折	多尿
高度視力障害	視力障害	症候性そう痒症
周期性クッシング症候群	クッシング症候群	静脈内膜炎
昨夜微熱	微熱	肺活量減少
腓腹筋痙攣	痙攣	総胆管のう腫
左肋骨打撲	肋骨部打撲	多尿
破壊性脊椎症	脊椎症	総胆管のう腫
胆嚢破裂	胆のう管破裂	腰部尋常性乾癬
独歩不可	歩行障害	膀胱白板症
骨破壊進行	関節リウマチ	多尿
下肢白癬	白癬	内反小趾
左鼓膜発赤	発赤	内反小趾
潜在結核	結核	胸膜播種
熱苦症状	発熱	膀胱白板症
シャイドレジャー症候群	シャイ・ドレーガー症候群	内反小趾
肺動脈弁閉鎖症	肺動脈弁閉鎖	サイトメガロウイルス脊髄炎
脾摘施行Ｃ型肝炎	Ｃ型肝炎	前足部痛
胸水セルブロック	胸水貯留	膀胱白板症
右肺上葉すりガラス影	胸部異常陰影	シーハン症候群
Ｆｏｌｌｉｃｕｌａｒ　ｌｙｍｐｈｏｍａ	濾胞性リンパ腫	胸膜播種
腫瘍性ＤＩＣ	線溶亢進	床形態歯周治療用装置破損
右精巣上体炎	精巣上体炎	肺動脈分岐部狭窄症
左肘関節亜脱臼	亜脱臼	多尿
左聴神経腫瘍	聴神経腫瘍	産科的創傷の血腫
左肺感染性嚢胞	肺のう胞	化膿性リンパ節炎
母体出血	出血	第４趾有棘細胞癌
右足趾壊疽	下肢壊疽	多尿
胃腸障害	急性胃腸障害	膀胱乳頭腫
残遺癌	癌	若年者キーンベック病
不安大きく	不安障害	症候性そう痒症
ＭＳ再発	多発性硬化症	胸膜播種
強直間代性痙攣発作	間代性痙攣	内反小趾
一過性意識消失発作	一過性脳虚血発作	肺活量減少
乳児白血病	白血病	膀胱白板症
筋委縮	筋萎縮症	多尿
水腎再燃	水腎症	新生児一過性低血糖症
しびれていない	しびれ感	内反小趾
時々血痰	血痰	肺活量減少
左鼠経ヘルニア	鼡径ヘルニア	網膜静脈血栓症
遺伝性腎性尿崩症	先天性腎性尿崩症	眼瞼異物残留
尿管結石	尿管結石症	致死型表皮水疱症
体幹掻痒感	そう痒	角膜上皮損傷
右大腿部骨幹部骨折	大腿骨骨幹部骨折	多尿
糖尿病神経症	糖尿病性神経痛	視路疾患
古典的肝細胞癌再発	肝細胞癌	鰓瘻
左室低形成	左心低形成症候群	内反小趾
劇症肝炎亜急性型	劇症肝炎	視路疾患
分岐部動脈瘤	内頚動脈後交通動脈分岐部動脈瘤	産科的創傷の血腫
腫瘍感染	腫瘍	床形態歯周治療用装置破損
悪性腫瘍スクリーニング	悪性腫瘍	多尿
外陰部炎	外陰炎	化膿性心膜炎
軽度骨髄抑制	骨髄機能低下	多尿
右踵骨折	骨折	多尿
ＰＰＨ	肺高血圧症	顔面メルケル細胞癌
頭痛時折	頭痛	内反小趾
血腫貯留	血腫	床形態歯周治療用装置破損
不整脈発作	不整脈	甲状腺出血
静脈炎症状	静脈炎	症候性そう痒症
子宮間質肉腫	肉腫	中指屈筋腱癒着
右主気管支膜様部壊死	壊死	多尿
右下肺野スリガラス影	胸部異常陰影	ＨＴＬＶ−１感染症
時々頭痛	頭痛	内反小趾
胆嚢腺扁平上皮癌	癌	足底部打撲傷
上行結腸早期癌	上行結腸癌	胸膜播種
突発性血小板減少性紫斑病	血小板減少性紫斑病	ＨＴＬＶ−１感染症
意識変動	意識障害	内側半月板断裂
左閉鎖リンパ節転移	リンパ節転移	臍帯卵膜付着による新生児の障害
両側小脳梗塞	小脳梗塞	産科的創傷の血腫
胃癌多発肝転移	転移性肝癌	前足部痛
左前腕浮腫	浮腫	内反小趾
赤紫斑	紫斑病	完全大血管転位症１型
偽腔閉塞型大動脈解離	解離性大動脈瘤	産科的創傷の血腫
高度感音性難聴	感音難聴	症候性そう痒症
左耳介欠損	耳介欠損	内反小趾
尿路感染	尿路感染症	頚部腫瘤
縦隔炎再発	縦隔炎	ミトコンドリア糖尿病・多発糖尿病性合併症あり
前立腺肥大有	前立腺肥大症	内反小趾
胆嚢腫瘍	胆のう腫瘍	前足部痛
胃がん	胃癌	床形態歯周治療用装置破損
左中大脳動脈梗塞	中大脳動脈塞栓症	産科的創傷の血腫
Ｓｏｔｏｓ症候群	ソトス症候群	化膿性リンパ節炎
必要認知症	認知症	躁病発作
肝腫瘤性病変	肝腫瘤	床形態歯周治療用装置破損
大動脈瘤解離	解離性大動脈瘤	産科的創傷の血腫
挿入部出血	出血	手掌部皮下腫瘤
眠前発熱	発熱	大動脈弁狭窄症兼僧帽弁閉鎖不全症兼三尖弁閉鎖不全症
肺炎反復	肺炎	肺活量減少
子宮内発育不全	子宮発育不全	乳歯歯根吸収不全
左眼窩内腫瘤	眼窩腫瘤	内反小趾
多発性腎梗塞	腎梗塞	眼瞼異物残留
多臓器不全状態	多臓器不全	化膿性リンパ節炎
再度痙攣発作	痙攣発作	内反小趾
変動一過性徐脈	徐脈	症候性そう痒症
四肢色素沈着	皮膚色素沈着	膀胱白板症
良性発作性頭位めまい	良性発作性頭位めまい症	症候性そう痒症
三角圧痛	肩部筋痛	症候性そう痒症
両側声帯不全麻痺	声帯不全麻痺	内反小趾
舌痛	舌痛症	内反小趾
肺動脈弁下狭窄	肺動脈弁下狭窄症	サイトメガロウイルス脊髄炎
乳癌局所再発	乳癌	抗生物質起因性腸炎
頚椎症性神経根炎	頚椎症性神経根症	総胆管のう腫
痛みきつい	疼痛	内反小趾
両側顎下腺腫大	顎下腺肥大	内反小趾
中等度咽頭期嚥下障害	嚥下障害	症候性そう痒症
ビタミンＤ不足	ビタミンＤ欠乏症	胸膜播種
日中下痢便	下痢症	膀胱白板症
胸郭低形成	胸郭異常	多尿
肺スリガラス陰影	胸部異常陰影	胸膜播種
頻脈傾向変	頻脈症	甲状腺出血
口蓋腫瘤	腫瘤	内反小趾
パーキンソン病関連疾患	パーキンソン病	甲状腺出血
グラム陰性桿菌菌血症	グラム陰性桿菌敗血症	肺活量減少
右上肢腫脹	上肢腫脹	内反小趾
左肩甲骨部痛	肩甲骨痛	エーテル中毒症
開腹子宮筋腫核	子宮筋腫	産科的創傷の血腫
白内障手術	白内障	類宦官症
腫瘤残存	腫瘤	多尿
直腸癌Ｒａ	直腸癌	胸膜播種
カルボプラチンアレルギー	薬物過敏症	胸膜播種
肺原発ホジキンリンパ腫	ホジキンリンパ腫	胸膜播種
循環障害	末梢循環障害	胸膜播種
原発性空腸癌	空腸癌	胸膜播種
右卵巣チョコレート嚢腫	チョコレートのう胞	腰椎腫瘍
重度精神運動発達遅滞	混合性特異的発達障害	症候性そう痒症
左腎梗塞	腎梗塞	眼瞼異物残留
筋緊張高く	筋強直	内反小趾
母指潰瘍治癒遅延	皮膚潰瘍	多尿
歩行時呼吸困難感	労作時呼吸困難	内側半月板断裂
滑液貯留	体液貯留	膀胱白板症
痰症状	喀痰	肺活量減少
腸管血流障害	末梢循環障害	膀胱白板症
発赤強い	発赤	完全大血管転位症１型
全身性単純ヘルペスウイルス感染症	ヘルペスウイルス感染症	膀胱白板症
冠動脈高度石灰化	冠動脈石灰化	第４趾有棘細胞癌
劇症型腸アメーバ症	腸アメーバ症	胸膜播種
慢性痛	慢性疼痛	症候性そう痒症
不適応行動	適応障害	症候性そう痒症
心室内血栓	心室内血栓症	胸膜播種
腹膜播種結節摘出	腹膜播種	肝腫瘤
緑色痰	喀痰	肺活量減少
冠動脈硬化	冠状動脈硬化症	産科的創傷の血腫
右中葉肺癌	中葉肺癌	ＨＴＬＶ−１感染症
ポンプポケット内血腫	血腫	床形態歯周治療用装置破損
血管免疫芽球型Ｔ細胞リンパ腫	血管免疫芽球性Ｔ細胞リンパ腫	臍帯卵膜付着による新生児の障害
腹部緊満	腹部膨満	総胆管のう腫
舌骨喉頭下垂	喉頭下垂症	内反小趾
尿量低下	乏尿	胸膜播種
脳梗塞症	脳梗塞	症候性そう痒症
左非浸潤性乳管癌	非浸潤性乳管癌	若年者キーンベック病
むつかぶれ	おむつ皮膚炎	内反小趾
水平亜脱臼	亜脱臼	第４趾有棘細胞癌
右反復性膝蓋骨脱臼	反復性膝蓋骨脱臼	多尿
早期癌	癌	抗生物質起因性腸炎
吻合部出血	出血	多尿
子宮頸がん	子宮頚癌	産科的創傷の血腫
腺扁平上皮癌	癌	突発性咽頭出血
喉頭蓋サルコイドーシス	サルコイドーシス	内反小趾
結核性	結核	床形態歯周治療用装置破損
声門部狭窄	喉頭狭窄症	内反小趾
両側急性硬膜外血腫	急性硬膜外血腫	急性小腸虚血
高レニン高血圧	高レニン性高血圧症	甲状腺出血
頭蓋底髄膜腫	髄膜腫	内反小趾
右前胸部痛	前胸部痛	エーテル中毒症
膵全体癌	膵癌	若年者キーンベック病
両側血気胸	血気胸	総胆管のう腫
穿刺部位出血	出血	内反小趾
手掌黄色腫	黄色腫症	糖原病
皮膚湿疹	湿疹	１型糖尿病性網膜症
唾石	唾石症	急性顎骨骨髄炎
非吻合部多発胆管狭窄	胆管狭窄症	気道閉塞
軽度肥満歴	肥満症	気道閉塞
左腎嚢胞不変	腎のう胞	前腕血栓性静脈炎
軽度発赤腫脹	発赤	内反小趾
左手関節変形	変形性手関節症	多尿
蛋白尿（３＋）	蛋白尿	胸膜播種
左手首痛	手部痛	エーテル中毒症
びまん性肺胞出血	肺胞出血	胸膜播種
続発性赤芽球癆	赤芽球ろう	第４趾有棘細胞癌
インフルエンザ菌	インフルエンザ	胸膜播種
左舌区小細胞癌	小細胞肺癌	抗生物質起因性腸炎
左足背疼痛	足背痛	症候性そう痒症
成人発症Ｓｔｉｌｌ病（ＡＯＳＤ）	成人スチル病	化膿性リンパ節炎
大球性正色素性貧血	正色素性貧血	慢性歯肉炎
双極Ⅱ型障害	２型双極性障害	甲状腺出血
限局型全身性強皮症	全身性強皮症	甲状腺出血
右水晶体脱臼	水晶体脱臼	第４趾有棘細胞癌
心サルコイト゛ーシス	心サルコイドーシス	静脈瘤性動脈瘤
Ｓ状結腸高分化腺癌	Ｓ状結腸癌	突発性咽頭出血
右側頬部腫脹	頬部腫脹	大動脈弁狭窄症兼三尖弁閉鎖不全症
右上背部痛	背部痛	エーテル中毒症
両下肢痛み	疼痛	内反小趾
多発海綿状血管腫	多発性海綿状血管腫	糖原病
結核歴	結核	床形態歯周治療用装置破損
ＳＭＡ浸潤	膵癌	胸膜播種
微小癌	癌	抗生物質起因性腸炎
慢性疼痛性障害	慢性疼痛	症候性そう痒症
高Ｃｌ血症	高クロール血症	胸膜播種
乳頭状腺癌	癌	突発性咽頭出血
帯状疱疹ウイルス脊髄炎	ウイルス脊髄炎	足関節外側靱帯断裂
内臓播種性ＶＺＶ感染症	汎発性帯状疱疹	閃輝性融解
様皮疹	発疹	内反小趾
左帯状疱疹	帯状疱疹	斜台部脊索腫
骨形成不全症Ⅲ型	骨形成不全症	産科的創傷の血腫
高度肥満症	病的肥満症	視路疾患
右前頭葉脳内血腫	血腫	臍帯卵膜付着による新生児の障害
マルチミニコア病	マルチコア病	化膿性リンパ節炎
四肢関節腫脹	関節炎	多尿
右腸骨静脈血栓症	腸骨静脈圧迫症候群	サイトメガロウイルス脊髄炎
脳底動脈閉塞	脳底動脈閉塞症	産科的創傷の血腫
胸背部圧迫感	背部圧迫感	エーテル中毒症
眼瞼結膜軽度貧血	貧血	総胆管のう腫
子宮頸癌Ⅲｂ期	子宮頚癌	産科的創傷の血腫
傍卵巣嚢胞	傍卵巣のう胞	前足部痛
肝内腫瘤性病変	腫瘤	床形態歯周治療用装置破損
血管性紫斑病	症候性紫斑病	化膿性リンパ節炎
時々右股関節痛	股関節痛	エーテル中毒症
ＡＳＤ	心房中隔欠損症	胸膜播種
緑膿菌肺感染症	緑膿菌肺炎	化膿性リンパ節炎
母子感染歴	母子感染	致死型表皮水疱症
ふらつきあり転倒リスク高い	めまい	甲状腺出血
頸腕症候群	頚肩腕症候群	内反小趾
食道癌術後リンパ節転移	リンパ節転移	臍帯卵膜付着による新生児の障害
亜急性期小脳梗塞	小脳梗塞	産科的創傷の血腫
喘息コントロール	咳喘息	肺活量減少
右膝違和感	全身違和感	症候性そう痒症
腓骨神経麻痺徴候	腓骨神経麻痺	内反小趾
中高分化型腺癌	癌	突発性咽頭出血
軽度脳梗塞	脳梗塞	多尿
身体外傷	外傷	多尿
心源性塞栓症	心原性脳塞栓症	症候性そう痒症
左上腕骨近位端骨折	上腕骨近位端骨折	多尿
神経根性痛	疼痛	症候性そう痒症
白色壊死組織付着	壊死	多尿
夜間中途覚醒	睡眠障害	大動脈弁狭窄症兼僧帽弁閉鎖不全症兼三尖弁閉鎖不全症
軽度肺動脈弁狭窄	肺動脈弁狭窄症	サイトメガロウイルス脊髄炎
転移性肝癌術後再発	転移性肝癌	鰓瘻
無涙症	涙液分泌不全	膀胱白板症
劇症Ａ型肝炎	Ａ型劇症肝炎	視路疾患
ｃｒｉｔｉｃａｌ　ｉｌｌｎｅｓｓ　ｐｏｌｙｎｅｕｒｏｐａｔｈｙ	多発ニューロパチー	胸膜播種
右眼増殖性糖尿病網膜症	増殖性糖尿病性網膜症	第２腰椎病的骨折
右上腕腫脹	上腕部腫脹	内反小趾
右側胸水貯留	胸水貯留	総胆管のう腫
水疱瘡	水疱症	膀胱白板症
軽度高Ｋ血症	高カリウム血症	膀胱白板症
肝性脳症再発	肝性脳症	肩甲骨外骨腫
水様便流出	下痢症	視路疾患
二絨毛膜二羊膜性双胎第	二絨毛膜二羊膜性双胎	産科的創傷の血腫
浮腫傾向	浮腫	視路疾患
骨Ｐａｇｅｔ病	骨パジェット病	床形態歯周治療用装置破損
Ｅｎｔａｍｏｅｂａ　ｈｉｓｔｏｌｙｔｉｃａ	アメーバ赤痢	化膿性リンパ節炎
左頚部内頸動脈狭窄	内頚動脈狭窄症	産科的創傷の血腫
大腿筋横紋筋肉腫	横紋筋肉腫	中指屈筋腱癒着
腸炎性関節炎	関節炎	膀胱白板症
ＰＭＳ	月経前症候群	胸膜播種
腓腹部圧痛	腹部圧痛	総胆管のう腫
非チフス性Ｓａｌｍｏｎｅｌｌａ菌血症	菌血症	胸膜播種
微小多発肝膿瘍	肝膿瘍	前足部痛
卵管狭窄	卵管狭窄症	第４趾有棘細胞癌
胸部大動脈解離	急性大動脈解離	産科的創傷の血腫
蜂窩織炎発症	蜂窩織炎	膀胱白板症
輪状披裂関節炎	関節炎	産科的創傷の血腫
左下肢蜂窩織炎	下肢蜂巣炎	総胆管のう腫
肺塞栓	肺塞栓症	胸膜播種
咽頭残留	嚥下障害	内反小趾
低髄圧症状	低髄液圧症	膀胱白板症
左腓骨開放骨折	腓骨開放骨折	第４趾有棘細胞癌
大量水様下痢	下痢症	視路疾患
処方右乳癌	乳癌	若年者キーンベック病
症候性けいれん	症候性てんかん	内反小趾
低血糖回避	低血糖	膀胱白板症
左慢性閉塞隅角緑内障	慢性閉塞隅角緑内障	化膿性リンパ節炎
弧発性古典的ＣＪＤ	孤発性クロイツフェルト・ヤコブ病	化膿性リンパ節炎
呼吸機能低下	呼吸機能検査異常	肺活量減少
右大腿リンパ節転移	リンパ節転移	床形態歯周治療用装置破損
左第３趾潰瘍	趾皮膚潰瘍	多尿
足変形	足部変形	多尿
膝関節水腫	膝関節水症	床形態歯周治療用装置破損
腹部瘢痕ヘルニア	腹壁瘢痕ヘルニア	腎脂肪腫
月経困難	月経困難症	症候性そう痒症
左局所進行乳癌	進行乳癌	抗生物質起因性腸炎
好酸球性胆嚢炎	胆のう炎	視路疾患
左下腿骨幹部骨折	骨折	多尿
即時型アレルギー	アレルギー	肺活量減少
ふらつき有	めまい	膀胱白板症
ループス腎炎Ｖ型	ループス腎炎	静脈瘤性動脈瘤
閉塞性睡眠時無呼吸症侯群	睡眠時無呼吸症候群	症候性そう痒症
右下肢しびれ	下肢しびれ	内反小趾
頭部脂漏性皮膚炎	脂漏性皮膚炎	膀胱白板症
結核性ブドウ膜炎	結核性ぶどう膜炎	床形態歯周治療用装置破損
左真珠腫性中耳炎再発	真珠腫性中耳炎	サイトメガロウイルス脊髄炎
傍大動脈ＬＮ転移	大動脈周囲リンパ節転移	慢性歯肉炎
痙直型四肢麻痺	四肢麻痺	内反小趾
角化性紅斑散在	紅斑症	内反小趾
労作時呼吸苦自覚	労作時呼吸困難	症候性そう痒症
慢性腎炎	慢性腎炎症候群	視路疾患
間質性肺炎像	間質性肺炎	化膿性リンパ節炎
嘔気様	嘔気	視路疾患
左側頭葉皮質化出血	出血	内反小趾
左上腕骨開放骨折	上腕骨開放骨折	多尿
腹部膨満継続	腹部膨満	内反小趾
右足底腱膜炎	足底筋膜炎	総胆管のう腫
両側顎関節症	顎関節症	甲状腺出血
出血性黄体	出血性黄体のう胞	急性小腸虚血
右鼡径部疼痛	鼡径部痛	大動脈弁狭窄症兼僧帽弁閉鎖不全症兼三尖弁閉鎖不全症
高～中分化型管状腺癌	癌	突発性咽頭出血
Ｌａｍｉｖｕｄｉｎｅ耐性Ｂ型肝硬変	Ｂ型肝硬変	眼瞼異物残留
遺伝性腎炎	家族性腎炎	視路疾患
湿疹化	湿疹	１型糖尿病性高コレステロール血症
左大腿部蜂窩織炎	大腿部蜂巣炎	淋菌性腹膜炎
下肢対麻痺	対麻痺	内反小趾
成長発達遅滞	発達遅滞	気道閉塞
下腿点状出血	点状出血	内反小趾
脈管奇形	奇形	内反小趾
手指欠損	手指欠損症	膀胱白板症
咽頭粘膜軽度発赤	咽頭発赤	内反小趾
可動時痛	疼痛	症候性そう痒症
下垂手	垂れ手	症候性そう痒症
左陰嚢内容腫大	陰のう腫大	大動脈弁狭窄症兼三尖弁閉鎖不全症
痰がからみ	喀痰	化膿性リンパ節炎
朝出血	出血	内反小趾
右鼠経ヘルニア修復術	鼡径ヘルニア	若年者キーンベック病
ステロイド骨粗鬆症	ステロイド性骨粗鬆症	甲状腺出血
足趾冷感	下肢冷感	大動脈弁狭窄症兼僧帽弁閉鎖不全症兼三尖弁閉鎖不全症
不整腫瘤	腫瘤	内反小趾
腎前性脱水	脱水症	視路疾患
左肩部痛	肩部痛	エーテル中毒症
頸部皮下膿瘍	皮膚膿瘍	足底部打撲傷
ウイルス性感冒	感冒	膀胱白板症
多発腫大リンパ節	リンパ節腫大	ＴＦＣＣ損傷
腹部自発痛	腹痛症	エーテル中毒症
中分化型前立腺癌	前立腺癌	突発性咽頭出血
左一側性形成不全性股関節症	一側性形成不全性股関節症	アフラトキシン中毒
好酸球性気道炎症	好酸球性気管支炎	化膿性リンパ節炎
腸管蠕動障害	腸管運動障害	症候性そう痒症
褥瘡形成リスク高い	褥瘡	完全大血管転位症１型
腰椎変性辷り症	腰椎変性すべり症	総胆管のう腫
手術高血圧	高血圧症	内側半月板断裂
嚥下下困難	嚥下障害	肺活量減少
てんかん脳波	異常脳波	内反小趾
巨大血腫	血腫	床形態歯周治療用装置破損
十二指腸原発神経内分泌腫瘍	十二指腸神経内分泌腫瘍	鰓瘻
腹水多量貯留	腹水症	膀胱白板症
内腸骨リンパ節転移	腸骨リンパ節転移	床形態歯周治療用装置破損
ＣＭＶ胃腸炎	サイトメガロウイルス腸炎	床形態歯周治療用装置破損
瘢痕痙性	瘢痕	風疹性髄膜脳炎
両Ｔ字杖歩行	歩行障害	甲状腺出血
便性状変化	便異常	化膿性リンパ節炎
右血栓閉塞	血栓塞栓症	第４趾有棘細胞癌
出血付着程度	出血	膀胱白板症
右海綿静脈洞髄膜腫	髄膜腫	産科的創傷の血腫
虚血性心疾患合併	虚血性心疾患	内側半月板断裂
壊死性筋炎	筋炎	産科的創傷の血腫
全肺腫瘍	肺腫瘍	臍帯卵膜付着による新生児の障害
軽度構音障害	構音障害	症候性そう痒症
両下腿紅斑	紅斑症	内反小趾
低Ｃａ血症	低カルシウム血症	膀胱白板症
二次性副腎不全	副腎クリーゼ	前立腺膿瘍
一週間程度眠気	非器質性過眠症	膀胱白板症
子宮内腔癒着	子宮内膜症	前足部痛
項部硬直軽度	項部硬直	内反小趾
下熱	発熱	肺活量減少
右母指陳旧性尺側側副靱帯損傷	靱帯損傷	慢性肺気腫
左気管支狭窄	気管支狭窄症	眼瞼異物残留
皮膚型ＰＮ	結節性多発動脈炎	床形態歯周治療用装置破損
肺線維化	肺線維症	胸膜播種
副鼻腔軽度粘膜肥厚	副鼻腔炎	内反小趾
味覚異常Ｇｒ１	味覚異常	化膿性リンパ節炎
中心視野欠損	視野欠損	静脈内膜炎
昨晩低血糖	低血糖	膀胱白板症
両水腎症	両側水腎症	視路疾患
前回貧血	貧血	総胆管のう腫
骨粗鬆症性圧迫骨折	骨粗鬆症・病的骨折あり	第４趾有棘細胞癌
右肺原発肺腺癌	肺腺癌	ＨＴＬＶ−１感染症
脊髄原発悪性リンパ腫	悪性リンパ腫	急性小腸虚血
手指浮腫	浮腫	内反小趾
口内炎再発	口内炎	大動脈弁狭窄症兼僧帽弁閉鎖不全症兼三尖弁閉鎖不全症
皮質性認知症	皮質下認知症	股関節脱臼
足背発赤	発赤	完全大血管転位症１型
後縦隔腫瘤	縦隔腫瘍	産科的創傷の血腫
頚椎症性脊椎症	脊椎症	心因性視覚障害
中部延髄右外側脳梗塞	脳梗塞	産科的創傷の血腫
仙骨部瘻孔	難治性瘻孔	第４趾有棘細胞癌
軽鎖沈着症	単クローン性軽鎖重鎖沈着症	総胆管のう腫
右傍気管リンパ節転移	リンパ節転移	臍帯卵膜付着による新生児の障害
ｓｍａｌｌ　ｃｅｌｌ　ｃａｒｃｉｎｏｍａ	癌	胸膜播種
遺伝性出血性毛細血管拡張症	オスラー病	サイトメガロウイルス脊髄炎
胸椎後縦靭帯骨化症	胸椎後縦靱帯骨化症	多尿
重症敗血症性ショック	敗血症性ショック	甲状腺出血
間質性肺炎評価	間質性肺炎	化膿性リンパ節炎
右腎損傷	腎損傷	舌小帯短縮症
右肺門部原発	原発性肺癌	胸膜播種
再発食道癌	食道癌	抗生物質起因性腸炎
不定愁訴多い	不定愁訴症	視路疾患
発熱再燃	発熱	肺活量減少
左肩関節痛	肩関節痛症	症候性そう痒症
瘢痕様変化	瘢痕	風疹性髄膜脳炎
元々頻尿	頻尿症	視路疾患
浮腫対策	浮腫	視路疾患
核下性顔面神経麻痺	顔面神経麻痺	多尿
皮膚原発悪性リンパ腫	悪性リンパ腫	臍帯卵膜付着による新生児の障害
市中感染型ＭＲＳＡ	ＭＲＳＡ感染症	化膿性リンパ節炎
左尿管結石	尿管結石症	前足部痛
乾性咳嗽頻回	乾性咳	肺活量減少
首痛	頚部痛	内反小趾
右側頭部紫斑	紫斑病	完全大血管転位症１型
薬剤過敏性症候群	薬物過敏症	傍矢状洞髄膜腫
延長症候群	ＱＴ延長症候群	静脈内膜炎
紫斑形成軽度	紫斑病	内反小趾
両側肺動脈狭窄症	肺動脈狭窄症	サイトメガロウイルス脊髄炎
子宮筋腫核出後妊娠	妊娠	床形態歯周治療用装置破損
ＡＲＤＳ合併	急性呼吸窮迫症候群	胸膜播種
胆道系閉塞	胆道閉塞	眼瞼異物残留
軟骨損傷	肋軟骨損傷	多尿
右副腎原発	副腎腫瘍	視路疾患
ｋｌｅｂｓｉｅｌｌａ　ｐｎｅｕｍｏｎｉａｅ感染症	クレブシェラ属感染	化膿性リンパ節炎
パ−キンソン症候群	パーキンソン症候群	静脈内膜炎
右原発性肺癌	原発性肺癌	胸膜播種
敗血症性ショック状態	敗血症性ショック	甲状腺出血
時々発疹	発疹	斜台部脊索腫
めまい軽度	めまい	症候性そう痒症
右横隔膜筋欠損	筋欠損	静脈内膜炎
脳症後遺症	脳症	多尿
胸膜悪性中皮腫	悪性胸膜中皮腫	臍帯卵膜付着による新生児の障害
漿膜損傷	損傷	若年者キーンベック病
頸椎症性	頚椎症	内反小趾
多発外傷	多発性外傷	多尿
皮膚損傷起	皮膚損傷	多尿
ふらつき目立	めまい	膀胱白板症
近位筋痛	筋肉痛	症候性そう痒症
採血上脱水	脱水症	総胆管のう腫
脳血管芽腫	小脳血管芽腫	足底部打撲傷
右慢性中耳炎	慢性中耳炎	大動脈弁狭窄症兼僧帽弁閉鎖不全症兼三尖弁閉鎖不全症
アレルギー様	アレルギー	化膿性リンパ節炎
ノカルジア脳膿瘍	ノカルジア症	足底部打撲傷
大腸ポリープ有	大腸ポリープ	胸膜播種
右後頭部帯状疱疹	後頭部帯状疱疹	内反小趾
右頚部結核性リンパ節炎	結核性リンパ節炎	臍帯卵膜付着による新生児の障害
陳旧性多発アテローム血栓性脳梗塞	陳旧性アテローム血栓性脳梗塞	産科的創傷の血腫
誤嚥徴候	異物誤嚥	症候性そう痒症
右前腕皮疹	発疹	１型糖尿病性網膜症
多発肺腫瘤	肺腫瘤	多尿
後腹膜浸潤	後腹膜悪性腫瘍	多尿
網状紫斑	紫斑病	温熱じんま疹
胚細胞腫瘍	腫瘍	若年者キーンベック病
ゲノタイプ１ｂ型Ｃ型肝硬変	Ｃ型肝硬変	正中頚のう胞
類円形腫大	リンパ節腫大	内反小趾
中枢性気管支拡張像	気管支拡張症	化膿性リンパ節炎
小股歩行	歩行異常	内反小趾
脳血管傷害	脳血管障害	多尿
糖尿病末梢神経障害	糖尿病性単ニューロパチー	類宦官症
ルンバール後頭痛	腰椎穿刺後頭痛	内反小趾
急性重症Ｂ型肝炎	Ｂ型肝炎	子宮線維症
下垂時疼痛	疼痛	症候性そう痒症
頚部蜂窩織炎	頚部蜂巣炎	臍帯卵膜付着による新生児の障害
腹満不変	腹部膨満	視路疾患
一過性心筋虚血	心筋虚血	慢性歯肉炎
日勤帯発熱	発熱	角膜上皮損傷
結核性喉頭狭窄	喉頭狭窄症	多尿
両側鼻内ポリープ	鼻茸	膀胱内異物
手掌潮紅	紅潮	総胆管のう腫
低血糖歴何年	低血糖	肺活量減少
離床時眩暈	めまい	大動脈弁狭窄症兼僧帽弁閉鎖不全症兼三尖弁閉鎖不全症
高齢者Ｃ型慢性肝炎	Ｃ型慢性肝炎	視路疾患
ＳＬＥ発症	全身性エリテマトーデス	化膿性リンパ節炎
軽度咽頭違和感	咽頭異常感症	症候性そう痒症
体熱感	不明熱	膀胱白板症
悪性腫瘍評価	悪性腫瘍	産科的創傷の血腫
発赤領域	発赤	化膿性リンパ節炎
閉塞性大腸癌	大腸癌	抗生物質起因性腸炎
子宮頚部ポリープ	子宮頚管ポリープ	ヘルペスウイルス性湿疹
両側大腰筋血腫	血腫	床形態歯周治療用装置破損
ＰＳＬＮ転移	大動脈周囲リンパ節転移	胸膜播種
咽頭部疼痛	咽頭痛	角膜上皮損傷
肺腫瘍塞栓症	肺腫瘍	手掌部皮下腫瘤
羊水過多	羊水過多症	膀胱白板症
筋肉痛症状	筋肉痛	内反小趾
心外膜石灰化	心膜石灰化	サイトメガロウイルス脊髄炎
右下肢急性動脈閉塞症	下肢急性動脈閉塞症	内反小趾
４型進行胃癌	胃進行癌	突発性咽頭出血
圧迫性脊髄症	脊髄症	総胆管のう腫
出血源不明	出血	甲状腺出血
貧血性網膜症	貧血網膜症	慢性歯肉炎
椎間板突出	椎間板症	内反小趾
カルチノイド腫瘍	カルチノイド	若年者キーンベック病
心臓内腫瘤	腫瘤	産科的創傷の血腫
日中気分不快	悪心	症候性そう痒症
多発性嚢胞肝	多発性肝のう胞	前腕血栓性静脈炎
仙骨奇形	仙骨部奇形	産科的創傷の血腫
けいれん再発	痙攣	第４趾有棘細胞癌
遊走性静脈炎	遊走性血栓性静脈炎	前額部扁平母斑
左胸膜炎	胸膜炎	大動脈弁狭窄症兼僧帽弁閉鎖不全症兼三尖弁閉鎖不全症
直腸癌術後異時性肝転移	転移性肝癌	前足部痛
手指痺れ	しびれ感	症候性そう痒症
左卵管水腫	卵管留水症	床形態歯周治療用装置破損
歩行時呼吸困難	労作時呼吸困難	内側半月板断裂
ガーゼ出血	出血	内反小趾
老人性紅皮症	紅皮症	膀胱白板症
右被殻脳梗塞	被殻出血	産科的創傷の血腫
自律神経ニューロパチー	自律神経性ニューロパチー	内反小趾
子宮頚部嚢胞	子宮頚部腫瘍	前足部痛
右原発閉塞隅角緑内障	原発閉塞隅角緑内障	化膿性リンパ節炎
腺腫内癌	癌	突発性咽頭出血
両下肢浮腫軽度	下肢浮腫	内反小趾
右化膿性肩関節炎	化膿性関節炎・肩関節	流産後尿細管壊死
膣転移	腟癌	手掌部皮下腫瘤
体力低下著明	体力低下	膀胱白板症
左小脳陳旧性梗塞	陳旧性脳梗塞	産科的創傷の血腫
淡黄色粘稠痰	喀痰	胸椎部挫傷
外傷所見	外傷	多尿
発赤局面	発赤	化膿性リンパ節炎
膀胱癌既往	膀胱癌	新生児一過性低血糖症
左末梢性肺動脈狭窄	肺動脈狭窄症	サイトメガロウイルス脊髄炎
骨代謝異常	代謝障害	内側半月板断裂
心陰影拡大	胸部異常陰影	ＨＴＬＶ−１感染症
腎動脈下腹部大動脈瘤	腹部大動脈瘤	サイトメガロウイルス脊髄炎
腸管壁内気腫	皮下気腫	大動脈弁狭窄症兼三尖弁閉鎖不全症
慢性活動性ＥＢＶ感染症	ＥＢウイルス感染症	子宮線維症
足関節圧痛	関節痛	エーテル中毒症
夕方発熱	発熱	角膜上皮損傷
顔面紅班	紅斑症	腎脂肪腫
排便痛	排便障害	症候性そう痒症
左水腎	水腎症	眼瞼異物残留
代謝異常	代謝障害	肺活量減少
両下肢リンハ゜浮腫	下肢リンパ浮腫	内反小趾
左頸部ＬＮ腫脹	肘リンパ節腫脹	床形態歯周治療用装置破損
肺門部リンパ節腫脹	リンパ節腫大	床形態歯周治療用装置破損
呼吸困難感軽度	呼吸麻痺	症候性そう痒症
左膝窩動脈血栓症	動脈血栓症	床形態歯周治療用装置破損
左股関節脱臼	股関節脱臼	多尿
ルーフ゜ス腎炎	ループス腎炎	子宮線維症
鼠径部腫脹	鼡径部腫脹	多尿
内鼠径ヘルニア	内鼡径ヘルニア	足背部第２度熱傷
左頬部血管腫	頬部血管腫	前足部痛
開口制限	開口不全	内反小趾
変形性関節炎	変形性関節症	甲状腺出血
初回歩行時ふらつき	よろめき歩行	膀胱白板症
洞性頻脈	洞頻脈	内反小趾
腹膜播種巣	腹膜播種	肝腫瘤
アレルギ—性結膜炎	アレルギー性結膜炎	膀胱白板症
鼠径部血腫	血腫	床形態歯周治療用装置破損
暗赤色嘔吐	嘔吐症	肺活量減少
直腸癌ＯＰ	直腸癌	胸膜播種
左増殖性糖尿病網膜症	糖尿病網膜症	臍帯卵膜付着による新生児の障害
レム睡眠行動異常	異常行動	肺活量減少
左大腿有棘細胞癌	大腿有棘細胞癌	若年者キーンベック病
声帯癌	声門癌	胸膜播種
左大腿部疼痛	大腿痛	症候性そう痒症
右顎関節症	顎関節症	症候性そう痒症
骨頭壊死	骨壊死	多尿
中枢神経浸潤	中枢神経系損傷	眼瞼異物残留
直腸皮下瘻孔	難治性瘻孔	大動脈弁狭窄症兼三尖弁閉鎖不全症
胆嚢腫大	胆のう肥大	前足部痛
Ｈｅｅｒｆｏｒｄｔ症候群	ぶどう膜耳下腺熱	内反小趾
前立腺癌既往	前立腺癌	若年者キーンベック病
ダグラス窩腹水	腹水症	総胆管のう腫
失見当障害	見当識障害	症候性そう痒症
ツツガムシ感染症	つつが虫病	先天性限局白皮症
特発性血小板減少症紫斑病	特発性血小板減少性紫斑病	ＨＴＬＶ−１感染症
前立腺浮腫	浮腫	視路疾患
胞性腫瘤	腫瘤	第４趾有棘細胞癌
右鼠径リンパ節腫脹	鼡径部リンパ節腫脹	若年者キーンベック病
ＡＡＡ破裂	腹部大動脈瘤	産科的創傷の血腫
夜間覚醒	不眠症	大動脈弁狭窄症兼僧帽弁閉鎖不全症兼三尖弁閉鎖不全症
初発癌	癌	抗生物質起因性腸炎
右迷走神経鞘腫	神経鞘腫	足底部打撲傷
痙攣様	痙攣	内反小趾
機会誤嚥	嚥下障害	症候性そう痒症
大腿静脈血栓	静脈血栓症	床形態歯周治療用装置破損
股関節部骨折	股関節骨折	多尿
吸収不全症侯群	吸収不良症候群	ＨＴＬＶ−１感染症
新生血管緑内障	緑内障	化膿性リンパ節炎
甲状腺低下症	甲状腺機能低下症	化膿性リンパ節炎
アメーバ肝膿瘍	肝アメーバ症	臍帯卵膜付着による新生児の障害
先天性真珠腫	真珠腫	若年者キーンベック病
頭部皮膚欠損	頭部皮膚欠損創	多尿
右肺門部浸潤影	胸部異常陰影	むちうち損傷
食道悪性腫瘍	食道癌	臍帯卵膜付着による新生児の障害
傍大動脈リンパ節転移	大動脈周囲リンパ節転移	慢性歯肉炎
ビタミンＤ欠乏	ビタミンＤ欠乏症	胸膜播種
レントゲン異常	胸部異常陰影	胸膜播種
器質的心疾患	心疾患	視路疾患
温痛覚	温痛覚過敏	角膜上皮損傷
両側内反足	内反足	大動脈弁狭窄症兼僧帽弁閉鎖不全症兼三尖弁閉鎖不全症
低酸素症状	低酸素性脳症	肺活量減少
粘稠痰少量	喀痰	肺活量減少
ダンベル型腫瘍	腫瘍	床形態歯周治療用装置破損
催不整脈作用	不整脈	化膿性リンパ節炎
左腋窩汗腺癌	汗腺癌	足底部打撲傷
感染性仮性嚢胞	仮性膵のう胞	視路疾患
乳房熱感	ほてり	角膜上皮損傷
大腸穿孔	腸穿孔	第４趾有棘細胞癌
腎瘢痕	瘢痕	致死型表皮水疱症
孤立性左室緻密化障害	孤立性心筋緻密化障害	産科的創傷の血腫
進行性顔面片側萎縮症	顔面痙攣症	アフラトキシン中毒
左手関節痛	手関節痛	症候性そう痒症
右鼠径部腫脹	鼡径部腫脹	若年者キーンベック病
びりびりしたしびれ	しびれ感	内反小趾
発赤軽減	発赤	完全大血管転位症１型
悪寒等	悪寒	視路疾患
非逆流性食道炎	食道炎	子宮線維症
甲状腺萎縮	後天性甲状腺萎縮	多尿
呼吸苦自覚症状	呼吸困難	症候性そう痒症
多発単神経障害	多発性単ニューロパチー	内側半月板断裂
中毒性	中毒	肺活量減少
右肺上葉結節影	胸部異常陰影	唾液腺管閉鎖
骨膜肥厚	肥厚性皮膚骨膜症	多尿
リステリア感染症	リステリア症	膀胱内異物
アルコール性脂肪性肝炎	アルコール性脂肪肝	視路疾患
脳室穿破	脳出血	多尿
鼠径部リンパ節腫大	鼡径部リンパ節腫脹	若年者キーンベック病
吐気治	嘔気	内側半月板断裂
右鼡径部リンパ節腫脹	鼡径部リンパ節腫脹	臍帯卵膜付着による新生児の障害
多発肺塞栓	肺塞栓症	胸膜播種
右腋窩リンパ節転位	腋窩リンパ節転移	臍帯卵膜付着による新生児の障害
重度右片麻痺	片麻痺	内反小趾
両側乳房腫瘤	乳房腫瘤	内反小趾
原発不明癌頸部リンパ節転移	頚部リンパ節転移	若年者キーンベック病
後腹膜脂胞肉腫	後腹膜脂肪肉腫	肝門部リンパ節転移
胆管閉塞機転	胆管閉塞症	眼瞼異物残留
右下葉原発扁平上皮癌	下葉肺扁平上皮癌	若年者キーンベック病
腰椎圧迫骨折既往	腰椎圧迫骨折	多尿
便秘悪化	便秘症	躁病発作
潜血３	顕微鏡的血尿	膀胱白板症
アレルギー性血管浮腫	浮腫	視路疾患
肺動脈分岐部狭窄	肺動脈分岐部狭窄症	サイトメガロウイルス脊髄炎
顕微的血尿	血尿	視路疾患
右鼡径リンパ節腫脹	鼡径部リンパ節腫脹	床形態歯周治療用装置破損
左足多趾症	多趾症	症候性そう痒症
日中痛み	疼痛	症候性そう痒症
不安感	不安障害	症候性そう痒症
眼球運動痛	疼痛	大動脈弁狭窄症兼僧帽弁閉鎖不全症兼三尖弁閉鎖不全症
腰椎変性側弯症	腰椎側弯症	総胆管のう腫
右腎低形成	低形成腎	視路疾患
Ｙｅｒｓｉｎｉａ　ｅｎｔｅｒｏｃｏｌｉｔｉｃａ感染症	エルシニア菌食中毒	化膿性リンパ節炎
膿胸合併肺放線菌症	肺放線菌症	化膿性リンパ節炎
チクチク痛む	チクチク感	内反小趾
左水尿管症	水尿管症	視路疾患
多発肺内転移	転移性肺癌	胸膜播種
左下葉肺癌断端再発	下葉肺癌	抗生物質起因性腸炎
右大腿部発赤	下腿発赤	義歯性潰瘍
右顔面打撲	顔面打撲傷	多尿
糖尿病性自律神経障害	糖尿病性自律神経ニューロパチー	静脈瘤性動脈瘤
分破水	破水	膀胱白板症
重症マイコプラズマ肺炎	マイコプラズマ肺炎	化膿性リンパ節炎
卵巣嚢腫破裂	卵巣のう腫破裂	若年者キーンベック病
抗原血症	サイトメガロウイルス感染症	急性小腸虚血
褥瘡発症	褥瘡	大動脈弁狭窄症兼僧帽弁閉鎖不全症兼三尖弁閉鎖不全症
甲状軟骨浸潤	甲状軟骨の悪性腫瘍	床形態歯周治療用装置破損
潜在性副腎皮質機能低下症	副腎皮質機能低下症	前立腺膿瘍
眼球陷凹	眼球陥没	尿崩症
両足趾潰瘍	趾皮膚潰瘍	多尿
過換気症状	過換気症	内側半月板断裂
左鎖骨下リンパ節転移	リンパ節転移	床形態歯周治療用装置破損
上右卵管留血腫	卵管留血腫	床形態歯周治療用装置破損
濾胞性リンパ腫再発	濾胞性リンパ腫	突発性咽頭出血
両眼糖尿病性網膜症	糖尿病網膜症	眼窩内粘液腫
左外傷性大腿骨頭壊死	外傷性大腿骨頭壊死	多尿
肝臓病変	肝疾患	視路疾患
右第１趾潰瘍	趾皮膚潰瘍	多尿
腋窩痛	腋窩部痛	角膜上皮損傷
踵部発赤	発赤	完全大血管転位症１型
両側ぶどう膜炎	ぶどう膜炎	膀胱白板症
右アスペルギルス肺炎	肺アスペルギルス症	むちうち損傷
痔疾患	痔核	症候性そう痒症
無疱疹帯状疱疹	帯状疱疹	斜台部脊索腫
吐き気軽度	嘔気	内側半月板断裂
非結核性抗酸菌性人工関節感染症	非結核性抗酸菌症	床形態歯周治療用装置破損
両下肢不随意運動	不随意運動症	大動脈弁狭窄症兼僧帽弁閉鎖不全症兼三尖弁閉鎖不全症
前胸痛	胸痛	エーテル中毒症
洞結節不全症候群	洞不全症候群	産科的創傷の血腫
結腸皮膚瘻	皮膚瘻	大動脈弁狭窄症兼三尖弁閉鎖不全症
患肢熱感	ほてり	角膜上皮損傷
両側腎膿瘍	腎膿瘍	前足部痛
右喉頭腫瘍	喉頭腫瘍	内反小趾
潜血	顕微鏡的血尿	眼部外傷性異物
細菌性脳動脈瘤破裂	脳動脈瘤破裂	産科的創傷の血腫
右鼡径部皮下出血	皮下出血	第４趾有棘細胞癌
右下腿筋肉内出血	筋肉内血腫	内反小趾
痒感	そう痒	急性顎骨骨髄炎
大動脈リンパ節転移	大動脈周囲リンパ節転移	慢性歯肉炎
心内血栓	心内血栓症	内側半月板断裂
術後出血	後出血	肝腫瘤
気分悪	悪心	症候性そう痒症
腰部脊椎管狭窄症	腰部脊柱管狭窄症	内反小趾
遠位弓部嚢状動脈瘤	動脈瘤	産科的創傷の血腫
左総腸骨動脈狭窄	総腸骨動脈狭窄	第４趾有棘細胞癌
尿潜血遷延	顕微鏡的血尿	胸膜播種
夜間悪寒	悪寒	中指末節骨骨折
造骨性骨転移	骨転移癌	床形態歯周治療用装置破損
腫瘍制御	腫瘍	床形態歯周治療用装置破損
失調性構音障害	構音障害	症候性そう痒症
右上腕骨頸部骨折	上腕骨頚部骨折	多尿
リンハ゜節腫大	リンパ節腫大	床形態歯周治療用装置破損
皮疹拡大傾向	発疹	斜台部脊索腫
依然浮腫	浮腫	視路疾患
右足底部蜂窩織炎	足蜂巣炎	総胆管のう腫
血栓閉塞型大動脈解離	早期血栓閉鎖型大動脈解離	産科的創傷の血腫
急性期脳血管障害	脳血管障害	サドマゾヒズム
朝方痰	喀痰	中指末節骨骨折
進行性直腸癌	直腸癌	突発性咽頭出血
小腸型クローン病	小腸クローン病	胸膜播種
軽度すりガラス影	胸部異常陰影	網膜静脈血栓症
二次性血小板増多症	血小板増加症	２型糖尿病・関節合併症あり
胃膵嚢胞	膵のう胞	前足部痛
最近浮腫	浮腫	視路疾患
右顔面疼痛	顔面痛	大動脈弁狭窄症兼僧帽弁閉鎖不全症兼三尖弁閉鎖不全症
便失禁多量	便失禁	化膿性リンパ節炎
労作時頻脈	頻脈症	症候性そう痒症
両下肢結節性紅斑	結節性紅斑	慢性肺気腫
重症胆管炎	胆管炎	総胆管のう腫
右側胸部痛	胸痛	エーテル中毒症
右小指基節骨骨折	小指基節骨骨折	多尿
右足背腫脹	足背腫脹	義歯性潰瘍
右上肢発赤	発赤	内反小趾
呂律のまわりにくさ	構音障害	症候性そう痒症
アミオダロン誘発性甲状腺中毒症	薬剤性甲状腺機能障害	胸膜播種
左胸部痛	胸痛	エーテル中毒症
右大腿痛	大腿痛	内反小趾
左下腿ＤＶＴ	下腿静脈血栓症	内反小趾
動悸等症状	動悸	症候性そう痒症
紫斑	紫斑病	化膿性リンパ節炎
致死性不整脈出現	不整脈	内反小趾
顆粒膜細胞腫	卵巣顆粒膜細胞腫	床形態歯周治療用装置破損
一瞬痛み	疼痛	症候性そう痒症
意識障害患者	意識障害	内側半月板断裂
切迫早産腹緊	切迫早産	エーテル中毒症
難治性皮膚非定型抗酸菌症	非結核性抗酸菌症	化膿性リンパ節炎
頚部鈍痛	鈍痛	内反小趾
発赤範囲	発赤	先天性限局白皮症
左腕腫脹	前腕腫脹	多尿
右肺上葉陰影	胸部異常陰影	むちうち損傷
右上葉肺結節	結節性肺結核	２型糖尿病・関節合併症あり
空腹時高血糖	高血糖症	膀胱白板症
右麻痺	片麻痺	内反小趾
味覚変化	味覚障害	症候性そう痒症
器質化肺炎	特発性器質化肺炎	化膿性リンパ節炎
浮腫悪化	浮腫	視路疾患
凝固異常症	血液凝固異常	流産後尿細管壊死
右側頭葉脳梗塞	脳梗塞	産科的創傷の血腫
両側下顎骨折	下顎骨骨折	多尿
左頭頂葉神経膠腫	頭頂葉神経膠腫	臍帯卵膜付着による新生児の障害
骨盤内多発リンパ節転移	骨盤内リンパ節転移	慢性歯肉炎
直腸閉塞	直腸閉鎖	第４趾有棘細胞癌
運動ニューロン病	運動ニューロン疾患	肺活量減少
肺犬糸状虫症	犬糸状虫症	化膿性リンパ節炎
軽度骨棘	骨棘	多尿
疲労感少	疲労感	症候性そう痒症
多発性肝腫瘤	肝腫瘍	腰部尋常性乾癬
意味性錯語	文意失語症	症候性そう痒症
ｃｏａｒｓｅ　ｃｒａｃｋｌｅｓ	湿性ラ音	膀胱白板症
緑色下痢便	下痢症	膀胱白板症
皮膚損傷リスク	皮膚損傷	多尿
左母指痛	母指痛	症候性そう痒症
ＡＶブロック	房室ブロック	内反小趾
前縦隔ＬＮ転移	縦隔リンパ節転移	慢性歯肉炎
間質性肺炎発症	間質性肺炎	化膿性リンパ節炎
外側脱臼	脱臼	第４趾有棘細胞癌
右環指基節骨骨折	環指基節骨骨折	産科的創傷の血腫
左殿部疼痛	殿部痛	症候性そう痒症
両側錐体路障害	錐体路障害	正中頚のう胞
両足しびれ	下肢しびれ	内反小趾
膜性増殖性	膜性増殖性糸球体腎炎	膀胱内異物
頻脈性心房粗動	心房粗動	甲状腺出血
下肢血流障害	下肢血行障害	総胆管のう腫
左肺上葉大細胞癌	上葉肺大細胞癌	抗生物質起因性腸炎
結核性肋膜炎	結核性胸膜炎	床形態歯周治療用装置破損
疼痛有	疼痛	内反小趾
実質外腫瘤	腫瘤	第４趾有棘細胞癌
骨盤部リンパ節転移	骨盤内リンパ節転移	床形態歯周治療用装置破損
左三叉神経帯状疱疹	三叉神経帯状疱疹	内反小趾
間質性肺炎悪化	間質性肺炎	化膿性リンパ節炎
仙骨部骨折	仙骨骨折	多尿
重症低体温症	低体温	甲状腺出血
関節炎悪化	関節炎	症候性そう痒症
右尖足	尖足	内反小趾
両手指浮腫	浮腫	内反小趾
左主気管支狭窄	気管支狭窄症	化膿性リンパ節炎
浸潤癌化	癌	抗生物質起因性腸炎
就寝後呼吸困難	呼吸困難	症候性そう痒症
仮性膵嚢胞	仮性膵のう胞	突発性咽頭出血
右肺上葉癌	上葉肺癌	ＨＴＬＶ−１感染症
訪室時疼痛	疼痛	症候性そう痒症
膠原病様症状	膠原病	急性小腸虚血
軽度黄染	黄疸	膀胱白板症
転移性膵癌	膵癌	新生児一過性低血糖症
除皮質硬直様	除皮質硬直	多尿
間歇跛行	間欠性跛行	症候性そう痒症
動脈瘤コイル塞栓術	動脈瘤	産科的創傷の血腫
紅斑散在	紅斑症	内反小趾
右膝疼痛	膝関節痛	症候性そう痒症
食思不振傾向	食欲不振	視路疾患
皮内腫瘍	腫瘍	糖原病
左前床突起部髄膜腫	髄膜腫	若年者キーンベック病
右脳梗塞	脳梗塞	産科的創傷の血腫
軽度腹部痛	腹痛症	総胆管のう腫
多発毛細血管拡張	オスラー病	サイトメガロウイルス脊髄炎
不整脈誘発	不整脈	甲状腺出血
左肺動脈ＰＥ	肺動脈血栓塞栓症	サイトメガロウイルス脊髄炎
胃潰瘍再発	胃潰瘍瘢痕	多尿
境界域精神発達遅滞	知的障害	症候性そう痒症
胆石膵炎	胆石性膵炎	手掌有棘細胞癌
右腕頭動脈瘤	腕頭動脈瘤	産科的創傷の血腫
外陰部ｐａｇｅｔ癌	外陰部パジェット病	傍矢状洞髄膜腫
リウマチ様症状	関節リウマチ	ＴＦＣＣ損傷
肺癌性リンパ管症	癌性リンパ管症	胸膜播種
左上腕骨顆部骨折	上腕骨顆部骨折	多尿
骨盤位妊娠	骨盤位	症候性そう痒症
大腿骨骨折後	大腿骨骨折	多尿
左椎間孔狭窄	結合組織性椎間孔狭窄症	頚部血管損傷後遺症
前立腺軽度腫大	前立腺肥大症	内反小趾
下顎腫脹	下顎部腫脹	内反小趾
鼻中隔弯曲	鼻中隔弯曲症	症候性そう痒症
大腸憩室症	多発性大腸憩室症	胸膜播種
逆流性食道炎無	逆流性食道炎	化膿性リンパ節炎
致死性偽膜性腸炎	偽膜性腸炎	膀胱白板症
眼窩蜂窩織炎	眼窩蜂巣炎	下顎打撲傷
排尿後痛	排尿痛	視路疾患
右腹痛	腹痛症	症候性そう痒症
嚥下耳痛	耳痛症	症候性そう痒症
茶色出血	出血	膀胱白板症
左下葉扁平上皮癌	下葉肺扁平上皮癌	若年者キーンベック病
右腎梗塞	腎梗塞	眼瞼異物残留
原発性ヘモクロマトーシス	ヘモクロマトーシス	胸膜播種
右前頭葉膠芽腫	前頭葉膠芽腫	前足部痛
急性水頭症	水頭症	膀胱白板症
活動性肺結核所見	活動性肺結核	胸膜播種
右眼白内障	白内障	化膿性リンパ節炎
本日胸痛	胸痛	症候性そう痒症
直腸膀膀胱窩	直腸膀胱瘻	前足部痛
頚部結核性リンパ節炎	結核性リンパ節炎	床形態歯周治療用装置破損
左橈骨遠位骨折	橈骨遠位端骨折	多尿
逆行性Ｐ波	心電図異常	化膿性リンパ節炎
しびれない	しびれ感	内反小趾
臀部圧痛	圧痛	症候性そう痒症
咽頭血腫	咽頭部血腫	肝腫瘤
膀胱癌再発	膀胱癌	新生児一過性低血糖症
多発皮下転移	皮下腫瘍	臍帯卵膜付着による新生児の障害
両側肺動脈血栓塞栓症	肺動脈血栓塞栓症	サイトメガロウイルス脊髄炎
副鼻腔病変	副鼻	化膿性リンパ節炎
安静時呼吸苦	呼吸困難	症候性そう痒症
左胸膜播種	胸膜播種	肝腫瘤
陰嚢疼痛	陰のう痛	角膜上皮損傷
上眼瞼腫脹	眼瞼浮腫	大動脈弁狭窄症兼三尖弁閉鎖不全症
右下肢複雑骨折	開放骨折	多尿
可動性良好腫瘤	腫瘤	第４趾有棘細胞癌
両頬部発赤	発赤	完全大血管転位症１型
感染性肝嚢胞	肝のう胞	視路疾患
左鼡径部腫脹	鼡径部腫脹	大動脈弁狭窄症兼三尖弁閉鎖不全症
突然呼吸困難	呼吸困難	肺活量減少
皮下出血斑	皮下出血	内反小趾
右下腿骨髄炎	大腿骨骨髄炎	総胆管のう腫
平行機能障害	平衡異常	症候性そう痒症
元々杖歩行	歩行障害	症候性そう痒症
両下肢腫脹	下肢腫脹	内反小趾
左傍矢状洞髄膜腫	傍矢状洞髄膜腫	若年者キーンベック病
限局性皮膚硬化型全身性強皮症	全身性強皮症	慢性肺気腫
毎回失禁	尿失禁症	膀胱白板症
右小脳腫瘍	小脳腫瘍	若年者キーンベック病
続発性サルコペニア	サルコペニア	胸膜播種
非医原性左尿管狭窄	尿管狭窄	胸膜播種
下腿血腫	血腫	床形態歯周治療用装置破損
逆流性膀胱炎	膀胱尿管逆流	眼瞼異物残留
覚醒時疼痛	疼痛	症候性そう痒症
左大転子部発赤	発赤	完全大血管転位症１型
卵巣原発腫瘍	卵巣腫瘍	床形態歯周治療用装置破損
リンパ腫再発	悪性リンパ腫	床形態歯周治療用装置破損
重度運動障害性構音障害	構音障害	症候性そう痒症
右肩周囲炎	肩周囲炎	肺動脈分岐部狭窄症
軽度動悸	動悸	症候性そう痒症
左ポスナーシュロスマン症候群	ポスナーシュロスマン症候群	化膿性リンパ節炎
液体貯留	体液貯留	床形態歯周治療用装置破損
低張性低ナトリウム血症	低ナトリウム血症	膀胱白板症
癌性胸腹膜炎	癌性腹膜炎	臍帯卵膜付着による新生児の障害
心臓内腫瘍	心臓腫瘍	床形態歯周治療用装置破損
左坐骨神経麻痺	坐骨神経麻痺	内反小趾
リステリア髄膜脳炎	リステリア性髄膜脳炎	膀胱白板症
点圧痛	圧痛	総胆管のう腫
帯状疱疹ウイルス脳炎	帯状疱疹性脳炎	胆のう瘻
齲蝕	う蝕	網膜静脈血栓症
腎性急性腎障害	腎障害	眼瞼異物残留
喉頭嚢胞	喉頭のう胞	突発性咽頭出血
甲状腺乳頭腺癌	甲状腺乳頭癌	突発性咽頭出血
左上下肢しびれ	半身しびれ	内反小趾
心筋傷害	心筋疾患	産科的創傷の血腫
圧迫性骨折	圧迫骨折	多尿
胆嚢胆石	胆泥	頭蓋癒合不全
縱隔リンパ節転移	縦隔リンパ節転移	臍帯卵膜付着による新生児の障害
悪性細胞	癌	突発性咽頭出血
Ｌｉｓｔｅｒｉａ　ｍｏｎｏｃｙｔｏｇｅｎｅｓ敗血症	敗血症	甲状腺出血
パニック症侯群	パニック障害	静脈内膜炎
アレルギー性肺アスペルギルス症	アレルギー性気管支肺アスペルギルス症	化膿性リンパ節炎
左下肢原発性リンパ浮腫	リンパ浮腫	内反小趾
呼気時喘鳴	喘鳴	症候性そう痒症
落ち着かない	多動性障害	膀胱白板症
苦悶症状	胸内苦悶	症候性そう痒症
トルーソー症候群	トルソー症候群	胸膜播種
全身浮腫不変	全身性浮腫	内反小趾
左側頭円蓋部髄膜腫	円蓋部髄膜腫	若年者キーンベック病
周術期喘息発作	気管支喘息発作	内反小趾
薬剤性副腎不全	副腎皮質機能低下症	前立腺膿瘍
乳がん	乳癌	視路疾患
巣状分節状糸球体硬化症	巣状糸球体硬化症	産科的創傷の血腫
口腔乾燥感	口腔乾燥症	膀胱白板症
右手関節尺側部痛	手関節痛	エーテル中毒症
右上顎洞真菌症	上顎洞炎	蚕蝕性角膜潰瘍
鮮血便	血便	膀胱白板症
心配症	心配	内側半月板断裂
アシドーシス進行	アシドーシス	化膿性リンパ節炎
右足滑液包炎	滑液包炎	膀胱白板症
第５胸椎転移	胸椎転移	床形態歯周治療用装置破損
表出性言語発達遅滞	言語発達遅滞	内反小趾
発作性心房細動既往	発作性心房細動	空腸瘻造設状態
左リウマチ性膝関節症	関節リウマチ・膝関節	多尿
左大腿部痛	大腿痛	内反小趾
隆起性病変	胃ポリープ症	内反小趾
腫瘤状構造	腫瘤	内反小趾
細菌性赤痢感染症	赤痢	化膿性リンパ節炎
多数骨折	骨折	多尿
門脈右枝血栓	門脈血栓症	床形態歯周治療用装置破損
３型進行癌	癌	抗生物質起因性腸炎
倦怠感等	倦怠感	症候性そう痒症
全頭脱毛症	脱毛症	第４趾有棘細胞癌
筋攣縮	筋痙縮	アフラトキシン中毒
元々徐脈	徐脈	症候性そう痒症
特発性側彎症	特発性側弯症	症候性そう痒症
回盲部放線菌症	放線菌症	膀胱白板症
ｆａｎ症候群	マルファン症候群	慢性歯肉炎
脊椎椎間板炎	椎間板炎	総胆管のう腫
起始異常	冠動脈起始異常	症候性そう痒症
右眼球破裂	眼球破裂	産科的創傷の血腫
介助　疼痛	疼痛	症候性そう痒症
前失神	失神	大動脈弁狭窄症兼僧帽弁閉鎖不全症兼三尖弁閉鎖不全症
ふらつき感自覚	よろめき歩行	膀胱白板症
低分化型肝細胞癌	肝細胞癌	突発性咽頭出血
右葉間胸水	葉間胸水	総胆管のう腫
子宮内膜症性卵巣嚢胞	卵巣子宮内膜症のう胞	前足部痛
腎嚢胞出血	傍腎盂のう胞	前足部痛
無症候性キャリア	ＨＴＬＶ−１キャリア	膀胱白板症
中等度腹水	腹水症	膀胱白板症
受容体脳炎	抗ＮＭＤＡ受容体脳炎	膀胱白板症
肛門部軽度発赤	肛門部周囲炎	化膿性リンパ節炎
側方リンパ節転移	リンパ節転移	慢性歯肉炎
左硝子体混濁	硝子体混濁	胸膜播種
統合失調症既往	統合失調症	症候性そう痒症
平衡機能障害	平衡障害	症候性そう痒症
肺腫瘤影	胸部異常陰影	手掌部皮下腫瘤
複雑型異型子宮内膜増殖症	腺腫性子宮内膜増殖症	正中頚のう胞
皮膚潰瘍形成	皮膚潰瘍	多尿
肝肥大	肝型糖原病	血小板放出機構異常症
紅斑腫脹	紅斑症	大動脈弁狭窄症兼三尖弁閉鎖不全症
腰部圧痛	腰痛症	内反小趾
元々不眠症	不眠症	化膿性リンパ節炎
左肩甲骨軟骨肉腫	肩甲骨軟骨肉腫	糖原病
肺血症性ショック	敗血症性ショック	胸膜播種
凝固線溶系異常	血液凝固異常	甲状腺出血
異所性静脈瘤	静脈瘤	産科的創傷の血腫
腫瘍崩壊	腫瘍	床形態歯周治療用装置破損
破壊性甲状腺炎	甲状腺炎	尿崩症
右腸骨ＬＮ転移	腸骨リンパ節転移	床形態歯周治療用装置破損
右腎被膜下血腫	血腫	前足部痛
全身性サルコイドーシス	サルコイドーシス	閃輝性融解
脱分化型脂肪肉腫	脂肪肉腫	中指屈筋腱癒着
非機能性下垂体腫瘍	下垂体腫瘍	床形態歯周治療用装置破損
ＡＣＴＨ分泌不全	ＡＣＴＨ分泌低下症	化膿性リンパ節炎
時々残尿感	残尿感	視路疾患
小人症	低身長症	内反小趾
右臼蓋転移	骨盤転移	手掌部皮下腫瘤
右頭頂葉脳梗塞	脳梗塞	産科的創傷の血腫
マルファン症候群合併	マルファン症候群	産科的創傷の血腫
右眼網膜症	網膜症	大動脈弁狭窄症兼僧帽弁閉鎖不全症兼三尖弁閉鎖不全症
咽喉頭炎	咽頭喉頭炎	総胆管のう腫
右下葉肺扁平上皮癌	下葉肺扁平上皮癌	ＨＴＬＶ−１感染症
足趾壊疽	趾壊死	多尿
左肺尖部腺癌	肺腺癌	臍帯卵膜付着による新生児の障害
潰瘍型間質性膀胱炎	間質性膀胱炎	臍帯卵膜付着による新生児の障害
紅色皮疹	発疹	腎脂肪腫
遺尿	遺尿症	胸膜播種
頚管狭窄	子宮頚管狭窄症	内反小趾
右腎門部腹側脂肪肉腫	腎周囲脂肪肉腫	前足部痛
左中頭蓋窩髄膜腫	中頭蓋窩髄膜腫	若年者キーンベック病
脳梗塞後後遺症	脳梗塞	産科的創傷の血腫
含歯性嚢胞	含歯性のう胞	突発性咽頭出血
紅斑熱	日本紅斑熱	膀胱白板症
多発頭蓋骨転移	骨転移癌	第４趾有棘細胞癌
Ｄａｎｌｏｓ症候群	エーラス・ダンロス症候群	胸膜播種
運動低下性構音障害	構音障害	症候性そう痒症
右重症下肢虚血	重症虚血肢	甲状腺出血
両側腸腰筋血腫	血腫	床形態歯周治療用装置破損
亀頭部発赤	発赤	内反小趾
肝嚢胞感染	肝のう胞	視路疾患
重症強迫性障害	強迫性障害	総胆管のう腫
顔面骨圧痛	圧痛	エーテル中毒症
左椎間板ヘルニア	椎間板ヘルニア	多尿
会陰部疼痛	外陰部痛	症候性そう痒症
咀嚼時痛	咀嚼筋痛障害	症候性そう痒症
左膝関節偽痛風	膝関節偽痛風	症候性そう痒症
２次性副甲状腺機能亢進症	副甲状腺機能亢進症	第２腰椎病的骨折
右上腕蜂窩織炎	上腕蜂巣炎	総胆管のう腫
右前大脳動脈未破裂動脈瘤	前大脳動脈瘤	産科的創傷の血腫
リウマチ性胸水	リウマチ性肺疾患	多尿
右眼白内障手術	白内障	産科的創傷の血腫
悪性リンハ゜腫	悪性リンパ腫	大動脈弁狭窄症兼三尖弁閉鎖不全症
胆管腫瘍栓	胆管腫瘍	床形態歯周治療用装置破損
右基底核梗塞	脳梗塞	産科的創傷の血腫
境界型耐糖能障害	耐糖能異常	膀胱白板症
リウマチ疾患	関節リウマチ	多尿
白内障Ｏ	白内障	化膿性リンパ節炎
心房細動停止	心房細動	甲状腺出血
帯状疱疹既往	帯状疱疹	斜台部脊索腫
腫瘤所見	腫瘤	内反小趾
ＶＨＬ病	フォンヒッペル・リンダウ病	胸膜播種
時折血痰	血痰	内側半月板断裂
陰嚢部腫脹	陰のう腫大	大動脈弁狭窄症兼三尖弁閉鎖不全症
帰室時疲労感	疲労感	症候性そう痒症
高分化型腺癌	癌	突発性咽頭出血
糖尿病等	糖尿病	視路疾患
Ｍｙｃｏｂａｃｔｅｒｉｕｍ　ｓｈｉｇａｅｎｓｅ感染症	非結核性抗酸菌症	化膿性リンパ節炎
後腹膜腫瘍切除術	後腹膜腫瘍	多尿
肺転移発覚	転移性肺腫瘍	胸膜播種
右中咽頭癌	中咽頭癌	斜台部脊索腫
両側肺動脈血栓塞栓	動脈血栓症	サイトメガロウイルス脊髄炎
臀部炎症性粉瘤	粉瘤	床形態歯周治療用装置破損
左耳耳鳴	耳鳴症	症候性そう痒症
鼠経ヘルニア	鼡径ヘルニア	網膜静脈血栓症
鼻閉塞	鼻閉	気道閉塞
疲労感等	疲労感	症候性そう痒症
日中掻痒感	そう痒	急性顎骨骨髄炎
前交通動脈未破裂脳動脈瘤	未破裂脳動脈瘤	産科的創傷の血腫
夜間低酸素血症	低酸素血症	肺活量減少
薬剤性腎不全	薬剤性腎障害	眼瞼異物残留
気管支狭窄	気管支狭窄症	化膿性リンパ節炎
腫瘍増悪	腫瘍	床形態歯周治療用装置破損
急性軸索障害	びまん性軸索損傷	総胆管のう腫
完全型ベーチェット病	ベーチェット病	胸膜播種
筋肉痙攣	痙攣	内反小趾
癌性髄膜腫症	悪性髄膜腫	若年者キーンベック病
化膿性脊椎椎間板炎	化膿性椎間板炎	足底部打撲傷
呼吸性雑音	胸部音異常	肺活量減少
真菌塊	真菌症	多尿
両肩関節圧痛	圧痛	エーテル中毒症
多発肝細胞癌	肝腫瘍	若年者キーンベック病
右腎小嚢胞	傍腎盂のう胞	前腕血栓性静脈炎
左横隔膜神経麻痺	横隔神経麻痺	産科的創傷の血腫
右高度水腎症	水腎症	視路疾患
創傷治癒遅延	創傷	多尿
上腫瘍	腫瘍	床形態歯周治療用装置破損
進行性食道癌	食道癌	抗生物質起因性腸炎
複雑性熱性痙攣	熱性痙攣	内反小趾
先天性鼻咽腔閉鎖不全症	先天性鼻咽腔閉鎖不全	気道閉塞
右眼鼻涙管閉塞症	鼻涙管閉鎖症	気道閉塞
縦隔原発Ｂ細胞大細胞型リンパ腫	縦隔原発大細胞型Ｂ細胞性リンパ腫	慢性歯肉炎
左半視野障害	視野障害	静脈内膜炎
大腿骨近位部骨折	大腿骨骨折	多尿
左踵部痛	踵痛	角膜上皮損傷
ポリープ様隆起	ポリープ	内反小趾
刺激性皮膚炎	皮膚炎	膀胱白板症
慢性緑膿菌感染	緑膿菌感染症	化膿性リンパ節炎
回腸閉塞	回腸狭窄	鼻下擦過創
尾部嚢胞	膵のう胞	前足部痛
虫刺症	蜂刺症	膀胱白板症
第二趾爪囲炎	爪囲炎	大動脈弁狭窄症兼僧帽弁閉鎖不全症兼三尖弁閉鎖不全症
膵仮性嚢胞破裂	仮性膵のう胞	突発性咽頭出血
シェーンラインヘノッホ紫斑病	ＩｇＡ血管炎	化膿性リンパ節炎
記銘障害	記銘力低下	症候性そう痒症
上歯肉癌	上顎歯肉癌	若年者キーンベック病
チャーグ－ストラウス症候群	好酸球性多発血管炎性肉芽腫症	静脈内膜炎
低ＡＴⅢ血症	アンチトロンビン欠乏症	胸膜播種
超皮質性感覚性失語	皮質下感覚性失語症	内反小趾
ＮＯＭＩ	腸壊死	多尿
肥厚性幽門狭窄	肥厚性幽門狭窄症	ヘルペスウイルス性湿疹
問題なし脊柱管狭窄症	脊柱管狭窄症	気道閉塞
左踵骨裂離骨折	踵骨骨折	第４趾有棘細胞癌
慢性糸球体炎	糸球体腎炎	膀胱白板症
左眼結膜下出血	結膜下出血	第４趾有棘細胞癌
子宮頸部上皮内腫瘍	子宮頚部上皮内腫瘍	臍帯卵膜付着による新生児の障害
左腰部有棘細胞癌	腰部有棘細胞癌	若年者キーンベック病
糖尿病罹患	糖尿病	視路疾患
四肢圧痛	圧痛	内反小趾
関節変形	関節奇形	多尿
気分変動	気分変調症	内側半月板断裂
左鎖骨下動脈起始異常	鎖骨下動脈起始異常	内反小趾
立位バランス練習重症筋無力症	重症筋無力症	甲状腺出血
腰椎脊柱管狭窄	腰部脊柱管狭窄症	内反小趾
左上葉小細胞肺癌	上葉小細胞肺癌	抗生物質起因性腸炎
左後縦隔腫瘍	後縦隔腫瘍	産科的創傷の血腫
食道カンジタ症合併ＨＩＶ感染症	ＨＩＶカンジダ病	化膿性リンパ節炎
固縮無動	こわばり	内反小趾
小体認知症	認知症	膀胱白板症
突然腹痛	腹痛症	総胆管のう腫
尿閉気味	尿閉	頚部腫瘤
生検部感染徴候	創傷感染症	視路疾患
痛風症状	痛風	膀胱白板症
脳転移新出	転移性脳腫瘍	胸膜播種
両側肩関節痛	肩関節痛症	エーテル中毒症
右眼下鼻側視野異常	視野障害	大動脈弁狭窄症兼僧帽弁閉鎖不全症兼三尖弁閉鎖不全症
右肺Ｓ４原発腺癌	肺腺癌	ＨＴＬＶ−１感染症
右肘関節骨折	肘関節骨折	多尿
両耳下腺腫脹	耳下腺腫脹	内反小趾
再下血	下血	眼部外傷性異物
両変形性股関節症	変形性股関節症	ＴＥＬ−ＡＭＬ１陽性Ｂリンパ芽球性白血病／リンパ腫
喘息コントロール不良	咳喘息	肺活量減少
腹部大動脈狭窄症	大腿動脈狭窄症	第４趾有棘細胞癌
左肺良性腫瘍	肺良性腫瘍	蚕蝕性角膜潰瘍
頸動脈狭窄症	内頚動脈狭窄症	産科的創傷の血腫
若年結核性腹膜炎	結核性腹膜炎	膀胱白板症
発赤部分	発赤	完全大血管転位症１型
大腸疾患	腸疾患	胸膜播種
頚部血腫	頚部表在損傷	床形態歯周治療用装置破損
肺雑聴取	胸部音異常	症候性そう痒症
急性冠症候群発症	急性冠症候群	産科的創傷の血腫
皮下浮腫	浮腫	視路疾患
低活動型せん妄	せん妄	化膿性リンパ節炎
左化膿性耳下腺炎	化膿性耳下腺炎	化膿性リンパ節炎
痔核症状	痔核	肺活量減少
拘束性心筋症	拘束型心筋症	産科的創傷の血腫
右内頸動脈血栓閉塞	動脈血栓症	産科的創傷の血腫
肝うっ血	うっ血肝	床形態歯周治療用装置破損
ＣＮＩ腎症	薬剤性腎障害	眼瞼異物残留
浮腫軽減	浮腫	視路疾患
胃液様	嘔吐症	床形態歯周治療用装置破損
右鼡径部出血	出血	第４趾有棘細胞癌
右肺上葉肺炎	肺炎	むちうち損傷
膠原病外来	膠原病	床形態歯周治療用装置破損
門亢症	門脈圧亢進症	化膿性リンパ節炎
在型食道癌	食道癌	抗生物質起因性腸炎
創内異物	外傷性異物	内反小趾
膀胱内尿貯留	後腹膜尿貯留	新生児一過性低血糖症
肢痛	疼痛	内反小趾
肺結核性腹膜炎	結核性腹膜炎	肺活量減少
腸管内血腫	血腫	床形態歯周治療用装置破損
ネフローゼ状態	ネフローゼ症候群	胸膜播種
軽度僧帽弁逆流症	僧帽弁逆流症	内反小趾
前胸部粉瘤	粉瘤	多尿
左室中部閉塞性肥大型心筋症	閉塞性肥大型心筋症	産科的創傷の血腫
しびれがきつい	しびれ感	内反小趾
両側内耳奇形	内耳先天奇形	症候性そう痒症
完全右脚ブロック指摘	完全右脚ブロック	多尿
肛門部潰瘍	肛門潰瘍	大動脈弁狭窄症兼三尖弁閉鎖不全症
臀部紅斑	紅斑症	致死型表皮水疱症
アレルギ—性鼻炎	アレルギー性鼻炎	化膿性リンパ節炎
末節骨骨折	骨折	多尿
脊椎症性変化	脊椎症	内反小趾
腸閉塞気味	イレウス	症候性そう痒症
浅呼吸	呼吸困難	内側半月板断裂
無症候性狭心症	狭心症	内側半月板断裂
右顎下リンパ節腫脹	顎下リンパ節腫脹	若年者キーンベック病
左側頭葉海綿状血管腫	側頭葉海綿状血管腫	糖原病
直腸癌術後直腸癌	直腸癌	若年者キーンベック病
痛覚消失	異常知覚	症候性そう痒症
膵炎再燃	膵炎	視路疾患
肘頭部潰瘍	前腕皮膚潰瘍	多尿
反復性腸閉塞	イレウス	肩甲骨外骨腫
胎児腹水	胎児水腫	膀胱白板症
失見当識障害	見当識障害	症候性そう痒症
皮膚ツルゴール低下	脱水症	内反小趾
右肩悪性軟部腫瘍	悪性軟部腫瘍	中指屈筋腱癒着
非定型うつ	非定型うつ病	症候性そう痒症
右中指スワンネック変形肩関節	スワンネック変形	多尿
胸郭運動異常	胸郭異常	症候性そう痒症
前頭蓋底腫瘍	頭蓋底腫瘍	内反小趾
腹部肥満	肥満症	総胆管のう腫
Ｓ状結腸粘膜下腫瘤	腫瘤	若年者キーンベック病
両側下腿圧痕性浮腫	下腿浮腫	内反小趾
動脈瘤様骨嚢腫	動脈瘤様骨のう腫	床形態歯周治療用装置破損
軟性腫瘤	腫瘤	第４趾有棘細胞癌
本日疼痛	疼痛	症候性そう痒症
出血軽度	出血	内側半月板断裂
軽度間歇性跛行	間欠性跛行	症候性そう痒症
蛋白血症	異常蛋白血症	膀胱白板症
不眠時２錠	不眠症	躁病発作
後縦隔膿瘍	縦隔膿瘍	臍帯卵膜付着による新生児の障害
胸水排出	胸水貯留	総胆管のう腫
ＡＩＤＳ非定型抗酸菌症	非結核性抗酸菌症	線維筋痛症
尺側神経麻痺	尺骨神経麻痺	大動脈弁狭窄症兼僧帽弁閉鎖不全症兼三尖弁閉鎖不全症
徐脈等	徐脈	症候性そう痒症
てんかんの発作	てんかん	ＣＭ関節脱臼
腹部大動脈石灰化	大動脈石灰化症	第４趾有棘細胞癌
サルコイドーシス疑	サルコイドーシス	類宦官症
左片麻痺	片麻痺	内反小趾
足部冷感	下肢冷感	症候性そう痒症
下痢〜水様便	下痢症	化膿性リンパ節炎
コレステロールポリープ	ポリープ	静脈瘤性動脈瘤
１型糖尿除	糖尿	胸膜播種
関節固縮	関節拘縮	多尿
肺多型癌	癌	胸膜播種
慢性アレルギ—性鼻炎	アレルギー性鼻炎	化膿性リンパ節炎
下顎骨正中部骨折	下顎正中部骨折	多尿
後嘔吐	嘔吐症	膀胱白板症
気分不快出現	悪心	膀胱白板症
劇症Ａ群溶連菌感染症	劇症型Ａ群連鎖球菌感染症	温熱じんま疹
内腸骨静脈血栓症	静脈血栓症	床形態歯周治療用装置破損
軽度咽頭期嚥下障害	嚥下障害	症候性そう痒症
舌根扁桃炎	扁桃炎	膀胱白板症
右肺上葉小細胞癌	上葉小細胞肺癌	抗生物質起因性腸炎
ＣＭＶ網膜症	サイトメガロウイルス網膜炎	傍矢状洞髄膜腫
脊椎側弯症	脊柱側弯症	総胆管のう腫
悪心Ｇ１	悪心	視路疾患
上腹部鈍痛	上腹部痛	総胆管のう腫
脊髄視神経炎	視神経炎	大動脈弁狭窄症兼僧帽弁閉鎖不全症兼三尖弁閉鎖不全症
本日血尿	血尿	視路疾患
クラミジア頸管炎	クラミジア頚管炎	産科的創傷の血腫
性急性リンパ性白血病	急性リンパ性白血病	急性小腸虚血
周囲リンパ節腫大	リンパ節腫大	床形態歯周治療用装置破損
印環細胞癌	癌	抗生物質起因性腸炎
６月肝転移	転移性肝腫瘍	前足部痛
左内頸動脈中等度狭窄	頚動脈硬化症	産科的創傷の血腫
左外耳道閉鎖	外耳道閉鎖	第４趾有棘細胞癌
右鼡径部ヘルニア	鼡径ヘルニア	足背部第２度熱傷
ＭＬＦ症候群	核間性眼筋麻痺	胸膜播種
醜形恐怖	醜形恐怖症	症候性そう痒症
肩関節疼痛	肩関節痛症	症候性そう痒症
右手痺れ	上肢しびれ	内反小趾
逆流感	胃食道逆流症	症候性そう痒症
播種性クリプトコックス症	播種性クリプトコッカス症	術後甲状腺機能低下症
左尿管導管吻合部狭窄	吻合部狭窄	温熱じんま疹
口唇落屑	皮膚落屑	総胆管のう腫
時折不整	不整脈	症候性そう痒症
僧帽弁狭窄症兼閉鎖不全症	僧帽弁狭窄症	外耳道母斑細胞母斑
伸筋腱脱臼	脱臼	アフラトキシン中毒
両下腿潰瘍	下腿皮膚潰瘍	多尿
内転障害	眼球運動痙攣	症候性そう痒症
びまん性リンパ腫	リンパ腫	床形態歯周治療用装置破損
多発嚢胞腎	多発性のう胞腎	前腕血栓性静脈炎
足首骨折	足関節骨折	多尿
右目白内障	白内障	蚕蝕性角膜潰瘍
嘔吐１回	嘔吐症	膀胱白板症
深夜低血糖	夜間低血糖症	膀胱白板症
過敏症状	過敏症	肺活量減少
高Ｂｉｌ血症	高ビリルビン血症	胸膜播種
右足小指骨折	小指骨折	多尿
第一腰椎破裂骨折	腰椎破裂骨折	多尿
せん妄発言	せん妄	化膿性リンパ節炎
ヒステリー症状	ヒステリー反応	化膿性リンパ節炎
歩行時創部痛	術創部痛	症候性そう痒症
パニック	パニック障害	内反小趾
正色素性正球性貧血	正球性正色素性貧血	慢性歯肉炎
右足腫脹	足部腫脹	内反小趾
両肺胸膜肥厚	胸膜肥厚	多尿
ＡＰＳ	抗リン脂質抗体症候群	化膿性リンパ節炎
脳圧亢進症状	頭蓋内圧亢進症	膀胱白板症
眼鏡　近視	近視	化膿性リンパ節炎
二次性ヘモクロマトーシス	ヘモクロマトーシス	傍矢状洞髄膜腫
潜在性副甲状腺機能低下症	副甲状腺機能低下症	子宮線維症
両眼瞼黄色腫	眼瞼黄色腫	突発性咽頭出血
右内腸骨動脈狭窄	動脈狭窄	第４趾有棘細胞癌
正中頚嚢胞	正中頚のう胞	前足部痛
両側尿管結石	尿管結石症	前足部痛
高血圧状態	高血圧症	内側半月板断裂
喀血症状	喀血	膀胱白板症
指発赤	発赤	膀胱乳頭腫
Ⅱａ型高脂血症	高脂血症	子宮線維症
右手橈骨骨折	橈骨骨折	多尿
右睾丸痛	精巣痛	角膜上皮損傷
本日血便	血便	膀胱白板症
回腸出血	腸出血	内側半月板断裂
左副腎出血	副腎出血	眼瞼異物残留
後頭蓋下髄膜腫	髄膜腫	内反小趾
急性前壁中隔梗塞	急性前壁中隔心筋梗塞	産科的創傷の血腫
右顔面部帯状疱疹	顔面帯状疱疹	斜台部脊索腫
びまん性管内増殖性糸球体腎炎	慢性びまん性管内増殖性糸球体腎炎	頚部腫瘤
傍腹部大動脈リンパ節腫大	リンパ節腫大	床形態歯周治療用装置破損
左上腕脂肪腫	上腕脂肪腫	足底部打撲傷
尿道口発赤	発赤	化膿性リンパ節炎
冠動脈狭窄症	冠状動脈狭窄症	産科的創傷の血腫
膵石灰化	膵石灰化症	突発性咽頭出血
丘疹様	丘疹	腎脂肪腫
肺上葉原発性肺癌	原発性肺癌	胸膜播種
労作時胸部不快	労作時呼吸困難	症候性そう痒症
２型＋ステロイド性糖尿病	ステロイド糖尿病	胸膜播種
腫瘤縮小	腫瘤	第４趾有棘細胞癌
Ｓａｌｍｏｎｅｌｌａ　ｅｎｔｅｒｉｔｉｄｉｓ敗血症	サルモネラ敗血症	甲状腺出血
グル音異常	異常腸音	肺活量減少
鉄吸収障害	鉄欠乏症	内側半月板断裂
水中毒症状	水中毒	肺活量減少
鼻中隔彎曲	鼻中隔弯曲症	症候性そう痒症
本日右眼白内障	白内障	化膿性リンパ節炎
過敏性腸症侯群	過敏性腸症候群	ＨＴＬＶ−１感染症
会話性幻聴	幻聴	症候性そう痒症
筋疲労感	筋疲労	総胆管のう腫
水疱後びらん	水疱症	内反小趾
胆管内結石	胆管結石症	腰部尋常性乾癬
時々せん妄	せん妄	突発性咽頭出血
処置後膵炎	膵炎	視路疾患
術後右反回神経麻痺	術後性反回神経麻痺	大動脈弁狭窄症兼僧帽弁閉鎖不全症兼三尖弁閉鎖不全症
反復性細菌感染	細菌感染症	肺活量減少
ｗｉｄｅ　ＱＲＳ頻拍	頻拍症	甲状腺出血
両側性末梢性顔面神経麻痺	末梢性顔面神経麻痺	内反小趾
皮膚軟部組織感染症	皮膚感染症	仙骨骨折
腰痛ヘルニア	椎間板ヘルニア性腰痛症	内反小趾
イレウス合併	イレウス	胸膜播種
息苦しく	呼吸困難	症候性そう痒症
肺好酸球性肉芽腫	肺好酸球性肉芽腫症	突発性咽頭出血
無菌性腸炎	非感染性腸炎	膀胱白板症
骨盤内リンパ嚢腫	骨盤部感染性リンパのう胞	床形態歯周治療用装置破損
両側眼瞼下垂症	眼瞼下垂症	気道閉塞
両側性結核性胸膜炎	結核性胸膜炎	臍帯卵膜付着による新生児の障害
甲状腺機能亢進症状	甲状腺機能亢進症	化膿性リンパ節炎
平坦Ｔ波	心電図異常	内反小趾
ペーシング不全	両室ペーシング機能付き植込型除細動器不全	化膿性リンパ節炎
後頭部打撲	頭部打撲	内反小趾
薬剤性過敏症候群	薬剤性過敏症症候群	胸膜播種
両側喉頭肉芽腫	喉頭肉芽腫	内反小趾
ふらつきあり	めまい	膀胱白板症
右鼡径ヘルニア	鼡径ヘルニア	足背部第２度熱傷
職業性ストレス	急性ストレス反応	膀胱白板症
卵管水腫	卵管留水症	床形態歯周治療用装置破損
左下葉原発性肺扁平上皮癌	肺扁平上皮癌	サイトメガロウイルス脊髄炎
外気胸	気胸	視路疾患
ポリープ数個	ポリープ	化膿性リンパ節炎
右低音障害型感音難聴	急性低音障害型感音難聴	症候性そう痒症
外陰部血腫	外陰血腫	床形態歯周治療用装置破損
左乳突蜂巣炎	乳様突起炎	膀胱白板症
未破裂左内頸動脈瘤	内頚動脈瘤	産科的創傷の血腫
中咽頭側壁扁平上皮癌	癌	ＴＦＣＣ損傷
ＥＶＡＮＳ症候群	エバンス症候群	産科的創傷の血腫
右聴神経腫瘍	聴神経腫瘍	産科的創傷の血腫
両肺多発結節性陰影	胸部異常陰影	シーハン症候群
左血腫	血腫	床形態歯周治療用装置破損
早期乳癌	乳癌	抗生物質起因性腸炎
脾臓腫瘤	腫瘤	床形態歯周治療用装置破損
多発髄膜腫	多発性髄膜腫	若年者キーンベック病
術中出血多	多量出血	内反小趾
先天性嚢胞肺	先天性のう胞肺	化膿性リンパ節炎
手背部疼痛	手背部痛	症候性そう痒症
腹部大動脈嚢状瘤	腹部大動脈瘤	産科的創傷の血腫
腫瘍感染合併	腫瘍	床形態歯周治療用装置破損
ＩＰ合併	間質性肺炎	胸膜播種
左腫瘤	腫瘤	第４趾有棘細胞癌
ゾメタ骨髄炎	骨髄炎	床形態歯周治療用装置破損
葉酸欠乏	葉酸欠乏症	膀胱白板症
右胸膜原発血管肉腫	血管肉腫	臍帯卵膜付着による新生児の障害
拘縮気味	筋拘縮症	総胆管のう腫
手関節圧痛	圧痛	エーテル中毒症
浮腫残存	浮腫	内反小趾
非てんかん性心因性発作	てんかん	甲状腺出血
鼻口蓋管嚢胞	鼻口蓋管のう胞	突発性咽頭出血
下腸間膜動脈閉塞	腸間膜動脈塞栓症	サイトメガロウイルス脊髄炎
右中大脳動脈領域梗塞	中大脳動脈閉塞症	産科的創傷の血腫
消化管腫瘤	腫瘤	多尿
脛骨前面圧痕性浮腫	浮腫	多尿
多少眠気	非器質性過眠症	内側半月板断裂
高濃度腫瘤	腫瘤	内反小趾
ＤＧＥ症状	消化管術後後遺症	内反小趾
過形成性ポリープ	胃過形成ポリープ	胸膜播種
日光アレルギー	光線過敏症	化膿性リンパ節炎
両膝痛	膝関節痛	エーテル中毒症
こわばりあり	こわばり	内反小趾
慢性炎症性腸疾患	腸炎	視路疾患
尺骨頭脱臼	脱臼	第４趾有棘細胞癌
けいれん症状	痙攣	視路疾患
重度三尖弁閉鎖不全症	三尖弁閉鎖不全症	外耳道母斑細胞母斑
肺炎併発	肺炎	子宮線維症
右下肢感覚鈍麻	感覚異常症	内反小趾
第二度房室ブロック	第２度房室ブロック	静脈内膜炎
慢性進行性肺アスペルギルス症	肺アスペルギルス症	化膿性リンパ節炎
点状発赤	発赤	完全大血管転位症１型
白血病化	白血病	膀胱白板症
消退性発赤	発赤	化膿性リンパ節炎
ヒステリー	ヒステリー反応	化膿性リンパ節炎
手指皮疹	発疹	膀胱白板症
残尿	残尿感	胸膜播種
腫脹圧痛	圧痛	若年性特発性関節炎・肩関節
ループスアンチコアグラント陰性	ループスアンチコアグラント	胸膜播種
両肺気胸	気胸	症候性そう痒症
右肺胸水貯留	胸水貯留	むちうち損傷
血性吐物	吐血	膀胱白板症
両側腓骨神経麻痺	腓骨神経麻痺	内反小趾
廃用	廃用症候群	肺活量減少
浮動感	めまい	視路疾患
軽度右室肥大	右室肥大	内反小趾
右膝蜂窩織炎	膝部蜂巣炎	淋菌性腹膜炎
強制換気	人工呼吸器装着状態	内側半月板断裂
２型＋ステロイド糖尿病	ステロイド糖尿病	胸膜播種
左下肢ガス壊疽	ガス壊疽	多尿
低血糖用	低血糖	膀胱白板症
喚語障害	不全失語症	症候性そう痒症
右足底潰瘍	足底皮膚潰瘍	多尿
右網膜静脈分枝閉塞症	網膜静脈分枝閉塞症	産科的創傷の血腫
腹痛時	腹痛症	症候性そう痒症
多動多弁	多動性障害	甲状腺出血
右手背浮腫	限局性浮腫	完全大血管転位症１型
足趾しびれ	下肢しびれ	症候性そう痒症
突然意識障害	意識障害	症候性そう痒症
足底痺れ	しびれ感	内反小趾
角膜ヘルペス	ヘルペス角膜炎	内反小趾
食思不振症状	食欲不振	腹膜中皮腫
細菌性食道炎	食道炎	化膿性リンパ節炎
開大代謝性アシドーシス	代謝性アシドーシス	胸膜播種
心因性過食症	心因性過食	視路疾患
術後肺転移	転移性肺腫瘍	胸膜播種
転移性腫瘤	転移性腫瘍	第４趾有棘細胞癌
夜間尿意	夜間頻尿症	視路疾患
右下腿腫脹	下腿腫脹	内反小趾
背部皮脂欠乏性湿疹	皮脂欠乏性湿疹	膀胱白板症
足爪白鮮	足爪白癬	多尿
神経性疼痛	神経痛	症候性そう痒症
房室接合部調律	異所性調律	症候性そう痒症
末梢循環不全徴候	末梢循環不全	静脈瘤性動脈瘤
眼瞼下垂自覚	眼瞼下垂症	気道閉塞
右上顎洞乳頭腫	上顎洞乳頭腫	若年者キーンベック病
帯状疱疹拡大	帯状疱疹	斜台部脊索腫
左尾状核ラクナ硬塞	ラクナ梗塞	産科的創傷の血腫
ＳＭＡ閉塞	急性上腸間膜動脈閉塞症	サイトメガロウイルス脊髄炎
めまいの発作	めまい	内反小趾
呼吸切迫	急性呼吸窮迫症候群	症候性そう痒症
劇症型連鎖球菌感染症	連鎖球菌感染症	閃輝性融解
腹部疝痛	仙痛	症候性そう痒症
胆嚢多発ポリープ	胆のうポリープ	乳歯歯根吸収不全
柑皮症	カロチン血症	２型糖尿病性末梢神経障害
浮腫状	浮腫	視路疾患
陰部掻痒	外陰部そう痒症	総胆管のう腫
十二指腸多発びらん	十二指腸びらん	第４趾有棘細胞癌
前立性肥大症	前立腺肥大症	内反小趾
嘔気状況	嘔気	視路疾患
両側眼球外転障害	眼球運動障害	静脈内膜炎
元々浮腫	浮腫	視路疾患
左小脳出血	小脳出血	第４趾有棘細胞癌
躁うつ	躁うつ病	視路疾患
夜間失禁	尿失禁症	大動脈弁狭窄症兼僧帽弁閉鎖不全症兼三尖弁閉鎖不全症
ベージェット病	ベーチェット病	胸膜播種
元来頭痛	頭痛	内反小趾
褥瘡発生リスク低い	褥瘡	膀胱乳頭腫
下部直腸癌	直腸癌	大動脈弁狭窄症兼三尖弁閉鎖不全症
両側総腸骨動脈狭窄	総腸骨動脈狭窄	産科的創傷の血腫
牽引痛	牽引性頭痛	症候性そう痒症
Ⅱ度熱傷	熱傷	多尿
重度感覚障害	体感異常	症候性そう痒症
両側肺尖部進行性胸膜肥厚	胸膜肥厚	多尿
婦人入院脳梗塞	脳梗塞	産科的創傷の血腫
炎症性ポリープ多発	ポリープ	化膿性リンパ節炎
右坐骨結節転移再発	転移性腫瘍	産科的創傷の血腫
ダンピング症候群併発	ダンピング症候群	内反小趾
右上肢痺れ	しびれ感	内反小趾
ＭＣＴＤ	混合性結合組織病	多尿
ループスアンチコアグラント陽性	ループスアンチコアグラント	化膿性リンパ節炎
昨日水様便	下痢症	化膿性リンパ節炎
気分不快増強	悪心	内側半月板断裂
拡張期高血圧	高血圧症	甲状腺出血
右気管支肺炎	気管支肺炎	子宮線維症
左頸部リンパ節腫大	薬剤性自己免疫性溶血性貧血	若年者キーンベック病
右低音部感音難聴	感音難聴	症候性そう痒症
ＰＨＴ	肺高血圧症	胸膜播種
夜間失見当	見当識障害	症候性そう痒症
劇症型髄膜炎菌感染症	髄膜炎菌感染症	膀胱白板症
物忘れ気	健忘症	症候性そう痒症
両難聴	難聴	症候性そう痒症
左腎細胞癌	腎細胞癌	前腕血栓性静脈炎
多発膵転移	転移性膵腫瘍	新生児一過性低血糖症
両眼白内障手	白内障	角膜上皮損傷
右手関節滑膜炎	滑膜炎	総胆管のう腫
膠原病由来	膠原病	床形態歯周治療用装置破損
声門上喉頭癌	喉頭癌	斜台部脊索腫
右膝メルケル細胞癌	メルケル細胞癌	若年者キーンベック病
右椎骨動脈起始部狭窄	椎骨動脈狭窄症	産科的創傷の血腫
加害妄想	妄想反応	症候性そう痒症
嚢胞性胸腺腫	胸腺腫	前足部痛
急性乳突洞炎	急性中耳炎	産科的創傷の血腫
舌内リンパ節転移	リンパ節転移	臍帯卵膜付着による新生児の障害
悪性リンパ腫既往	悪性リンパ腫	突発性咽頭出血
左肺下葉腫瘤影	肺腫瘤	淋菌性腹膜炎
Ｌ３圧迫骨折	圧迫骨折	多尿
左感音性難聴	感音難聴	症候性そう痒症
腎臓疾患	腎疾患	眼瞼異物残留
ＣＯＰＤＩ期	慢性閉塞性肺疾患	胸膜播種
転倒歴多数	よろめき歩行	多尿
ＤＩＨＳ	薬疹	視路疾患
夜勤帯下血	下血	大動脈弁狭窄症兼僧帽弁閉鎖不全症兼三尖弁閉鎖不全症
インスリン依存性糖尿病	１型糖尿病	視路疾患
頸部椎間板ヘルニア	頚椎椎間板ヘルニア	多尿
右眼網膜裂孔	網膜裂孔	産科的創傷の血腫
拍動性疼痛	疼痛	症候性そう痒症
下血増悪	下血	内側半月板断裂
ＤＭ性腎不全	糖尿病性腎不全	眼瞼異物残留
膝関節軽度屈曲拘縮	屈曲拘縮	多尿
ＡＴＬ	成人Ｔ細胞白血病リンパ腫	胸膜播種
肺動脈弁閉鎖不全	肺動脈弁閉鎖	産科的創傷の血腫
熱感軽度	ほてり	症候性そう痒症
重度不眠	不眠症	躁病発作
咀嚼困難感	咀嚼障害	症候性そう痒症
食道圧迫	食道圧迫症	症候性そう痒症
両足関節痛	足関節痛	エーテル中毒症
術後肝転移	転移性肝癌	前足部痛
朝低血糖	低血糖	膀胱白板症
喘息疑い	咳喘息	症候性そう痒症
顔皮疹	発疹	若年性特発性関節炎・肩関節
子宮筋腫有	子宮筋腫	産科的創傷の血腫
淡明細胞型腎細胞癌	腎細胞癌	前腕血栓性静脈炎
浮腫生	浮腫	鼻下擦過創
再出血徴候	出血	多尿
アシネトバクター敗血症	敗血症	甲状腺出血
左自然気胸再発	自然気胸	斜台部脊索腫
高度肥満２型糖尿病	２型糖尿病	視路疾患
右大腿骨骨肉腫	大腿骨骨肉腫	多尿
左腎盂腎炎治癒後	腎盂腎炎	眼瞼異物残留
二次性水頭症	外傷後水頭症	膀胱白板症
ダグラス窩播種	腹膜播種	肝腫瘤
左室拡張能低下	左室不全	化膿性リンパ節炎
ウィルス感染症	ウイルス感染症	むちうち損傷
左手尺骨神経麻痺	尺骨神経麻痺	内反小趾
周期性呼吸時折	周期性呼吸	症候性そう痒症
異常帯下	帯下	膀胱白板症
多発性大腸ポリープ	大腸ポリープ	胸膜播種
糖尿病用	糖尿病	視路疾患
術前心電図異常	心電図異常	肺活量減少
中耳炎症状	中耳炎	大動脈弁狭窄症兼僧帽弁閉鎖不全症兼三尖弁閉鎖不全症
脱力症状	脱力感	膀胱白板症
上半身掻痒感	そう痒	急性顎骨骨髄炎
動揺性めまい	めまい	症候性そう痒症
褥瘡発生歴	褥瘡	角膜上皮損傷
水分摂取困難	嚥下障害	膀胱白板症
趾爪囲炎	爪囲炎	網膜静脈血栓症
右下葉原発低分化腺癌	癌	突発性咽頭出血
挙上期誤嚥	異物誤嚥	大動脈弁狭窄症兼僧帽弁閉鎖不全症兼三尖弁閉鎖不全症
腹部膨満増強	腹部膨満	内反小趾
右副腎腫瘍摘出術	副腎腫瘍	臍帯卵膜付着による新生児の障害
右鎖骨痛	鎖骨痛	多尿
細菌性扁桃炎	扁桃炎	化膿性リンパ節炎
左歯性上顎洞炎	歯性上顎洞炎	症候性そう痒症
重度歯周病	歯周症	内反小趾
正常圧緑内障	緑内障	化膿性リンパ節炎
梗塞後出血	出血性脳梗塞	第４趾有棘細胞癌
骨髄異型性症候群	骨髄異形成症候群	産科的創傷の血腫
光線過敏	光線過敏症	肺活量減少
副睾丸炎	精巣炎	大動脈弁狭窄症兼僧帽弁閉鎖不全症兼三尖弁閉鎖不全症
虚脱病変	虚脱	膀胱白板症
慢性アレルギー性鼻炎	季節性アレルギー性鼻炎	膀胱白板症
肘痛	肘関節痛	症候性そう痒症
夕食前低血糖	低血糖	膀胱白板症
先天性代謝異常症	代謝障害	肺活量減少
単頸双角子宮	双角子宮	産科的創傷の血腫
原発性肺高血圧症	肺高血圧症	子宮線維症
左眼加齢性黄斑変性症	加齢黄斑変性	化膿性リンパ節炎
左鎖骨リンパ節転移	リンパ節転移	床形態歯周治療用装置破損
殿部色素沈着	色素異常症	致死型表皮水疱症
舌浮腫	浮腫	内反小趾
ストレス性潰瘍	ストレス潰瘍	多尿
舌損傷	損傷	多尿
発熱下	発熱	膀胱白板症
失見当識発言	見当識障害	症候性そう痒症
右眼内悪性リンパ腫	眼窩悪性リンパ腫	臍帯卵膜付着による新生児の障害
腹部大動脈狭窄	大動脈狭窄症	第４趾有棘細胞癌
右季肋部自発痛	季肋部痛	大動脈弁狭窄症兼僧帽弁閉鎖不全症兼三尖弁閉鎖不全症
軽度痺れ	しびれ感	内反小趾
星芒状血管腫	血管腫	臍帯卵膜付着による新生児の障害
右房内腫瘤	腫瘤	内反小趾
Ｓ状結腸転移	転移性消化器腫瘍	胸膜播種
全身掻痒感	そう痒	総胆管のう腫
右手舟状骨骨折	手舟状骨骨折	多尿
肉芽腫性腸疾患	腸疾患	前足部痛
両足圧痕性浮腫	浮腫	内反小趾
発作後精神病	精神病	大動脈弁狭窄症兼僧帽弁閉鎖不全症兼三尖弁閉鎖不全症
虫垂粘液嚢胞腺腫	虫垂粘液のう胞	突発性咽頭出血
四肢水疱	水疱症	内反小趾
右足趾骨髄炎	趾骨髄炎	産褥骨盤腹膜炎
若年性リウマチ	関節リウマチ	内反小趾
体陽性脳炎	脳炎	大動脈弁狭窄症兼僧帽弁閉鎖不全症兼三尖弁閉鎖不全症
境界域ＤＭ	糖尿病	多尿
結節性不整脈	不整脈	産科的創傷の血腫
劇症敗血症	敗血症	甲状腺出血
慢性血腫	血腫	床形態歯周治療用装置破損
骨破壊病変	関節リウマチ	多尿
眼窩部痛	眼痛	大動脈弁狭窄症兼僧帽弁閉鎖不全症兼三尖弁閉鎖不全症
昨日不眠	不眠症	化膿性リンパ節炎
頚椎脊柱管狭窄症	頚部脊柱管狭窄症	産科的創傷の血腫
発赤域	発赤	胸膜播種
膵頭部転移	転移性膵腫瘍	前足部痛
高度肝障害	肝障害	視路疾患
右肺下葉腫瘍	肺腫瘍	前足部痛
口腔内発赤腫脹	発赤	大動脈弁狭窄症兼三尖弁閉鎖不全症
中咽頭再発腫瘍	咽頭腫瘍	第４趾有棘細胞癌
左下肢冷感	下肢冷感	大動脈弁狭窄症兼僧帽弁閉鎖不全症兼三尖弁閉鎖不全症
大腫瘍	腫瘍	床形態歯周治療用装置破損
胸骨肋骨転移	肋骨転移	床形態歯周治療用装置破損
重症心身障害児	重症心身障害	甲状腺出血
腹部軽度膨隆	腹部膨満	内反小趾
リンパ管症	癌性リンパ管症	床形態歯周治療用装置破損
遷延性抑うつ状態	うつ状態	肺活量減少
結核性強膜炎	結核性胸膜炎	膀胱白板症
下腿筋萎縮	筋萎縮症	アフラトキシン中毒
膵頭癌	癌	突発性咽頭出血
ＶＡＨＳ	ウイルス関連血球貪食症候群	視路疾患
圧痛自発痛	圧痛	症候性そう痒症
痰中等量引ける	喀痰	内側半月板断裂
放射線障害	放射線宿酔	化膿性リンパ節炎
浅眠	不眠症	大動脈弁狭窄症兼僧帽弁閉鎖不全症兼三尖弁閉鎖不全症
反射異常	異常反射	膀胱乳頭腫
慢性間質性腎炎	慢性尿細管間質性腎炎	前立腺膿瘍
脳溢血	脳卒中	総胆管のう腫
右下肢深部静脈血栓症	下肢静脈血栓症	内反小趾
カテーテル感染	カテーテル感染症	先天性限局白皮症
腫瘍多発	腫瘍	床形態歯周治療用装置破損
背部筋緊張高い	筋強直	エーテル中毒症
全身紅斑	紅斑症	内反小趾
しびれてる感	しびれ感	症候性そう痒症
少量尿失禁	尿失禁症	胸膜播種
脳腫瘍切除	脳腫瘍	多尿
右側下顎骨体部骨折	下顎骨骨折	多尿
高血糖是正	高血糖症	膀胱白板症
腫瘤拡大	腫瘤	第４趾有棘細胞癌
病原性大腸菌	病原性大腸菌感染症	胸膜播種
耳小骨奇形	耳小骨の先天奇形	産科的創傷の血腫
全身性紫斑	全身性紫斑病	化膿性リンパ節炎
微小多発脳梗塞	多発性脳梗塞	産科的創傷の血腫
右股関節亜脱臼	股関節亜脱臼	多尿
糸球体血尿	血尿	眼部外傷性異物
左橈骨神経麻痺	橈骨神経麻痺	内反小趾
全身性間代性痙攣	間代性痙攣	内反小趾
右肋間痛	肋間痛	症候性そう痒症
右続発性緑内障	続発性緑内障	化膿性リンパ節炎
軟骨腫	骨軟骨腫	床形態歯周治療用装置破損
開大性代謝性アシドーシス	代謝性アシドーシス	化膿性リンパ節炎
パニック様症状	全般性不安障害	内反小趾
胆嚢充満結石	胆のう結石症	腰部尋常性乾癬
左上葉肺転移	転移性肺腫瘍	胸膜播種
軽度しびれ感	しびれ感	内反小趾
意識レベル低	意識障害	内側半月板断裂
爪囲紅斑	爪囲炎	内反小趾
子宮頸癌Ｉｂ１期	子宮頚癌	産科的創傷の血腫
感覚性運動失調	運動失調	症候性そう痒症
両側鎖骨上窩リンパ節腫大	リンパ節腫大	若年者キーンベック病
中枢性めまい	中枢性めまい症	視路疾患
関節滑膜炎	滑膜炎	総胆管のう腫
続発性膜性腎症	膜性腎症	前立腺膿瘍
立位保持困難	四肢筋力低下	症候性そう痒症
先天性風疹症侯群	先天性風疹症候群	化膿性リンパ節炎
左足痺れ	しびれ感	内反小趾
Ｒｉｅｄｅｌ甲状腺炎	線維性甲状腺腫	第２腰椎病的骨折
椎骨動脈狭窄	椎骨動脈狭窄症	産科的創傷の血腫
活動性肺結核症	活動性肺結核	胸膜播種
鼻腔化膿性肉芽腫	細菌性肉芽腫症	肝腫瘤
痙攣発作再発	痙攣発作	ＣＭ関節脱臼
右脛骨内果骨折	足関節内果骨折	多尿
左胸膜転移	胸膜播種	臍帯卵膜付着による新生児の障害
卵巣腫瘍再発	卵巣腫瘍	若年者キーンベック病
右肺中葉転移	転移性肺癌	胸膜播種
下腿筋痛	下肢筋肉痛	内反小趾
右大腰筋血腫	血腫	床形態歯周治療用装置破損
十二指腸潰瘍再発	慢性十二指腸潰瘍	第４趾有棘細胞癌
Ａｆ不変	心室細動	慢性歯肉炎
左下腿部帯状疱疹	帯状疱疹	内反小趾
顔面麻痺１	顔面神経麻痺	内反小趾
巨大腫瘤	腫瘤	第４趾有棘細胞癌
右足関節腫脹	足関節腫脹	多尿
外陰部湿疹	湿疹	先天性限局白皮症
両肺副雑音	胸部音異常	症候性そう痒症
腎機能異常	腎機能検査異常	視路疾患
姿勢障害	姿勢異常	症候性そう痒症
左肘頭開放骨折	開放骨折	多尿
イレウス発生	イレウス	胸膜播種
若干硬結	硬結	多尿
左骨盤内リンパ嚢胞	骨盤部感染性リンパのう胞	床形態歯周治療用装置破損
発作性３度房室ブロック	第３度房室ブロック	内反小趾
身体損傷	損傷	多尿
右大腿骨骨腫瘍	大腿骨腫瘍	床形態歯周治療用装置破損
慢性胆嚢炎	慢性胆のう炎	視路疾患
偽性高Ｋ血症	高カリウム血症	膀胱白板症
反応性胸水	胸水貯留	視路疾患
元々痛み	疼痛	症候性そう痒症
骨盤内膜症	骨盤子宮内膜症	角膜上皮損傷
右耳下腺腫瘤	耳下腺腫瘤	内反小趾
肝形質細胞腫	形質細胞腫	前足部痛
躁病相	躁状態	悪寒
易出血傾向	出血傾向	総胆管のう腫
ジューリング疱疹状皮膚炎	ジューリング病	足底部打撲傷
末梢発赤	発赤	内反小趾
部分性脂肪萎縮症	部分的脂肪萎縮症	股関節脱臼
亜急性脊髄連合変性症	亜急性連合性脊髄変性症	産科的創傷の血腫
副腎偶発腫	良性副腎皮質腫瘍	視路疾患
右下腿紅斑	紅斑症	内反小趾
腸管通過障害	消化管狭窄	膀胱乳頭腫
努力様呼吸	起坐呼吸	内側半月板断裂
膿疱形成	膿疱	内反小趾
左卵巣膿瘍	卵巣膿瘍	足底部打撲傷
発赤皮疹	発疹	若年性特発性関節炎・肩関節
赤痢アメーバ大腸炎	アメーバ赤痢	膀胱乳頭腫
サイトメガロウイルス感染	サイトメガロウイルス感染症	先天性限局白皮症
Ｇｒａｄｅ　３肝障害	肝障害	視路疾患
低ＡＬＢ血症	低アルブミン血症	膀胱白板症
Ⅱ型糖尿病	２型糖尿病	胸膜播種
両顎関節痛	顎関節痛	エーテル中毒症
逆流性胆管炎	逆行性胆管炎	眼瞼異物残留
関節痛症状	関節痛	症候性そう痒症
空気塞栓	空気塞栓症	温熱じんま疹
肝膿瘍破裂	肝膿瘍	床形態歯周治療用装置破損
総肺静脈還流異常症	肺静脈還流異常症	顔面メルケル細胞癌
両下腿痛	下腿痛	内反小趾
左橈骨頭脱臼骨折	脱臼骨折	第４趾有棘細胞癌
正中創感染	創傷感染症	膀胱白板症
左網膜分枝動脈閉塞症	動脈閉塞症	産科的創傷の血腫
頸部浮腫	浮腫	内反小趾
肺扁平上皮癌、病期不明	肺扁平上皮癌	胸膜播種
低血圧自覚症状	低血圧症	内側半月板断裂
常時痛み	疼痛	症候性そう痒症
倦怠感増	倦怠感	視路疾患
脾臓腫瘍	脾腫瘍	床形態歯周治療用装置破損
多発肝転移増大	転移性肝癌	視路疾患
頸部食道狭窄	食道狭窄	内反小趾
陰茎アポクリン癌	陰茎アポクリン腺癌	傍矢状洞髄膜腫
元来月経痛	月経痛	角膜上皮損傷
胆嚢十二指腸瘻	胆のう十二指腸瘻	腰部尋常性乾癬
特発性肺胞出血	肺胞出血	胸膜播種
左鼠径部疼痛	鼡径部痛	大動脈弁狭窄症兼僧帽弁閉鎖不全症兼三尖弁閉鎖不全症
左側頬粘膜癌	頬粘膜癌	若年者キーンベック病
円盤状皮疹	円板状エリテマトーデス	内反小趾
左手首疼痛	手部痛	症候性そう痒症
アレルギー反応	アレルギー	肺活量減少
夜間痙攣	痙攣	症候性そう痒症
膵体部小嚢胞	腫瘍性膵のう胞	突発性咽頭出血
耳介脂漏性湿疹少	脂漏性皮膚炎	化膿性リンパ節炎
両側急性硬膜下出血	急性硬膜下血腫	内反小趾
毎回尿失禁	尿失禁症	化膿性リンパ節炎
喉頭蓋腫脹	喉頭蓋炎	内反小趾
愁訴	不定愁訴症	症候性そう痒症
血腫不変	血腫	床形態歯周治療用装置破損
各種膠原病	膠原病	床形態歯周治療用装置破損
肺気胸	気胸	視路疾患
深部感覚鈍麻	感覚異常症	大動脈弁狭窄症兼僧帽弁閉鎖不全症兼三尖弁閉鎖不全症
脊柱圧痛	圧痛	総胆管のう腫
亜脱臼傾向	亜脱臼	症候性そう痒症
自傷痕	自傷	多尿
嘔吐持続	嘔吐症	内側半月板断裂
痙攣重積後脳症	痙攣重積型二相性急性脳症	内反小趾
小腸大腸型	小腸大腸クローン病	血小板放出機構異常症
薬剤肝障害	薬物性肝障害	視路疾患
転移性膵体部癌	膵体部癌	前足部痛
左前頭葉神経膠腫	前頭葉神経膠腫	臍帯卵膜付着による新生児の障害
精神運動興奮	精神運動興奮状態	大動脈弁狭窄症兼僧帽弁閉鎖不全症兼三尖弁閉鎖不全症
インフルエンザＡ型感染症	インフルエンザＡ型	化膿性リンパ節炎
紅斑反応	紅斑症	致死型表皮水疱症
右尿管結石症	尿管結石症	前足部痛
瞳孔不同	瞳孔不同症	ＨＴＬＶ−１感染症
多発肝転移巣	転移性肝腫瘍	腰部尋常性乾癬
顕微鏡的大腸炎	大腸炎	胸膜播種
直腸Ｒａ癌	直腸癌	胸膜播種
原発性アルドステロン	原発性アルドステロン症	胸膜播種
苔癬局面	苔癬	腎脂肪腫
足趾爪混濁肥厚	ころもじらみ寄生症	多尿
ＣＭＶ肺炎	サイトメガロウイルス肺炎	化膿性リンパ節炎
右ＩＣＡ狭窄	内頚動脈狭窄症	化膿性リンパ節炎
痰貯留	喀痰	肺活量減少
足趾蜂窩織炎	足蜂巣炎	総胆管のう腫
僧帽弁狭窄兼逆流症	僧帽弁狭窄症	腹膜中皮腫
中背部悪性黒色腫	背部悪性黒色腫	淋菌性腹膜炎
歯槽膿漏	歯周炎	突発性咽頭出血
左肘関節破壊	関節リウマチ・肘関節	頚椎椎弓骨折
副甲状腺亢進症	副甲状腺機能亢進症	第２腰椎病的骨折
右声帯不全麻痺	声帯不全麻痺	内反小趾
心合併症	心臓合併症	症候性そう痒症
皮下石灰化	皮膚石灰沈着症	内反小趾
薬剤性発熱	発熱	肺活量減少
労作時前胸部痛	前胸部痛	エーテル中毒症
肺炎等	肺炎	むちうち損傷
軽度ＡＤＨＤ	注意欠陥多動障害	内反小趾
新生児一過性多呼	新生児一過性多呼吸	胸膜播種
両心房拡大	心肥大	産科的創傷の血腫
上転障害	眼球運動障害	症候性そう痒症
不眠状態	不眠症	躁病発作
プレクリニカルクッシング症候群	クッシング症候群	静脈内膜炎
左胸鎖乳突筋炎	胸鎖乳突筋炎	肝門部リンパ節転移
腫瘍性	腫瘍	床形態歯周治療用装置破損
時々関節痛	関節痛	症候性そう痒症
嫌悪感	悪寒	症候性そう痒症
二次性僧帽弁閉鎖不全症	僧帽弁閉鎖不全症	外耳道母斑細胞母斑
急性大動脈弁閉鎖不全	大動脈弁閉鎖不全症	産科的創傷の血腫
左心肥大	心肥大	正中頚のう胞
腹痛嘔気	嘔気	内側半月板断裂
前頭部打撲	頭部打撲	内反小趾
左大腿部骨外性粘液型軟骨肉腫	軟骨肉腫	糖原病
高度異形成相当	子宮頚部高度異形成	内反小趾
腹緊なし	腹部膨満	総胆管のう腫
右頚部ＬＮ腫大	リンパ節腫大	床形態歯周治療用装置破損
側卵巣嚢腫	卵巣のう腫	前足部痛
哺乳後嘔吐	嘔吐症	気道閉塞
右結石性腎盂腎炎	結石性腎盂腎炎	腸ジスキネジア
Ｃｒｏｎｋｈｉｔｅ−Ｃａｎａｄａ症候群	クロンカイト・カナダ症候群	甲状腺出血
心嚢液貯留	心膜液貯留	視路疾患
臓器限局性前立腺癌	限局性前立腺癌	抗生物質起因性腸炎
貧血傾向	貧血	視路疾患
右中大脳動脈梗塞	内頚動脈塞栓症	産科的創傷の血腫
日中傾眠	傾眠症	大動脈弁狭窄症兼僧帽弁閉鎖不全症兼三尖弁閉鎖不全症
脾臓結核	結核	床形態歯周治療用装置破損
食後高血糖	高血糖症	膀胱白板症
高浸透圧血症	高血糖高浸透圧症候群	膀胱白板症
両下肢軽度浮腫	下肢浮腫	内反小趾
右間歇性跛行	間欠性跛行	気道閉塞
陰嚢ヘルニア	陰のうヘルニア	胸膜播種
多形紅斑型薬疹	薬疹	斜台部脊索腫
右腋窩リンパ節腫脹	腋窩リンパ節腫脹	臍帯卵膜付着による新生児の障害
静脈内腫瘍栓	腫瘍	床形態歯周治療用装置破損
爪甲剥離症	爪剥離症	多尿
再度急性腎不全	急性腎不全	眼瞼異物残留
進行再発大腸癌	大腸癌	抗生物質起因性腸炎
胃接合部癌	胃癌	前足部痛
耳閉塞感	耳閉感	症候性そう痒症
手足しびれ	しびれ感	内反小趾
内膜損傷	損傷	多尿
胃小彎側ＬＮ転移	胃周囲リンパ節転移	床形態歯周治療用装置破損
軽度発達遅滞	発達遅滞	内反小趾
非浸潤性膀胱癌	膀胱癌	新生児一過性低血糖症
右先天性耳瘻孔	先天性耳瘻孔	角膜上皮損傷
脂肪腫摘出	脂肪腫	気道閉塞
椎間板ヘルニア有	椎間板ヘルニア	多尿
扁平ポリープ	ポリープ	化膿性リンパ節炎
咽頭知覚障害	咽頭異常感症	気道閉塞
腸液貯留	体液貯留	胸膜播種
両変形性膝関節症	変形性膝関節症	甲状腺出血
急性胆嚢胆管炎	胆管炎	視路疾患
扁平上皮癌	癌	若年者キーンベック病
内痔核脱出	内痔核	床形態歯周治療用装置破損
びまん性脳浮腫	脳浮腫	視路疾患
呼気困難	呼吸困難	内側半月板断裂
重症鬱血性心不全	うっ血性心不全	内側半月板断裂
大腸早期癌	大腸癌	胸膜播種
喘鳴聴取	喘鳴	大動脈弁狭窄症兼僧帽弁閉鎖不全症兼三尖弁閉鎖不全症
左乳癌特	乳癌	若年者キーンベック病
Ａ型溶連菌感染症	溶連菌感染症	胸膜播種
悪性副腎外褐色細胞腫	褐色細胞腫	突発性咽頭出血
傍隔壁型肺気腫	肺気腫	化膿性リンパ節炎
角膜糜爛	角膜びらん	風疹性髄膜脳炎
骨盤内播種新生	骨盤転移	肝腫瘤
急性非代償性心不全	心不全	内側半月板断裂
最近便秘	便秘症	急性感染症性精神病
右頬部痛	頬部痛	角膜上皮損傷
右肺動静脈瘻	肺動静脈瘻	症候性そう痒症
１型高ウイルスＣ型慢性肝炎	Ｃ型慢性肝炎	頭皮扁平母斑
問題なし膀胱直腸障害	膀胱直腸障害	胸膜播種
Ｌｉｓｔｅｒｉａ腸炎	細菌性腸炎	胸膜播種
右膿胸	膿胸	前足部痛
ヒリヒリ感	疼痛	膀胱白板症
時折胸痛	胸痛	症候性そう痒症
大動脈弁下心室中隔欠損	心室中隔欠損症	産科的創傷の血腫
右傍矢状静脈洞髄膜腫	髄膜腫	産科的創傷の血腫
無自覚性低血糖	低血糖	膀胱白板症
両側卵管留血腫	卵管留血腫	床形態歯周治療用装置破損
脱水注意	脱水症	内側半月板断裂
心尖部型肥大型心筋症	肥大型心筋症	産科的創傷の血腫
右飛蚊症	飛蚊症	化膿性リンパ節炎
腎不全保存期	腎不全	眼瞼異物残留
口腔内炎	口内炎	肺活量減少
びまん性大細胞	びまん性大細胞型Ｂ細胞性リンパ腫	ＴＦＣＣ損傷
大うつ病	単極性うつ病	症候性そう痒症
肝門部悪性リンパ腫	肝門部リンパ節転移	前足部痛
精神病性うつ病	うつ病	症候性そう痒症
水疱性類天疱	水疱症	Ｓ状結腸型ヒルシュスプルング病
中枢性低換気	換気量減少	子宮線維症
右膝ＡＣＬ損傷	前十字靱帯損傷	多尿
全身倦怠感軽度	全身倦怠感	症候性そう痒症
混合難聴	難聴	症候性そう痒症
毛孔一致性丘疹	丘疹	胆のう瘻
先天性巨大色素性母斑	巨大母斑細胞母斑	突発性咽頭出血
不安大	不安障害	症候性そう痒症
胸骨下液体貯留	体液貯留	床形態歯周治療用装置破損
新出肺転移	転移性肺腫瘍	胸膜播種
左聴器癌	癌	抗生物質起因性腸炎
多発脳神経障害	多発性脳神経障害	内反小趾
上腹部リンパ節転移	リンパ節転移	床形態歯周治療用装置破損
被殻梗塞	被殻出血	多尿
直腸Ｒａｂ癌	直腸癌	胸膜播種
軽度高血糖	高血糖症	膀胱白板症
本日硬便少量	便異常	膀胱白板症
２型腫瘤	腫瘤	第４趾有棘細胞癌
右腎無形成	腎無形成	眼瞼異物残留
リンパ節圧痛	圧痛	内反小趾
全身性細菌感染症	細菌感染症	膀胱白板症
脳髄膜瘤	髄膜脳瘤	内反小趾
水頭症症状	水頭症	膀胱白板症
小血栓	血液凝固異常	胸膜播種
右耳失聴	聴覚消失	症候性そう痒症
統合失調症合併	統合失調症	症候性そう痒症
胃痛症状	胃痛	症候性そう痒症
急性期ＨＩＶ感染症	ＨＩＶ感染症	化膿性リンパ節炎
右下肢運動障害	四肢運動障害	大動脈弁狭窄症兼僧帽弁閉鎖不全症兼三尖弁閉鎖不全症
炎症性脱髄性多発根神経炎	慢性炎症性脱髄性多発神経炎	総胆管のう腫
上行結腸腫瘤	腫瘤	大動脈弁狭窄症兼三尖弁閉鎖不全症
過食症状	過食症	膀胱白板症
疾病不安	不安障害	視路疾患
肺癌手術	肺癌	胸膜播種
色素脱失	炎症後色素脱失	胸膜播種
膿貯留	膿瘍	無症候性原発性胆汁性肝硬変
片側副腎腫瘍	副腎腫瘍	前足部痛
リンパ節腫脹	リンパ節腫大	床形態歯周治療用装置破損
右椎骨動脈巨大血栓化動脈瘤	椎骨動脈瘤	産科的創傷の血腫
カテ感染	カテーテル感染症	むちうち損傷
安心感	心気症	症候性そう痒症
左鼡径ヘルニア再発	鼡径ヘルニア	第４趾有棘細胞癌
胃食道静脈瘤破裂	食道静脈瘤破裂	産科的創傷の血腫
左足背蜂窩織炎	足背蜂巣炎	膀胱白板症
右胸水貯留	胸水貯留	総胆管のう腫
暗青色斑	青色母斑	ＡＬアミロイドーシス
ＨＣＶ陽性	Ｃ型肝炎ウイルス感染	子宮線維症
疲労感生	疲労感	症候性そう痒症
感染性静脈血栓症	静脈血栓症	眼瞼異物残留
両側腎腫大	腎腫大	前足部痛
過敏性膀胱炎	膀胱炎	胸膜播種
包交時出血	出血	総胆管のう腫
右坐骨骨折	坐骨骨折	多尿
右耳下腺腫脹	耳下腺腫脹	大動脈弁狭窄症兼三尖弁閉鎖不全症
進行肺癌	肺癌	胸膜播種
肋骨起始部骨転移	肋骨転移	床形態歯周治療用装置破損
外傷性変化	外傷	多尿
中等度精神遅滞	中等度知的障害	躁病発作
先天性左股関節脱臼	先天性股関節脱臼	アフラトキシン中毒
リポフスチン沈着	神経セロイドリポフスチン症	胸膜播種
鮮血痰	血痰	肺活量減少
壊死性変化	壊死	多尿
溶連菌感染	溶連菌感染症	膀胱白板症
局所発赤	発赤	先天性限局白皮症
不整脈チーム	不整脈	甲状腺出血
中等度ＣＯＰＤ	慢性閉塞性肺疾患	化膿性リンパ節炎
胸部圧痛	圧痛	エーテル中毒症
両上肢痛	上肢痛	内反小趾
気分不快症状	悪心	内側半月板断裂
右上腕骨近位端粉砕骨折	上腕骨近位端粉砕骨折	多尿
乳突蜂巣	乳様突起炎	内反小趾
褥創形成	褥瘡	風疹性髄膜脳炎
ガマ腫	がま腫	突発性咽頭出血
膀胱腫瘍再発	膀胱腫瘍	慢性副鼻腔炎急性増悪
夜間せん妄状態	せん妄	化膿性リンパ節炎
神経系腫瘍	腫瘍	床形態歯周治療用装置破損
クッシング徴候	クッシング症候群	内反小趾
先天性側弯	肋骨異常を伴う先天性側弯症	症候性そう痒症
非定型抗酸菌肺炎	肺炎	肺活量減少
軽度甲状腺腫大	甲状腺腫	内反小趾
手足痺れ	四肢しびれ	内反小趾
節外性濾胞辺縁帯リンパ腫	脾辺縁帯リンパ腫	前足部痛
左下葉肺癌	下葉肺癌	ＨＴＬＶ−１感染症
Ｋｌｅｂｓｉｅｌｌａ　ｐｎｅｕｍｏｎｉａｅ敗血症	新生児クレブシエラ敗血症	膀胱白板症
若年性認知症	認知症	化膿性リンパ節炎
外腸骨域リンパ節腫大	リンパ節腫大	床形態歯周治療用装置破損
貧血高度	貧血	内側半月板断裂
腰部腫瘍	腰椎部腫瘍	床形態歯周治療用装置破損
鼠径ヘルニア	鼡径ヘルニア	抗生物質起因性腸炎
分化型管状腺癌	癌	突発性咽頭出血
侵襲性肺アスペルギウス症	侵襲性肺アスペルギルス症	胸膜播種
孤発性ＣＪＤ	孤発性クロイツフェルト・ヤコブ病	内反小趾
右下葉結節影	胸部異常陰影	完全大血管転位症１型
軽度左軸偏位	心電図左軸偏位	症候性そう痒症
左頚部結核性リンパ節炎	結核性リンパ節炎	床形態歯周治療用装置破損
食道がん	食道癌	化膿性リンパ節炎
肛門部発赤	発赤	化膿性リンパ節炎
脳室拡大進行	脳室拡大	内反小趾
下腿潰瘍	下腿皮膚潰瘍	多尿
小脳転移	転移性脳腫瘍	胸膜播種
腎盂軽度拡張	腎盂拡張	頚部腫瘤
腫瘍指摘	腫瘍	多尿
心臓原発性悪性リンパ腫	心臓悪性リンパ腫	慢性歯肉炎
準夜帯嘔気	嘔気	大動脈弁狭窄症兼僧帽弁閉鎖不全症兼三尖弁閉鎖不全症
成人Ｓｔｉｌｌ病	成人スチル病	胸膜播種
脳血管疾患	脳血管障害	床形態歯周治療用装置破損
左膝窩部痛	膝窩部痛	症候性そう痒症
非浸潤性尿路上皮癌	尿管尿路上皮癌	胸膜播種
下咽頭がん	下咽頭癌	内反小趾
両上肢痺れ	上肢しびれ	内反小趾
混合性肝癌	肝癌	前腕血栓性静脈炎
甲状腺痛	甲状腺炎	角膜上皮損傷
少量血便	血便	膀胱白板症
脳梗塞有	脳梗塞	第４趾有棘細胞癌
痕発赤	発赤	完全大血管転位症１型
不消化便	消化不良性下痢	化膿性リンパ節炎
末梢性めまい	めまい症	急性顎骨骨髄炎
左上腕骨肉腫	上腕骨骨肉腫	多尿
四肢型運動失調	運動失調	症候性そう痒症
産生胃癌	胃癌	突発性咽頭出血
下肢冷感軽度	下肢冷感	内反小趾
左室内同期不全	左室不全	化膿性リンパ節炎
左脛腓骨骨折	腓骨骨折	多尿
漿液性腺腫	卵巣漿液性腺腫	突発性咽頭出血
日本海裂頭条虫	日本海裂頭条虫症	第４趾有棘細胞癌
先天性脳血管異常	脳動静脈奇形	甲状腺出血
臀部皮疹	発疹	若年性特発性関節炎・肩関節
歩行時軽度跛行	跛行	症候性そう痒症
心室中隔扁平化	心室中隔欠損症	サイトメガロウイルス脊髄炎
フルニエ壊疽	外陰部壊死性筋膜炎	多尿
肝芽腫再発	肝芽腫	前足部痛
状血管腫	血管腫	床形態歯周治療用装置破損
卵巣癌破裂	卵巣癌	若年者キーンベック病
右下腿疼痛	下腿痛	大動脈弁狭窄症兼僧帽弁閉鎖不全症兼三尖弁閉鎖不全症
軽度眼球突出	眼球突出症	内反小趾
前頭葉障害	前頭葉症候群	内反小趾
歯牙損傷	切歯破折	多尿
両側乳糜胸水	胸水貯留	総胆管のう腫
肺門部リンパ節腫大	肺門リンパ節腫脹	床形態歯周治療用装置破損
麻疹罹患歴	麻疹	１型糖尿病性高コレステロール血症
尿漏れ	尿失禁症	視路疾患
心膜播種	腹膜播種	肝腫瘤
髄液播種	腹膜播種	肝腫瘤
左腎動脈狭窄症	腎動脈狭窄症	眼瞼異物残留
体動時創部痛	術創部痛	内反小趾
後頭部皮下血腫	頭部皮下血腫	糖原病
ＭＲＳＡ菌血症	ＭＲＳＡ感染症	胸膜播種
篩骨蜂巣	篩骨洞炎	腰椎腫瘍
左退形成性星細胞腫	退形成性星細胞腫	産科的創傷の血腫
仮性動脈瘤切除	偽性動脈瘤	産科的創傷の血腫
鼻中隔血腫	血腫	突発性咽頭出血
左嗅裂ポリープ	ポリープ	突発性咽頭出血
労作時疲労	疲労感	症候性そう痒症
不定愁訴多	不定愁訴症	総胆管のう腫
軽度失調性構音障害	構音障害	症候性そう痒症
びらんからの出血	出血	内反小趾
動揺性精神神経症状	神経症	症候性そう痒症
過呼吸気味	過換気症	内側半月板断裂
真菌性感染性心内膜炎	細菌性心内膜炎	膀胱内異物
気道狭窄音	気道狭窄	化膿性リンパ節炎
未分類関節炎	関節炎	甲状腺出血
左視床出血	視床出血	手掌部皮下腫瘤
骨突出部発赤	発赤	内反小趾
神経症性うつ病	抑うつ神経症	躁病発作
右浸潤影	胸部異常陰影	むちうち損傷
四肢近位筋筋力低下	筋力低下	甲状腺出血
左耳後部腫瘤	耳後部腫瘤	内反小趾
右乳腺良性腫瘍	乳腺腫瘍	肝門部リンパ節転移
左尿管結石性腎盂腎炎	結石性腎盂腎炎	眼瞼異物残留
イレウス気味	偽性イレウス	胸膜播種
筋力低下可能性	筋力低下	甲状腺出血
咽喉頭違和感	咽喉頭異常感症	症候性そう痒症
前立腺癌死	前立腺癌	若年者キーンベック病
再度皮疹	発疹	斜台部脊索腫
左肩腱板損傷	肩腱板損傷	産科的創傷の血腫
低形成	骨髄低形成	内反小趾
再脱臼	脱臼	第４趾有棘細胞癌
左肺動脈狭窄症	肺動脈狭窄症	サイトメガロウイルス脊髄炎
肺動脈弁上狭窄	肺動脈弁上狭窄症	サイトメガロウイルス脊髄炎
後頸部発赤	発赤	内反小趾
血管原性浮腫	浮腫	視路疾患
偽粘液腫	粘液腫	糖原病
毛包向性菌状息肉症	菌状息肉症	多尿
Ｂｌｕｅ　ｔｏｅ　ｓｙｎｄｒｏｍｅ	末梢動脈疾患	視路疾患
嚢胞様腫瘤像	腫瘤	若年者キーンベック病
右足不随意運動	不随意運動症	大動脈弁狭窄症兼僧帽弁閉鎖不全症兼三尖弁閉鎖不全症
婦人科癌	癌	抗生物質起因性腸炎
両側眼振	眼振	大動脈弁狭窄症兼僧帽弁閉鎖不全症兼三尖弁閉鎖不全症
爪水虫	爪白癬	膀胱白板症
子宮体癌Ｉａ期	子宮体癌	突発性咽頭出血
過活動型せん妄	せん妄	化膿性リンパ節炎
左下肢鬱滞性皮膚炎	うっ滞性皮膚炎	総胆管のう腫
ＢＰＳＤ	認知症に重なったせん妄	視路疾患
進行性核上麻痺	進行性核上性麻痺	斜台部脊索腫
汎発性水痘感染症	水痘	化膿性リンパ節炎
えん下障害	嚥下障害	化膿性リンパ節炎
左上腕悪性黒色腫	上腕部悪性黒色腫	内反小趾
左側頭葉挫傷	脳挫傷	多尿
虚血性肝炎	肝炎	視路疾患
重症敗血症	敗血症	甲状腺出血
幽門前部狭窄	幽門狭窄症	ヘルペスウイルス性湿疹
圧迫移植部ネクローシス	壊死	床形態歯周治療用装置破損
子宮頸癌子宮頚癌	子宮頚癌	産科的創傷の血腫
舌乾燥	口腔乾燥症	多尿
足痛い	足痛	内反小趾
円形紅斑	紅斑症	内反小趾
左眼後発性白内障	白内障	膀胱内異物
徐脈気味	徐脈	症候性そう痒症
境界性パーソナリティ障害	境界型パーソナリティ障害	膀胱白板症
鼻骨折	鼻骨骨折	多尿
膵尾部腫瘤性病変	膵腫瘤	若年者キーンベック病
重症腸炎	腸炎	膀胱白板症
左大腿骨転子下骨折	転子下骨折	多尿
左低形成腎	低形成腎	視路疾患
肺野すりガラス状陰影	肺野異常陰影	ＨＴＬＶ−１感染症
アテローム性血栓性脳梗塞	血栓性脳梗塞	産科的創傷の血腫
結腸癌肝転移	転移性肝癌	前足部痛
診察時皮疹	発疹	膀胱白板症
切開関連性心房粗動	心房粗動	甲状腺出血
硬性白斑	白斑	内反小趾
術後不整脈	不整脈	症候性そう痒症
広範囲脊柱管狭窄症	広範脊柱管狭窄症	サイトメガロウイルス脊髄炎
中～低分化肝細胞癌	肝細胞癌	突発性咽頭出血
起床時咳嗽	咳	症候性そう痒症
腰骨骨折	腰椎骨折	多尿
血性腹水貯留	腹水症	膀胱白板症
心理的不安	不安障害	症候性そう痒症
カンジダ肺炎	肺カンジダ症	化膿性リンパ節炎
右小細胞癌	小細胞肺癌	若年者キーンベック病
頬部悪性腫瘍	頬部腫瘍	大動脈弁狭窄症兼三尖弁閉鎖不全症
多源性ＰＶＣ散発	心室期外収縮	ＨＴＬＶ−１感染症
原発性甲状腺機能低下	甲状腺機能低下症	化膿性リンパ節炎
ヨードアレルギー	ヨード過敏症	化膿性リンパ節炎
右ＩＣ動脈瘤	内頚動脈脳動脈瘤	産科的創傷の血腫
顔面形成	顔面形成異常	多尿
活動性肝炎	肝炎	視路疾患
インフルエンザ陽性	インフルエンザ	視路疾患
眼球結膜浮腫	結膜浮腫	ＴＦＣＣ損傷
排便なし	便秘症	膀胱白板症
全身性Ｃａｎｄｉｄａ感染症	カンジダ症	視路疾患
顔面神経痛	三叉神経痛	大動脈弁狭窄症兼僧帽弁閉鎖不全症兼三尖弁閉鎖不全症
多発肺膿瘍	肺膿瘍	胸膜播種
疣贅様構造物	疣贅	症候性そう痒症
アルコ−ル性肝硬変	肝硬変症	眼瞼異物残留
皮質層状壊死	壊死	多尿
発熱随伴症状	発熱	肺活量減少
急性肺動脈血栓塞栓症	肺動脈血栓塞栓症	眼瞼異物残留
両下肢深部静脈血栓症	下肢静脈血栓症	内反小趾
右上腕骨近位端骨折	上腕骨近位端骨折	多尿
脳炎脳症	脳症	膀胱白板症
辺縁性脳炎	脳炎	真性性腺欠如
易疲労性強い	易疲労感	総胆管のう腫
せん妄生	せん妄	特発性発疹
右第３趾爪囲炎	爪囲炎	網膜静脈血栓症
多発縦隔リンパ節転移	縦隔リンパ節転移	慢性歯肉炎
家族性ＣＪＤ	家族性クロイツフェルト・ヤコブ病	化膿性リンパ節炎
圧迫時疼痛	疼痛	症候性そう痒症
症型Ａ群溶連菌感染症	溶連菌感染症	皮下唇裂
末梢肺動脈塞栓症	動脈塞栓症	眼瞼異物残留
歩容困難	歩行障害	内側半月板断裂
脳室出血	出血	第４趾有棘細胞癌
顔面痺れ	しびれ感	内反小趾
尿失禁状態	尿失禁症	胸膜播種
重度失調性構音障害	構音障害	症候性そう痒症
卵巣癌Ⅲｃ期	卵巣癌	若年者キーンベック病
低血糖鞘状	低血糖	膀胱白板症
発赤潰瘍	発赤	多尿
左下肺浸潤影	肺部異常陰影	むちうち損傷
右大脳動脈未破裂動脈瘤	脳動脈瘤	産科的創傷の血腫
失語正常	失語症	躁病発作
先週頭痛	頭痛	内反小趾
ｃｅｌｌ　ｌｅｕｋｅｍｉａ	白血病	内反小趾
失語持続	失語症	症候性そう痒症
ＧＣＡ	巨細胞動脈炎	斜台部脊索腫
大動脈弁硬化症	大動脈弁狭窄症	産科的創傷の血腫
多発筋炎	多発性筋炎	甲状腺出血
呼吸促迫症状	呼吸促迫	肺活量減少
大腿骨骨頭壊死	大腿骨頭壊死	多尿
呼気喘鳴	喘鳴	症候性そう痒症
サイトメガロ網膜炎	サイトメガロウイルス網膜炎	傍矢状洞髄膜腫
ＡＣＴＨ非依存性Ｃｕｓｈｉｎｇ症候群	クッシング症候群	化膿性リンパ節炎
次週左気胸	気胸	症候性そう痒症
内分泌機能不全	内分泌機能異常	化膿性リンパ節炎
熱	発熱	膀胱白板症
Ｍａｌｌｏｒｙ−Ｗｅｉｓｓ症候群	マロリ・ワイス症候群	胸膜播種
軽度音声障害	音声障害	肺活量減少
緑膿菌腸炎	緑膿菌性腸炎	肺活量減少
ドレーン出血	出血	第４趾有棘細胞癌
副鼻腔転移	副鼻腔癌	手掌部皮下腫瘤
原発不明癌頸部転移	原発不明癌	産科的創傷の血腫
発熱中	発熱	肺活量減少
再発腫瘤	腫瘤	第４趾有棘細胞癌
右錐体路障害	錐体路障害	大動脈弁狭窄症兼僧帽弁閉鎖不全症兼三尖弁閉鎖不全症
犬吠様咳嗽	咳	症候性そう痒症
両下肢筋痛	下肢筋肉痛	内反小趾
左室ブロック波形	心電図異常	内反小趾
有痛性腫瘤	腫瘤	内反小趾
難治性冠攣縮性狭心症	冠攣縮性狭心症	症候性そう痒症
起床時頭痛	頭痛	内反小趾
Ⅱ型房室ブロック	房室ブロック	サイトメガロウイルス脊髄炎
眼白内障	白内障	膀胱内異物
慢性下気道感染	急性気管支炎	子宮線維症
乳頭様腎盂腫瘍	腎盂乳頭状癌	突発性咽頭出血
喀痰付着	喀痰	膀胱白板症
両側下腿潰瘍	下腿皮膚潰瘍	多尿
心肺停止後蘇生	心肺停止	肺活量減少
ＳＣＤ	脊髄小脳変性症	胸膜播種
無症候性腸アメーバ症	腸アメーバ症	胸膜播種
手首痛	手部痛	内反小趾
頸部食道癌	頚部食道癌	産科的創傷の血腫
症候性てんかん発症	症候性てんかん	化膿性リンパ節炎
左腎血管腫	腎血管腫	前足部痛
地誌的失認	失認	症候性そう痒症
命令性幻聴	幻聴	大動脈弁狭窄症兼僧帽弁閉鎖不全症兼三尖弁閉鎖不全症
子宮体癌Ⅱ期	子宮体癌	抗生物質起因性腸炎
両側副腎腫瘍	副腎腫瘍	前足部痛
左顔面神経麻痺症状	顔面神経麻痺	内反小趾
左顔面痛覚障害	片側痛覚鈍麻	角膜上皮損傷
顎部痛	顎痛	内反小趾
元々疼痛	疼痛	症候性そう痒症
粘膿性鼻汁	鼻汁	視路疾患
膣原発横紋筋肉腫	横紋筋肉腫	産科的創傷の血腫
卵巣嚢腫ＯＰ	卵巣のう腫	前足部痛
遅発性ペースメーカー感染症	ペースメーカ植え込み後感染症	化膿性リンパ節炎
子宮筋肉腫	子宮肉腫	産科的創傷の血腫
肺血管陰影増強	肺血管疾患	むちうち損傷
頭頸部放線菌症	放線菌症	多尿
腎機能障害	腎機能低下	視路疾患
Ｈｏｄｇｋｉｎ　Ｌｙｍｐｈｏｍａ	ホジキンリンパ腫	胸膜播種
冠動脈−肺動脈瘻	肺動脈瘻	サイトメガロウイルス脊髄炎
嚥下時疼痛	嚥下痛	症候性そう痒症
術後創感染	術後膿瘍	糖原病
大腸ポリープ後	大腸ポリープ	胸膜播種
右下葉扁平上皮癌	下葉肺扁平上皮癌	若年者キーンベック病
咳嗽法	咳	症候性そう痒症
高リスク前立腺癌	前立腺癌	突発性咽頭出血
門脈圧亢進	門脈圧亢進症	内反小趾
認知面低下	軽度認知障害	症候性そう痒症
ノカルジア	ノカルジア症	多尿
右人工膝関節感染	人工膝関節感染	腎脂肪腫
膿梗塞	脳梗塞	床形態歯周治療用装置破損
下大静脈狭窄	大静脈狭窄症	内反小趾
十二指腸穿通性潰瘍	穿通性十二指腸潰瘍	第４趾有棘細胞癌
左横隔膜弛緩症	横隔膜弛緩症	症候性そう痒症
火傷	熱傷	多尿
入眠困難感	不眠症	症候性そう痒症
非定型カルチノイド腫瘍	カルチノイド	若年者キーンベック病
軽度食欲低下	食欲不振	膀胱白板症
尿管結石有	尿管結石症	新生児一過性低血糖症
両下腿壊疽性膿皮症様潰瘍	膿皮症	多尿
冠攣縮型狭心症	冠攣縮性狭心症	第４趾有棘細胞癌
恥骨骨髄炎	骨髄炎	持続性蛋白尿
かすみ目	視力低下	完全大血管転位症１型
眩暈消失	めまい	大動脈弁狭窄症兼僧帽弁閉鎖不全症兼三尖弁閉鎖不全症
手指関節腫脹	関節炎	多尿
ＳＰＮ	充実性偽乳頭状腫瘍	胸膜播種
夜間嘔気	嘔気	症候性そう痒症
左足背発赤	下腿発赤	完全大血管転位症１型
女性器クラミジア感染症	クラミジア感染症	化膿性リンパ節炎
血液凝固障害	血液凝固異常	床形態歯周治療用装置破損
慢性的な呼吸困難	呼吸困難	内側半月板断裂
右肺下葉肺炎	肺炎	むちうち損傷
低酸素虚血性脳症	低酸素性脳症	内側半月板断裂
左大葉性肺炎	大葉性肺炎	化膿性リンパ節炎
膵臓癌術後再発	膵癌	若年者キーンベック病
足底湿疹	足湿疹	斜台部脊索腫
歩行ふらつき	めまい	膀胱白板症
結腸縫合不全	縫合不全	顎下腺萎縮
多発肝血管腫	多発性肝血管腫	前足部痛
紅色腫瘤	腫瘤	多尿
気管支閉鎖症	気管支閉鎖	内反小趾
神経アミロイドーシス	アミロイドーシス	傍矢状洞髄膜腫
夜疼痛	疼痛	症候性そう痒症
咽頭粘膜発赤	発赤	内反小趾
時々不整脈	不整脈	甲状腺出血
多発性リンパ節転移	多部位リンパ節転移	慢性歯肉炎
新生児死亡	原因不明の死亡	多尿
最近花粉症	花粉症	甲状腺出血
食道空腸吻合部狭窄	吻合部狭窄	第４趾有棘細胞癌
クリオグロブリン性血管炎	クリオグロブリン血症性血管炎	膀胱白板症
右頬部擦過傷	頬部擦過創	内反小趾
右肺下葉癌	下葉肺癌	ＨＴＬＶ−１感染症
腎結石多発	腎結石症	新生児一過性低血糖症
ＥＢウイルス初感染	ＥＢウイルス感染症	化膿性リンパ節炎
外表奇形	奇形	グラム陽性桿菌感染症
急性膵臓炎	急性膵炎	視路疾患
Ｉｓｐポリープ	大腸ポリープ	静脈瘤性動脈瘤
咽頭部発赤	発赤	内反小趾
頭部腫瘍	頭部皮下腫瘍	若年者キーンベック病
遅発性発疹	発疹	化膿性リンパ節炎
肺炎悪化	肺炎	子宮線維症
朝痰	喀痰	中指末節骨骨折
子宮体癌Ⅳ期	子宮体癌	突発性咽頭出血
骨外腫瘤形成	腫瘤	多尿
低悪性度Ｂ細胞性リンパ腫	びまん性大細胞型Ｂ細胞性リンパ腫	突発性咽頭出血
視神経脊髄炎（ＮＭＯ）	視神経脊髄炎	正中頚のう胞
左下副甲状腺腺腫	副甲状腺腺腫	臍帯卵膜付着による新生児の障害
単形性ＶＴ	非持続性心室頻拍	サイトメガロウイルス脊髄炎
特発性心室細動	心室細動	顔面メルケル細胞癌
高脂血症高脂血症	高脂血症	視路疾患
白色調腫瘍	腫瘍	床形態歯周治療用装置破損
左頬部有棘細胞癌	頬部有棘細胞癌	若年者キーンベック病
Ｇｏｔｔｒｏｎ徴候	ゴットロン丘疹	内反小趾
脊柱起立筋膿瘍	筋膿瘍	床形態歯周治療用装置破損
左踵骨骨折	踵骨骨折	多尿
胃癌幽門狭窄	幽門狭窄症	抗生物質起因性腸炎
拡張能障害	心不全	視路疾患
小腸静脈瘤破裂	食道静脈瘤破裂	第４趾有棘細胞癌
右上肢振戦	一側上肢振戦	大動脈弁狭窄症兼僧帽弁閉鎖不全症兼三尖弁閉鎖不全症
中枢性甲状腺機能低下症	甲状腺機能低下症	子宮線維症
左肺動脈閉塞	肺動脈狭窄症	サイトメガロウイルス脊髄炎
単純性網膜症	網膜症	眼窩内粘液腫
両眼性複視	複視	静脈内膜炎
Ｈｅｎｏｃｈ−Ｓｃｈｏｎｌｅｉｎ紫斑病	ＩｇＡ血管炎	胸膜播種
右胸腔内腫瘍	腫瘍	臍帯卵膜付着による新生児の障害
尿もれ	尿失禁症	視路疾患
下肢筋力低下自覚	筋力低下	甲状腺出血
右足静脈瘤	静脈瘤	内反小趾
上気道浮腫	咽頭浮腫	視路疾患
複雑型熱性痙攣	熱性痙攣	内反小趾
吻合部浮腫	浮腫	完全大血管転位症１型
右膀胱側壁部膀胱癌	膀胱側壁部膀胱癌	臍帯卵膜付着による新生児の障害
Ｃａｐｎｏｃｙｔｏｐｈａｇａ　ｃａｎｉｍｏｒｓｕｓ感染症	グラム陰性菌感染症	化膿性リンパ節炎
子宮頸部頸管狭窄	子宮頚管狭窄症	産科的創傷の血腫
呼吸喘鳴	喘鳴	症候性そう痒症
口腔内乾燥	口腔乾燥症	多尿
脊椎管狭窄症	脊柱管狭窄症	総胆管のう腫
ヘルペス髄膜炎	髄膜炎	膀胱白板症
左股関節破壊	股関節症	多尿
左前庭障害	前庭障害	グラム陽性桿菌感染症
膠原繊維性腸炎	腸炎	床形態歯周治療用装置破損
食道期軽度障害	嚥下障害	気道閉塞
右外腸骨静脈狭窄	静脈狭窄	産科的創傷の血腫
妊娠発覚	妊娠	急性顎骨骨髄炎
両膝関節症	膝関節症	甲状腺出血
類もやもや病	もやもや病	化膿性リンパ節炎
呼内疾患ベース肺炎	肺炎	子宮線維症
左足関節開放性脱臼骨折	足関節開放性脱臼骨折	第４趾有棘細胞癌
白色粘性痰	喀痰	膀胱白板症
食道癌２病変	食道癌	抗生物質起因性腸炎
右卵巣奇形腫	卵巣奇形腫	若年者キーンベック病
感冒罹患	感冒	膀胱白板症
血腫像	血腫	床形態歯周治療用装置破損
ｌｙｍｐｈｏｍａ	悪性リンパ腫	胸膜播種
左足首骨折	足関節骨折	多尿
慢性血栓性肺高血圧症	慢性血栓塞栓性肺高血圧症	子宮線維症
眼振誘発	眼振	大動脈弁狭窄症兼僧帽弁閉鎖不全症兼三尖弁閉鎖不全症
急性ウイルス性脳炎	ウイルス性脳炎	膀胱白板症
掻痒等	そう痒	急性顎骨骨髄炎
労作時呼吸困難感軽度	労作時呼吸困難	症候性そう痒症
逆流性食道炎症状	逆流性食道炎	化膿性リンパ節炎
非代償性Ｃ型肝硬変	Ｃ型非代償性肝硬変	急性小腸虚血
子宮筋腫大	子宮筋腫	産科的創傷の血腫
ヘルペス感染症	ヘルペスウイルス感染症	肺活量減少
抑うつあり	うつ状態	視路疾患
出血腫脹	出血	床形態歯周治療用装置破損
急性感音性難聴	感音難聴	症候性そう痒症
肺塞栓既往	肺塞栓症	胸膜播種
リンパ節多発転移	多部位リンパ節転移	慢性歯肉炎
ｉｎｖａｓｉｖｅ　ｔｈｙｍｏｍａ	悪性胸腺腫	胸膜播種
イレウスリスク高い	イレウス	胸膜播種
左肺下葉扁平上皮癌	下葉肺扁平上皮癌	サイトメガロウイルス脊髄炎
分類不能型免疫不全	免疫不全	化膿性リンパ節炎
高度拘束性換気障害	拘束性換気障害	内側半月板断裂
非典型的胸痛	胸痛	症候性そう痒症
ＭＲＳＡ感染	ＭＲＳＡ感染症	むちうち損傷
肝多発腫瘤	肝腫瘤	腰部尋常性乾癬
左大腿骨病的骨折	大腿骨病的骨折	多尿
Ｓ状結腸癌術後肝転移	転移性肝癌	前足部痛
棘波	心電図異常	網膜静脈血栓症
黄色痰自己喀出	膿性痰	肺活量減少
心膜腔内播種	転移性心腫瘍	肝腫瘤
耳痛	耳痛症	症候性そう痒症
四肢末端しびれ	しびれ感	内反小趾
内頸動脈狭窄	内頚動脈狭窄症	産科的創傷の血腫
胃部分壊死	壊死	多尿
転倒受傷	外傷	症候性そう痒症
左急性感音難聴	感音難聴	症候性そう痒症
タール便少量	黒色便	化膿性リンパ節炎
切除不能胃癌	胃癌	アフラトキシン中毒
後頭葉脳出血	脳出血	第４趾有棘細胞癌
隅角結節	虹彩結節	多尿
落ち着かなさ	多動性障害	症候性そう痒症
脊椎多発圧迫骨折	圧迫骨折	多尿
左傍脊柱筋膿瘍	筋膿瘍	臍帯卵膜付着による新生児の障害
Ⅰ型ＤＭ	糖尿病	胸膜播種
多発ＬＮ転移	多部位リンパ節転移	胸膜播種
右角膜ヘルペス	ヘルペス角膜炎	内反小趾
大腸粘膜癌	癌	若年者キーンベック病
大動脈損傷	上大動脈損傷	産科的創傷の血腫
仙骨前腫瘤	腫瘤	第４趾有棘細胞癌
前頭葉脳出血	脳出血	内反小趾
社会不安症	不安神経症	症候性そう痒症
左頚部食道傍リンパ節転移	リンパ節転移	臍帯卵膜付着による新生児の障害
時折物忘れ	健忘症	症候性そう痒症
左頬部未分化腺癌	癌	若年者キーンベック病
ＩＩ型ＤＭ	２型糖尿病	胸膜播種
脊椎管狭窄	脊柱管狭窄症	第４趾有棘細胞癌
膨満　グル音正常	腹部膨満	内反小趾
顔面神経麻痺静的再建	顔面神経麻痺	内反小趾
低分化性扁平上皮癌	癌	突発性咽頭出血
左房内粘液腫	心臓粘液腫	臍帯卵膜付着による新生児の障害
重症うつ病	うつ病	症候性そう痒症
左肺下葉浸潤影	胸部異常陰影	むちうち損傷
中葉舌区症候群	中葉無気肺	内反小趾
膵管炎	膵炎	視路疾患
軟部組織腫瘤	腫瘤	多尿
腫瘤構造	腫瘤	第４趾有棘細胞癌
慢性誤嚥	嚥下障害	症候性そう痒症
Ｇｍ敗血症	敗血症	膀胱白板症
右大腿部蜂窩織炎	大腿部蜂巣炎	淋菌性腹膜炎
病的腹水	腹水症	膀胱白板症
慢性疲労	疲労感	症候性そう痒症
膿性喀痰	膿性痰	肺活量減少
Ｃｈｏｌｅｄｏｃｈｏｃｅｌｅ	総胆管のう腫	化膿性リンパ節炎
癌再発	癌	抗生物質起因性腸炎
胆汁うっ滞型	胆汁うっ滞	気道閉塞
肺門腫瘤	縦隔腫瘍	手掌部皮下腫瘤
両膝関節疼痛	膝関節痛	エーテル中毒症
右鎖骨転移	骨転移癌	床形態歯周治療用装置破損
緑内症	緑内障	化膿性リンパ節炎
夕方痛み	疼痛	症候性そう痒症
左側副部痛	側腹部痛	症候性そう痒症
後腹膜腫瘍上行結腸浸潤	後腹膜腫瘍	前足部痛
心窩部自発痛	心窩部痛	大動脈弁狭窄症兼僧帽弁閉鎖不全症兼三尖弁閉鎖不全症
リンパ節腫大傾向	リンパ節腫大	床形態歯周治療用装置破損
時々尿失禁	尿失禁症	静脈瘤性動脈瘤
左臀部悪性軟部腫瘍	殿部悪性軟部腫瘍	臍帯卵膜付着による新生児の障害
低血糖遷延	低血糖	膀胱白板症
右中大脳動脈閉塞症	中大脳動脈閉塞症	産科的創傷の血腫
重症ＣＭＶ腸炎	サイトメガロウイルス腸炎	胸膜播種
発熱コントロール	発熱	肺活量減少
右下腿蜂窩織炎	下腿蜂巣炎	総胆管のう腫
膿瘍形成	膿瘍	床形態歯周治療用装置破損
右尿管損傷	尿管損傷	臍帯卵膜付着による新生児の障害
感染性心内膜症	感染性心内膜炎	膀胱内異物
ブドウ球菌検出	ぶどう球菌感染症	胸膜播種
副腎皮質機能不全	副腎皮質機能低下症	前立腺膿瘍
Ｅｓｃｈｅｒｉｃｈｉａ　ｃｏｌｉ	大腸菌感染症	化膿性リンパ節炎
両側網膜剥離	網膜剥離	自己免疫性溶血性貧血
播種性血管内凝固症	播種性血管内凝固	急性小腸虚血
肺野肺門部異常陰影	肺門部異常陰影	ＨＴＬＶ−１感染症
右房浸潤	乳房悪性腫瘍	臍帯卵膜付着による新生児の障害
屈筋腱鞘炎	腱鞘炎	総胆管のう腫
肺結節陰影	胸部異常陰影	完全大血管転位症１型
呼吸困難感等自覚症状	呼吸困難	内側半月板断裂
原発性肺腫瘍	肺腫瘍	胸膜播種
右下腿コンパートメント症候群	下腿コンパートメント症候群	内反小趾
右鎖骨上窩リンパ節腫大	鎖骨上リンパ節腫脹	床形態歯周治療用装置破損
右鼡径部腫脹	鼡径部腫脹	大動脈弁狭窄症兼三尖弁閉鎖不全症
低悪性度リンパ腫	ホジキンリンパ腫	胸膜播種
右側胸部皮下結節	皮下結節	多尿
両側卵巣チョコレート嚢胞	チョコレートのう胞	突発性咽頭出血
回盲部悪性リンパ腫	悪性リンパ腫	突発性咽頭出血
陰部腫脹	陰のう腫大	大動脈弁狭窄症兼三尖弁閉鎖不全症
腹水浸出	腹水症	総胆管のう腫
ＴＡＡ	胸部大動脈瘤	サイトメガロウイルス脊髄炎
腸管皮膚瘻	腸瘻	大動脈弁狭窄症兼三尖弁閉鎖不全症
ライン感染	カテーテル感染症	むちうち損傷
多発擦過傷	擦過創	多尿
脂質異常	脂質異常症	視路疾患
肺嚢胞感染	肺のう胞	視路疾患
Ｃｈｕｒｇ−Ｓｔｒａｕｓｓ　症候群	好酸球性多発血管炎性肉芽腫症	甲状腺出血
脾結核	結核	床形態歯周治療用装置破損
潰瘍性大腸炎急性増悪	潰瘍性大腸炎	尿崩症
肺抗酸菌感染症	肺非結核性抗酸菌症	子宮線維症
２型大腸癌	大腸癌	胸膜播種
両眼網膜症	網膜症	産科的創傷の血腫
左眼結膜炎	結膜炎	大動脈弁狭窄症兼僧帽弁閉鎖不全症兼三尖弁閉鎖不全症
右肺原発腺癌	肺腺癌	ＨＴＬＶ−１感染症
ＣＲＥＳＴ症候群	クレスト症候群	肺活量減少
感覚神経障害	知覚障害	症候性そう痒症
物忘れ	健忘症	症候性そう痒症
脳筋症	ミトコンドリア脳筋症	産科的創傷の血腫
駆細胞型急性リンパ性白血病再発	急性リンパ性白血病	急性小腸虚血
左大腿骨骨腫瘍	大腿骨腫瘍	床形態歯周治療用装置破損
膿瘍縮小	膿瘍	床形態歯周治療用装置破損
右後頭葉塞栓性脳梗塞	塞栓性脳梗塞	産科的創傷の血腫
肝内転移	転移性肝腫瘍	手掌有棘細胞癌
膵管内乳頭粘液腫瘍	膵管内乳頭粘液性腫瘍	突発性咽頭出血
胃癌多発骨転移	胃癌骨転移	床形態歯周治療用装置破損
僧房弁疣贅	疣贅	症候性そう痒症
左膝窩動脈瘤	膝窩動脈瘤	産科的創傷の血腫
腹部背部痛	背部痛	エーテル中毒症
アルコール性ニューロパチー	アルコール性多発ニューロパチー	化膿性リンパ節炎
体幹部発赤	発赤	完全大血管転位症１型
慢性突発性血小板減少性紫斑病	血小板減少性紫斑病	急性小腸虚血
下部消化管穿孔	腸穿孔	内反小趾
Ｔ字杖歩行可能	歩行障害	症候性そう痒症
鎖骨上リンパ節腫大	鎖骨上リンパ節腫脹	床形態歯周治療用装置破損
右大腿ヘルニア嵌頓	大腿ヘルニア嵌頓	臍帯卵膜付着による新生児の障害
大腫瘤影	腫瘤	多尿
双極２型障害	２型双極性障害	甲状腺出血
感染性腹部動脈瘤	感染性腹部大動脈瘤	産科的創傷の血腫
ヘルペス性脳炎	サル痘	肺活量減少
不安症様	不安神経症	症候性そう痒症
右前額部痛	前頭部痛	内反小趾
右胸膜播種	胸膜播種	肝腫瘤
骨折病変	骨折	多尿
半月体形成糸球体腎炎	半月体形成性糸球体腎炎	慢性歯肉炎
筋力低下著明	筋力低下	甲状腺出血
下肢骨折	骨折	多尿
付属器圧痛	圧痛	症候性そう痒症
アスピリンアレルギー	アスピリン不耐症	化膿性リンパ節炎
固形腫瘍	腫瘍	床形態歯周治療用装置破損
嘔吐出現	嘔吐症	膀胱白板症
統合失調症残遺状態	統合失調症	甲状腺出血
右上肢不全片麻痺	不全片麻痺	内反小趾
低血糖生	低血糖	膀胱白板症
劇症型肺炎球菌性敗血症	肺炎球菌性敗血症	膀胱白板症
左大腿蜂窩織炎	蜂窩織炎	淋菌性腹膜炎
発熱有	発熱	膀胱白板症
頭位性回転性めま	体位性めまい	内反小趾
不眠考	不眠症	化膿性リンパ節炎
全失語	全失語症	膀胱白板症
口唇紅潮	紅潮	膀胱白板症
開腹腫瘤	腫瘤	第４趾有棘細胞癌
左尺骨神経障害	尺骨神経麻痺	産科的創傷の血腫
外側部乳癌	乳癌	若年者キーンベック病
脳幹部神経膠腫	脳幹神経膠腫	臍帯卵膜付着による新生児の障害
両足関節以遠しびれ感	しびれ感	内反小趾
左再発性気胸	続発性気胸	大動脈弁狭窄症兼僧帽弁閉鎖不全症兼三尖弁閉鎖不全症
胃のむかつき	悪心	症候性そう痒症
気管性喘息	気管支喘息	症候性そう痒症
痒疹結節散在	痒疹	膀胱白板症
日中下痢	下痢症	膀胱白板症
骨粗鬆症有	骨粗鬆症	総胆管のう腫
先天性胆管欠損	胆管先天奇形	肩甲骨外骨腫
左深部静脈血栓症	深部静脈血栓症	産科的創傷の血腫
冠性Ｔ波	心電図異常	膀胱白板症
多発胸膜肥厚斑	胸膜肥厚	多尿
カンジダ眼内炎	眼内炎	第２腰椎病的骨折
副腎転移	転移性副腎腫瘍	眼瞼異物残留
左緊張性気胸	緊張性気胸	症候性そう痒症
度腟壁裂傷	腟裂傷	総胆管のう腫
仙骨部腫瘤	腫瘤	第４趾有棘細胞癌
帯状疱疹再燃	帯状疱疹	斜台部脊索腫
左前胸部腫瘤	前胸部腫瘤	多尿
喘息症状	咳喘息	症候性そう痒症
ふらつく気	よろめき歩行	膀胱白板症
拡張障害型心不全	心不全	化膿性リンパ節炎
アカシジア症状	錐体路障害	化膿性リンパ節炎
間歇的腹痛	腹痛症	症候性そう痒症
左肺舌区扁平上皮癌	肺扁平上皮癌	抗生物質起因性腸炎
星状細胞腫	星細胞腫	若年者キーンベック病
急性腎障害	腎障害	眼瞼異物残留
左鎖骨上リンパ節腫脹	鎖骨上リンパ節腫脹	床形態歯周治療用装置破損
陳旧性脳出血	脳出血	第４趾有棘細胞癌
良性下垂体腫瘍	下垂体腫瘍	床形態歯周治療用装置破損
腸雑音聴取可	異常腸音	症候性そう痒症
左側頭部帯状疱疹	帯状疱疹	斜台部脊索腫
左肺原発性肺癌	原発性肺癌	胸膜播種
頭蓋内出血性病変	非外傷性頭蓋内出血	内反小趾
閉塞性睡眠呼吸障害	睡眠時無呼吸症候群	化膿性リンパ節炎
右披裂部腫瘍	腫瘍	若年者キーンベック病
両膝変形	変形性膝関節症	多尿
表在性腫瘍	腫瘍	若年者キーンベック病
左母指多指症	副母趾	症候性そう痒症
両側側脳室軽度拡大	脳室拡大	産科的創傷の血腫
脈性右室心筋症	不整脈原性右室心筋症	産科的創傷の血腫
アルコール性末梢神経障害	アルコール性多発ニューロパチー	眼瞼異物残留
縦隔炎併発	縦隔炎	尿崩症
暗紅色斑	紅斑症	内反小趾
骨盤圧痛	骨盤痛	症候性そう痒症
骨巨細胞腫瘍	骨巨細胞腫	床形態歯周治療用装置破損
Ｌａｎｇｈａｎｓ巨細胞	ランゲルハンス細胞組織球症	サイトメガロウイルス脊髄炎
気管支喘息発症	気管支喘息	大動脈弁狭窄症兼僧帽弁閉鎖不全症兼三尖弁閉鎖不全症
分葉状嚢胞性腫瘤	腫瘤	若年者キーンベック病
胆管拡張	胆管拡張症	床形態歯周治療用装置破損
甲状腺肥大	甲状腺疾患	足底部打撲傷
患肢発赤	発赤	内反小趾
好中球浸潤	好中球増加症	静脈瘤性動脈瘤
多房性腫瘤	腫瘤	第４趾有棘細胞癌
夜間不安	不安障害	症候性そう痒症
右上肢線状強皮症	線状強皮症	内反小趾
左内耳障害	迷路障害	症候性そう痒症
左耳介発赤	発赤	化膿性リンパ節炎
朝方倦怠感	倦怠感	症候性そう痒症
後頚部脂肪腫	頚部脂肪腫	足底部打撲傷
副腎性クッシング症侯群	クッシング症候群	前立腺膿瘍
混合性アルカローシス	アルカローシス	ＨＴＬＶ−１感染症
痛く	疼痛	内反小趾
皮疹再燃	発疹	多尿
再発悪性リンパ腫	悪性リンパ腫	突発性咽頭出血
子宮筋腫手術	子宮筋腫	産科的創傷の血腫
時折心窩部痛	心窩部痛	症候性そう痒症
右足根骨骨折	足根骨骨折	多尿
腕頭静脈血栓症	静脈血栓症	内反小趾
脊椎病変	脊椎異常	床形態歯周治療用装置破損
歯状核	歯状核赤核淡蒼球ルイ体萎縮症	多尿
右脛骨骨幹部骨折	脛骨骨幹部骨折	多尿
両側腎盂軽度拡張	腎盂拡張	化膿性リンパ節炎
軽度屈曲拘縮	屈曲拘縮	多尿
左下肺野陰影	下肺野陰影	ＨＴＬＶ−１感染症
ＥＢＶ腸炎	細菌性腸炎	胸膜播種
左側舌癌	舌癌	斜台部脊索腫
足しびれ	下肢しびれ	内反小趾
膵内分泌腫瘍肝転移	転移性肝癌	前足部痛