出現形	正解	予測
痰貯留多	喀痰	過剰喀痰
皮膚リンパ腫	菌状息肉症	皮膚Ｔ細胞リンパ腫
個細胞壊死	壊死	皮膚壊死
左大腿骨顆上骨折	大腿骨外顆骨折	大腿骨顆上骨折
病原性大腸菌Ｏ−１５７感染性腸炎	病原性大腸菌感染症	非感染性大腸炎
口腔粘膜浮腫	浮腫	鼻咽頭浮腫
閉塞性膵炎	膵炎	急性膵炎
多発性脾膿瘍	脾膿瘍	多発性肝膿瘍
舌扁平上皮癌	舌癌	肺扁平上皮癌
両側肺門部浸潤影	胸部異常陰影	肺門部異常陰影
脳障害	脳症	小脳機能障害
ｈｅｍｏｐｈａｇｏｃｙｔｉｃ　ｓｙｎｄｒｏｍｅ	血球貪食症候群	Ｅｕｔｈｙｒｏｉｄ　Ｓｉｃｋ症候群
抗癌剤漏出	薬剤漏出性皮膚障害	抗癌剤漏出性皮膚障害
ｓｙｓｔｅｍｉｃ　ｍａｓｔｏｃｙｔｏｓｉｓ	肥満細胞腫症	ＣＡＤＡＳＩＬ
発汗多量	多汗症	代償性発汗
右上葉肺小細胞癌	上葉肺大細胞癌	上葉非小細胞肺癌
ＳＩＡＤ	抗利尿ホルモン不適合分泌症候群	ＡＩＤＳ
左後頭葉梗塞	脳梗塞	再発性脳梗塞
難治性イレウス	イレウス	偽性イレウス
大腸菌菌血症	菌血症	腸管出血性大腸菌感染症
右前頭葉出血	脳出血	前房出血
仙椎陳旧性骨折	陳旧性骨折	陳旧性腰椎骨折
乳癌既往	乳癌	非浸潤性乳癌
心室中隔穿孔	心室中隔欠損症	急性心筋梗塞後心室中隔穿孔
ぼんやり感持続	反応性低下	体感消失
皮疹不変	発疹	全身発疹
創部痛	術創部痛	項部痛
腸閉塞歴	イレウス	直腸閉鎖
紅斑局面多発	紅斑症	水疱性多形紅斑
下部進行食道癌	食道癌	下部食道癌
無γグロブリン血症	無ガンマグロブリン血症	Ｘ連鎖無ガンマグロブリン血症
手首疼痛	疼痛	手背部痛
ｓｐｌｅｎｉｃ　ｍａｒｇｉｎａｌ　ｚｏｎｅ　ｌｙｍｐｈｏｍａ	脾辺縁帯リンパ腫	ＣＡＤＡＳＩＬ
体動時息ぎれ	労作時呼吸困難	行動緩慢
一部浮腫	浮腫	全身性浮腫
ふらつき注意	よろめき歩行	よろめき感
新出肝転移	転移性肝癌	転移性肝腫瘍
脊椎カリエス	脊椎結核	脊椎カリエス後遺症
行動障害	素行障害	感覚運動障害
小豆大紅斑	紅斑症	多形紅斑
ＦＳＧＳ	巣状糸球体硬化症	ＡＩＤＳ
腹腔鏡補助下子宮筋腫核	子宮筋腫	巨大子宮筋腫
神経根障害	神経根炎	胸髄神経根障害
糖尿病性腎症１期	腎性糖尿	１型糖尿病性腎症第１期
左前頭葉心原性脳梗塞	心原性脳塞栓症	心原性小脳梗塞
閉塞性尿路感染	尿路感染症	感染後尿道狭窄
顔面蝶形紅斑	ＬＥ蝶形皮疹	多形紅斑
仙骨部色素沈着	色素異常症	鉄色素沈着
肥満糖尿病	糖尿病	前糖尿病
左肩痛み	肩部筋痛	肩部痛
ＰＳＶＴ発作	発作性上室頻拍	ＡＩＤＳ
ＤＭＮ　２期	糖尿病	ＨＤＬＳ
労作時胸部絞扼感	胸内苦悶	足部絞扼性神経障害
右膝変形	変形性膝関節症	足部変形
骨性腫瘤	腫瘤	骨腫瘤
精神病様症状	精神病	症状精神病
項頸部痛	頚部痛	項部痛
左大腿骨転子部粉砕骨折	転子下骨折	大腿骨転子部骨折
最近眠気	非器質性過眠症	睡眠薬依存
ＶＨＤ	心臓弁膜症	ＨＤＬＳ
重症肺血栓塞栓症	肺塞栓症	肺血栓塞栓症
右乳突蜂巣	乳様突起炎	先天性蜂巣状肺
右肺尖部気胸	気胸	人工気胸
骨盤内子宮内膜症	子宮内膜症	骨盤子宮内膜症
局麻薬アレルギー	薬物過敏症	抗アレルギー薬中毒
右肩関節亜脱臼半横指	肩関節亜脱臼	肩関節前方亜脱臼
慢性蕁麻疹	慢性じんま疹	麻疹
高分化型漿液性腺癌	癌	甲状腺未分化癌
外側疼痛	疼痛	急性疼痛
卵巣癌再発卵巣癌	卵巣癌	再発卵巣癌
奬液性嚢胞腺腫	膵漿液性のう胞腺腫	胞状腺腫
脳血栓塞栓症	脳血管閉塞性脳梗塞	脳塞栓症
左リウマチ性肘関節症	関節リウマチ・膝関節	関節リウマチ・肘関節
気分不快時	悪心	気分異常
脂肪性腫瘤	脂肪腫	脊髄脂肪髄膜瘤
ウィルス性肺炎	肺炎	ウイルス性肺炎
類円形紅斑	紅斑症	多形紅斑
書字不能	書痙	書字障害
夜間不眠状態	不眠症	不規則睡眠
熱型	発熱	夏期熱
骨盤内充実性腫瘍	骨盤腫瘍	骨盤内良性軟部腫瘍
両側角乾燥性結膜炎	結膜炎	乾性角結膜炎
微熱持続	微熱	持続熱
夕方浮腫	浮腫	顔面浮腫
直腸肛門奇形	鎖肛	胃腸奇形
右大腿部腫瘍	大腿悪性軟部腫瘍	大腿腫瘍
壊死性遊走性紅斑	遊走性紅斑	慢性遊走性紅斑
上大静脈血栓	静脈血栓症	下大静脈血栓症
骨盤内ＬＮ転移	骨盤内リンパ節転移	骨盤転移
ＰＫＤ	多発性のう胞腎	ＰＣＷＨ
分水嶺脳梗塞	脳梗塞	分水界梗塞
上皮性腫瘍	腫瘤	前立腺上皮内腫瘍
大球性正色素貧血	大球性貧血	正球性正色素性貧血
挙上空腸穿孔	腸穿孔	直腸穿孔
肛門周囲びらん	外痔びらん	肛門部びらん
胸部不快	胸内苦悶	胸部不快感
下葉肺炎	肺炎	大葉性肺炎
右足根部粉砕骨折	粉砕骨折	上腕骨粉砕骨折
左大脳陳旧性ラクナ梗塞	陳旧性ラクナ梗塞	多発性ラクナ梗塞
出血多量	急性大量出血	多量出血
腹水多量	腹水症	異常腹水
腸間膜リンパ管腫	リンパ管腫	腸間膜リンパ節腫脹
右乳腺線維腫症	線維腫	乳腺線維腫
肺野鬱血像	肺野異常陰影	肺胞出血
陰嚢びらん	陰のうびらん	陰茎びらん
精神的ショック	ショック	心原性ショック
右上腕骨外側上顆炎	外側上顆炎	上腕骨骨髄炎
子宮頚上皮内癌	子宮頚部上皮内癌	子宮頚管上皮内癌
難治性非定型性抗酸菌症	非結核性抗酸菌症	多剤耐性腸球菌感染症
大後頭孔狭窄	軟骨形成不全症	後天性後鼻孔狭窄
熱型変化	発熱	突発性発熱
月経痛コントロール不十分	月経痛	スルーダー神経痛
右ＤＶＴ	深部静脈血栓症	ＡＶＭ
非特異的胸痛	胸痛	反復性胸痛
Ａｅｒｏｍｏｎａｓ　ｈｙｄｒｏｐｈｉｌａ敗血症	敗血症	ＭＲＳＡ敗血症
重症細菌性敗血症	敗血症	放線菌症性敗血症
腹直筋膜下血腫	筋肉内血腫	腹壁下血腫
関連腎臓病	腎疾患	慢性腎臓病
左腰部疼痛	腰痛症	腰殿部痛
ＨＣＶ重複感染症	Ｃ型肝炎ウイルス感染	ＨＴＬＶ−１感染症
非ケトン性高血糖	高血糖高浸透圧症候群	ケトン性低血糖症
Ｙｅｒｓｉｎｉａ腸炎	エルシニア腸炎	ＭＲＳＡ腸炎
声帯浮腫	声帯炎	声門浮腫
咳嗽持続	咳	慢性咳嗽
左側下顎骨嚢胞	顎骨のう胞	上皮性顎骨のう胞
胆管閉鎖症	胆管閉塞症	胆道閉鎖症
シャント吻合部狭窄	透析シャント狭窄	吻合部狭窄
無気力	無力症	無気肺
上肢疼痛	疼痛	上肢痛
Ｔｕｒｎｅｒ症候群	ターナー症候群	ＶＡＴＥＲ症候群
左心不全徴候	心不全	左心不全
ＩＰＭＮ癌化	膵管内乳頭粘液性腺癌	ＡＬＫ融合遺伝子陽性非小細胞肺癌
朝方疼痛	疼痛	慢性疼痛
蜂窩肺形成	蜂窩織炎	先天性蜂巣状肺
右ＩＣＡ高度狭窄	内頚動脈狭窄症	小脳動脈狭窄
膵体部嚢胞	膵のう胞	膵漿液性のう胞腫瘍
非ヘルペス性辺縁系脳炎	辺縁系脳炎	ヘルペス脳炎
無症候性ＶＴ	心室頻拍	ＱＴ短縮症候群
口腔清掃	個人衛生の著しいレベル低下	口腔乾燥症
無石性胆嚢炎	胆のう炎	原発性胆汁性胆管炎
残像腫瘍	腫瘍	縦隔腫瘍
両顎下腺腫大	顎下腺肥大	顎下腺多形腺腫
夜間中途覚醒時	睡眠障害	不規則睡眠
薬剤性骨髄抑制	骨髄機能低下	骨髄増殖性疾患
中枢神経悪性リンパ腫再発	悪性リンパ腫	脳悪性リンパ腫
非Ｂ非Ｃ型肝硬変	肝硬変症	Ｂ型肝硬変
足がむくみ	下肢浮腫	ざんごう足
難治性浮腫	高度浮腫	周期性浮腫
Ｇｒａｎｕｌｏｍａｔｏｓｉｓ　ｗｉｔｈ　ｐｏｌｙａｎｇｉｉｔｉｓ	多発血管炎性肉芽腫症	Ｅｕｔｈｙｒｏｉｄ　Ｓｉｃｋ症候群
未分化癌	癌	肺未分化癌
両側副腎悪性リンパ腫	悪性リンパ腫	脾悪性リンパ腫
炎症性貧血	貧血	慢性感染性貧血
両下肢掻痒感	皮膚そう痒症	そう痒
ｍａｓｓ　ｌｅｓｉｏｎ	腫瘤	ＭＥＬＡＳ症候群
右大脳半球多発脳梗塞	多発性脳梗塞	多発性小脳梗塞
鎮静困難	興奮状態	行動緩慢
再発腫瘤近傍	腫瘤	多発性皮下腫瘤
腹腔内膿瘍形成	膿瘍	腹腔内膿瘍
腎被膜下出血	外傷性腎被膜下血腫	副腎出血
リンパ腺腫脹	リンパ節腫大	縦隔リンパ節腫脹
疼痛時頓用	疼痛	慢性疼痛
多房性膿瘍	膿瘍	環指膿瘍
右耳介後部痛	耳痛症	耳下部痛
無呼吸症候群	無呼吸発作	急性呼吸窮迫症候群
出血過多	出血	多量出血
甲状腺嚢腫	甲状腺のう胞	甲状腺腫
両側浸出性中耳炎	滲出性中耳炎	慢性滲出性中耳炎
覚醒度	麻酔覚醒遅延	覚醒剤依存症
有意弁膜症	弁膜炎	連合弁膜症
右下肺野無気肺	無気肺	上葉無気肺
小脳性失調	小脳性運動失調症	急性小脳性失調症
主幹動脈狭窄	脳動脈狭窄症	動脈狭窄
創部皮下血腫	外傷性皮下血腫	頭部皮下血腫
両肺小結節影	肺野異常陰影	肺野円形陰影
造影剤アレルギー歴	薬物過敏症	刺虫アレルギー
慢性的な抑うつ気分	うつ状態	神経症性抑うつ状態
鼻部異物肉芽腫	皮膚異物肉芽腫	異物肉芽腫
遠隔ＬＮ転移	リンパ節転移	転移性縦隔腫瘍
子宮がん	子宮癌	子宮頚部びらん
睾丸腫脹	精巣腫脹	鼡径部腫脹
脳実質外腫瘍	腫瘍	遺伝性脳腫瘍
抑鬱感	気うつ	空気飢餓感
扁桃腺腫大	扁桃肥大	扁桃腫瘍
口内出血	口腔出血	内出血
進行肝癌	肝癌	胃進行癌
噴門部狭窄	胃狭窄	噴門狭窄
突発性腎出血	腎出血	特発性腎出血
傍大動脈ＬＮ	大動脈周囲リンパ節転移	遺残性頚動脈脳底動脈吻合
左椎骨動脈低形成	骨髄低形成	椎骨脳底動脈循環不全
左房拡張	心拡大	共通房室口
下肢筋痛	下肢筋肉痛	下肢痛
蠕動不良	異常腸音	運動失行
黒色丘疹	丘疹	紅色丘疹
Ｈａｅｍｏｐｈｉｌｕｓ　ｉｎｆｌｕｅｎｚａｅ敗血症	敗血症	ＭＲＣＮＳ敗血症
右上葉原発肺小細胞癌	小細胞肺癌	上葉非小細胞肺癌
出血源不詳	出血	出血傾向
浸潤癌化所見	癌	肺未分化癌
痔核脱出	痔核	脱出性内痔核
重症膵炎	膵炎	重症急性膵炎
痛みアリ	疼痛	前頭部痛
右足疼痛	疼痛	足痛
増殖前網膜症	網膜症	増殖性網膜症
傍神経節腫瘍	傍神経節腫	神経細胞腫瘍
小腸膀胱瘻	膀胱皮膚瘻	膀胱腸瘻
少量左胸水	胸水貯留	血性胸水
多発ＨＣＣ再発	肝細胞癌	ＨＣＡＨＣ
結核性嚢腫	結核	結核腫
大腿腫脹	下腿腫脹	大腿部腫脹
全身性ＣＭＶ感染症	サイトメガロウイルス感染症	ＭＲＣＮＳ感染症
両下肢圧痕性浮腫	クインケ浮腫	上肢浮腫
下部腸間膜動脈出血	動脈性出血	上腸間膜動脈解離
ＩｇＭ型Ｍ蛋白	単クローン性免疫グロブリン血症	家族性高リポ蛋白血症２ｂ型
喘息発作様症状	気管支喘息発作	運動誘発性喘息
分食道癌	食道癌	食道未分化癌
多少便秘気味	便秘症	単純性便秘
全身皮膚発赤	発赤	下腿発赤
多発肺嚢胞	肺のう胞	先天性のう胞肺
口腔内びらん	口唇びらん	鼻腔内びらん
紅斑熱群リケッチア症	リケッチア感染症	日本紅斑熱
ＩＴＰ	特発性血小板減少性紫斑病	ＡＩＤＳ
ｂｒｅａｋｔｈｒｏｕｇｈ　ｈｅｐａｔｉｔｉｓ	肝炎	Ｅｕｔｈｙｒｏｉｄ　Ｓｉｃｋ症候群
左室圧排	右室肥大	総排泄腔外反症
両側声帯外転障害	声帯外転筋麻痺	発声障害
一部水疱形成	水疱症	単純型表皮水疱症
飲みこみにくさ	嚥下障害	多飲症
副腎ヒストプラズマ感染症	真菌症	マイコプラズマ感染症
両松葉杖歩行	歩行障害	内転歩行
遺伝性低尿酸血症	低尿酸血症	続発性高尿酸血症
小腸皮膚瘻	皮膚瘻	直腸皮膚瘻
非細菌性血栓性疣贅	疣贅	化膿性疣贅
特発性腸間膜血腫	血腫	大腸血管腫
肝骨転移	骨転移癌	肝癌骨転移
乳腺線維腫症	線維腫	乳腺線維腫
術後左反回神経麻痺	反回神経麻痺	術後性反回神経麻痺
無症候性髄膜腫	髄膜腫	悪性脊髄髄膜腫
表皮内水疱形成	先天性表皮水疱症	単純型表皮水疱症
後頚部圧痛	圧痛	腹部圧痛
良性胆道狭窄	胆管狭窄症	術後胆管狭窄
ＣＫＤ　腎硬化症	腎硬化症	良性腎硬化症
前頭葉出血	出血	前房出血
有茎性乳頭状腫瘍	腫瘍	充実性偽乳頭状腫瘍
理解困難	言語理解障害	呼吸困難
腹腔内敗血症	敗血症	炭疽敗血症
膵尾部腫大	膵腫大	膵体尾部腫瘍
過呼吸状態	過換気症	呼吸困難
右肺門部原発肺小細胞癌	小細胞肺癌	肺門部非小細胞癌
胃癌骨髄癌腫症	骨髄転移	胃体部癌
眼乾燥感	ドライアイ	眼瞼乾皮症
内側縦束症候群	核間性眼筋麻痺	双線弧線装置破損
夜低血糖	低血糖	夜間低血糖症
左上下肢軽度麻痺	四肢麻痺	下肢麻痺
下肢痙性	痙性対麻痺	下肢痙攣
皮疹状況	発疹	斑状皮疹
髄外形質細胞腫	骨外性形質細胞腫	形質細胞腫
ｍａｌｉｇｎａｎｔ　ｌｙｍｐｈｏｍａ	悪性リンパ腫	ＣＡＤＡＳＩＬ
重症ＡＧＨＤ	重症成人成長ホルモン分泌不全	高ＩｇＤ血症
湿疹性病変	湿疹	急性湿疹
手内筋萎縮	筋萎縮症	上肢筋萎縮
昨夜微熱	微熱	慢性微熱
腓腹筋痙攣	痙攣	腓腹筋痛
破壊性脊椎症	脊椎症	外傷性脊椎症
独歩不可	歩行障害	歩行困難
骨破壊進行	関節リウマチ	人工骨頭破損
下肢白癬	白癬	四肢白癬
熱苦症状	発熱	熱疲労
肺動脈弁閉鎖症	肺動脈弁閉鎖	純型肺動脈弁閉鎖症
脾摘施行Ｃ型肝炎	Ｃ型肝炎	２型自己免疫性膵炎
胸水セルブロック	胸水貯留	胸水検査異常
右肺上葉すりガラス影	胸部異常陰影	下肺野陰影
Ｆｏｌｌｉｃｕｌａｒ　ｌｙｍｐｈｏｍａ	濾胞性リンパ腫	ＣＡＲＡＳＩＬ
腫瘍性ＤＩＣ	線溶亢進	ＶＩＰ産生腫瘍
左肘関節亜脱臼	亜脱臼	肩関節亜脱臼
左肺感染性嚢胞	肺のう胞	Ｂ群溶連菌感染症
右足趾壊疽	下肢壊疽	足壊疽
残遺癌	癌	残胃癌
不安大きく	不安障害	不安緊張状態
ＭＳ再発	多発性硬化症	ＨＤＬＳ
強直間代性痙攣発作	間代性痙攣	間代強直性痙攣
一過性意識消失発作	一過性脳虚血発作	意識消失
乳児白血病	白血病	乳児偽白血病
筋委縮	筋萎縮症	筋短縮症
水腎再燃	水腎症	先天性水腎症
左鼠経ヘルニア	鼡径ヘルニア	上腹壁ヘルニア
糖尿病神経症	糖尿病性神経痛	糖尿病性末梢神経障害
左室低形成	左心低形成症候群	右室低形成
劇症肝炎亜急性型	劇症肝炎	Ａ型劇症肝炎
分岐部動脈瘤	内頚動脈後交通動脈分岐部動脈瘤	内頚動脈眼動脈分岐部動脈瘤
腫瘍感染	腫瘍	皮膚腫瘍
悪性腫瘍スクリーニング	悪性腫瘍	悪性グロームス腫瘍
右踵骨折	骨折	踵骨骨折
ＰＰＨ	肺高血圧症	ＰＣＷＨ
静脈炎症状	静脈炎	静脈炎後症候群
子宮間質肉腫	肉腫	子宮内膜間質肉腫
右主気管支膜様部壊死	壊死	閉鎖性胸部気管損傷
右下肺野スリガラス影	胸部異常陰影	肺野円形陰影
時々頭痛	頭痛	一次性頭痛
胆嚢腺扁平上皮癌	癌	上部胆管癌
突発性血小板減少性紫斑病	血小板減少性紫斑病	続発性血小板減少性紫斑病
意識変動	意識障害	意識消失
左閉鎖リンパ節転移	リンパ節転移	多部位リンパ節転移
左前腕浮腫	浮腫	上腕浮腫
偽腔閉塞型大動脈解離	解離性大動脈瘤	早期血栓閉鎖型大動脈解離
高度感音性難聴	感音難聴	高度難聴
胆嚢腫瘍	胆のう腫瘍	胆管腫瘍
胃がん	胃癌	胃びらん
左中大脳動脈梗塞	中大脳動脈塞栓症	脳外主幹動脈閉塞脳梗塞
Ｓｏｔｏｓ症候群	ソトス症候群	ＳＡＰＨＯ症候群
肺炎反復	肺炎	急性肺炎
多発性腎梗塞	腎梗塞	外傷性腎梗塞
変動一過性徐脈	徐脈	徐脈性不整脈
三角圧痛	肩部筋痛	圧痛
乳癌局所再発	乳癌	乳癌再発
頚椎症性神経根炎	頚椎症性神経根症	軸椎骨髄炎
痛みきつい	疼痛	片側痛覚過敏
両側顎下腺腫大	顎下腺肥大	顎下腺多形腺腫
ビタミンＤ不足	ビタミンＤ欠乏症	ビタミンＤ過剰症
日中下痢便	下痢症	慢性下痢症
胸郭低形成	胸郭異常	右室低形成
肺スリガラス陰影	胸部異常陰影	肺門部異常陰影
口蓋腫瘤	腫瘤	顎部腫瘤
パーキンソン病関連疾患	パーキンソン病	若年性パーキンソン病
グラム陰性桿菌菌血症	グラム陰性桿菌敗血症	グラム陰性桿菌感染症
開腹子宮筋腫核	子宮筋腫	巨大子宮筋腫
白内障手術	白内障	白内障術後
直腸癌Ｒａ	直腸癌	ＫＲＡＳ遺伝子野生型直腸癌
カルボプラチンアレルギー	薬物過敏症	ラテックスアレルギー
肺原発ホジキンリンパ腫	ホジキンリンパ腫	ＨＩＶ非ホジキンリンパ腫
重度精神運動発達遅滞	混合性特異的発達障害	自閉性精神発達遅滞
筋緊張高く	筋強直	筋緊張性障害
母指潰瘍治癒遅延	皮膚潰瘍	指尖難治性皮膚潰瘍
歩行時呼吸困難感	労作時呼吸困難	呼吸困難
痰症状	喀痰	膿性痰
腸管血流障害	末梢循環障害	脳血管障害
全身性単純ヘルペスウイルス感染症	ヘルペスウイルス感染症	ＨＩＶヘルペスウイルス感染症
緑色痰	喀痰	膿性痰
ポンプポケット内血腫	血腫	縦隔血腫
尿量低下	乏尿	腹圧性尿失禁
むつかぶれ	おむつ皮膚炎	つかえ感
水平亜脱臼	亜脱臼	水晶体亜脱臼
早期癌	癌	末期癌
吻合部出血	出血	咽頭出血
子宮頸がん	子宮頚癌	子宮頚部びらん
腺扁平上皮癌	癌	肺腺扁平上皮癌
喉頭蓋サルコイドーシス	サルコイドーシス	皮膚サルコイドーシス
声門部狭窄	喉頭狭窄症	先天性声門下狭窄症
頭蓋底髄膜腫	髄膜腫	中頭蓋窩髄膜腫
膵全体癌	膵癌	膵体部癌
手掌黄色腫	黄色腫症	偽黄色腫
非吻合部多発胆管狭窄	胆管狭窄症	術後胆管狭窄
左腎嚢胞不変	腎のう胞	単純性腎のう胞
左手首痛	手部痛	手関節痛
続発性赤芽球癆	赤芽球ろう	慢性後天性赤芽球ろう
インフルエンザ菌	インフルエンザ	インフルエンザ菌感染症
左舌区小細胞癌	小細胞肺癌	肺門部非小細胞癌
成人発症Ｓｔｉｌｌ病（ＡＯＳＤ）	成人スチル病	ＨＤＬＳ
大球性正色素性貧血	正色素性貧血	正球性正色素性貧血
限局型全身性強皮症	全身性強皮症	限局性強皮症
両下肢痛み	疼痛	下肢痛
ＳＭＡ浸潤	膵癌	ＭＲＳＡ感染症
微小癌	癌	小細胞肺癌
高Ｃｌ血症	高クロール血症	高ＬＤＬ血症
乳頭状腺癌	癌	乳頭腺管癌
内臓播種性ＶＺＶ感染症	汎発性帯状疱疹	ＨＴＬＶ−１感染症
様皮疹	発疹	斑状皮疹
骨形成不全症Ⅲ型	骨形成不全症	骨形成不全症２型
高度肥満症	病的肥満症	肥満症
右前頭葉脳内血腫	血腫	外傷性脳内血腫
四肢関節腫脹	関節炎	足関節腫脹
右腸骨静脈血栓症	腸骨静脈圧迫症候群	腸骨動脈血栓症
眼瞼結膜軽度貧血	貧血	眼瞼結膜出血
子宮頸癌Ⅲｂ期	子宮頚癌	子宮頚部微小浸潤癌
肝内腫瘤性病変	腫瘤	肝腫瘤
血管性紫斑病	症候性紫斑病	血管拡張性環状紫斑症
ＡＳＤ	心房中隔欠損症	ＡＩＤＳ
緑膿菌肺感染症	緑膿菌肺炎	緑膿菌感染症
ふらつきあり転倒リスク高い	めまい	タングクリブ不適合
食道癌術後リンパ節転移	リンパ節転移	胃周囲リンパ節転移
亜急性期小脳梗塞	小脳梗塞	多発性小脳梗塞
喘息コントロール	咳喘息	非アトピー性喘息
中高分化型腺癌	癌	甲状腺未分化癌
身体外傷	外傷	頭部外傷
神経根性痛	疼痛	慢性神経痛
白色壊死組織付着	壊死	皮膚壊死
夜間中途覚醒	睡眠障害	深昏睡
無涙症	涙液分泌不全	無汗症
ｃｒｉｔｉｃａｌ　ｉｌｌｎｅｓｓ　ｐｏｌｙｎｅｕｒｏｐａｔｈｙ	多発ニューロパチー	ＣＡＲＡＳＩＬ
水疱瘡	水疱症	水疱性類天疱瘡
軽度高Ｋ血症	高カリウム血症	高ＨＤＬ血症
水様便流出	下痢症	排便後出血
Ｅｎｔａｍｏｅｂａ　ｈｉｓｔｏｌｙｔｉｃａ	アメーバ赤痢	ＣＡＲＡＳＩＬ
大腿筋横紋筋肉腫	横紋筋肉腫	大腿横紋筋肉腫
腸炎性関節炎	関節炎	肺炎球菌性関節炎
ＰＭＳ	月経前症候群	ＨＤＬＳ
腓腹部圧痛	腹部圧痛	腓腹部痛
非チフス性Ｓａｌｍｏｎｅｌｌａ菌血症	菌血症	ＢＬＮＡＲ感染症
微小多発肝膿瘍	肝膿瘍	多発性肝膿瘍
輪状披裂関節炎	関節炎	破壊性関節炎
左下肢蜂窩織炎	下肢蜂巣炎	蜂窩織炎
咽頭残留	嚥下障害	咽頭腐蝕
大量水様下痢	下痢症	発酵性下痢
処方右乳癌	乳癌	異所性乳癌
弧発性古典的ＣＪＤ	孤発性クロイツフェルト・ヤコブ病	ＩＣＵ症候群
呼吸機能低下	呼吸機能検査異常	肺性呼吸困難
右大腿リンパ節転移	リンパ節転移	多部位リンパ節転移
膝関節水腫	膝関節水症	関節水腫
好酸球性胆嚢炎	胆のう炎	自己免疫性胆管炎
左下腿骨幹部骨折	骨折	大腿骨骨幹部骨折
ふらつき有	めまい	よろめき感
結核性ブドウ膜炎	結核性ぶどう膜炎	結核性腹膜炎
痙直型四肢麻痺	四肢麻痺	痙性四肢麻痺
角化性紅斑散在	紅斑症	多形紅斑
慢性腎炎	慢性腎炎症候群	腎炎
左側頭葉皮質化出血	出血	皮質脳内出血
右足底腱膜炎	足底筋膜炎	膝部腱膜炎
右鼡径部疼痛	鼡径部痛	慢性疼痛
高～中分化型管状腺癌	癌	環指基底細胞癌
Ｌａｍｉｖｕｄｉｎｅ耐性Ｂ型肝硬変	Ｂ型肝硬変	Ｃ型非代償性肝硬変
湿疹化	湿疹	汗疹湿疹化
下肢対麻痺	対麻痺	下肢麻痺
下腿点状出血	点状出血	大腿部皮下出血
脈管奇形	奇形	脳静脈奇形
可動時痛	疼痛	痙攣陣痛
下垂手	垂れ手	下垂足
痰がからみ	喀痰	喀痰喀出困難
右鼠経ヘルニア修復術	鼡径ヘルニア	腹壁瘢痕ヘルニア
足趾冷感	下肢冷感	趾擦過創
腎前性脱水	脱水症	脱水を伴う妊娠悪阻
頸部皮下膿瘍	皮膚膿瘍	頚部膿瘍
ウイルス性感冒	感冒	ウイルス感染症
腹部自発痛	腹痛症	側胸部痛
中分化型前立腺癌	前立腺癌	前立腺小細胞癌
褥瘡形成リスク高い	褥瘡	褥瘡・ＤＴＩ
腰椎変性辷り症	腰椎変性すべり症	腰椎側弯症
手術高血圧	高血圧症	術中低血圧
嚥下下困難	嚥下障害	嚥下困難
てんかん脳波	異常脳波	脳炎後てんかん
腹水多量貯留	腹水症	胸水貯留
ＣＭＶ胃腸炎	サイトメガロウイルス腸炎	ＭＲＳＡ腸炎
両Ｔ字杖歩行	歩行障害	内転歩行
出血付着程度	出血	出血傾向
右海綿静脈洞髄膜腫	髄膜腫	傍矢状洞髄膜腫
壊死性筋炎	筋炎	壊死性筋膜炎
両下腿紅斑	紅斑症	手掌紅斑
低Ｃａ血症	低カルシウム血症	高ＨＤＬ血症
二次性副腎不全	副腎クリーゼ	急性腎前性腎不全
一週間程度眠気	非器質性過眠症	不規則睡眠
子宮内腔癒着	子宮内膜症	子宮頚部癒着
下熱	発熱	高熱
右母指陳旧性尺側側副靱帯損傷	靱帯損傷	陳旧性母指側副靱帯損傷
皮膚型ＰＮ	結節性多発動脈炎	ＨＤＬＳ
副鼻腔軽度粘膜肥厚	副鼻腔炎	急性副鼻腔蓄膿症
前回貧血	貧血	先天性貧血
骨粗鬆症性圧迫骨折	骨粗鬆症・病的骨折あり	膝蓋骨不顕性骨折
右肺原発肺腺癌	肺腺癌	原発性肺癌
脊髄原発悪性リンパ腫	悪性リンパ腫	悪性リンパ腫骨髄浸潤
手指浮腫	浮腫	足部浮腫
皮質性認知症	皮質下認知症	皮質認知症
後縦隔腫瘤	縦隔腫瘍	横隔膜腫瘤
頚椎症性脊椎症	脊椎症	頚椎症性脊髄症
中部延髄右外側脳梗塞	脳梗塞	延髄梗塞
仙骨部瘻孔	難治性瘻孔	仙骨部褥瘡
右傍気管リンパ節転移	リンパ節転移	気管支リンパ節転移
ｓｍａｌｌ　ｃｅｌｌ　ｃａｒｃｉｎｏｍａ	癌	ＣＡＲＡＳＩＬ
遺伝性出血性毛細血管拡張症	オスラー病	毛細血管拡張症
間質性肺炎評価	間質性肺炎	急性間質性肺炎
右肺門部原発	原発性肺癌	原発性肺ペスト
瘢痕様変化	瘢痕	萎縮性瘢痕
核下性顔面神経麻痺	顔面神経麻痺	中枢性顔面神経麻痺
左尿管結石	尿管結石症	腎尿管結石
乾性咳嗽頻回	乾性咳	慢性咳嗽
右側頭部紫斑	紫斑病	老人性紫斑
薬剤過敏性症候群	薬物過敏症	薬剤性過敏症症候群
紫斑形成軽度	紫斑病	色素性紫斑
子宮筋腫核出後妊娠	妊娠	子宮筋層内妊娠
ＡＲＤＳ合併	急性呼吸窮迫症候群	ＡＩＤＳ
右副腎原発	副腎腫瘍	副腎のう胞
ｋｌｅｂｓｉｅｌｌａ　ｐｎｅｕｍｏｎｉａｅ感染症	クレブシェラ属感染	ＥＳＢＬ産生菌感染症
めまい軽度	めまい	めまい症
右横隔膜筋欠損	筋欠損	横隔膜欠損
脳症後遺症	脳症	脳手術後遺症
漿膜損傷	損傷	硬膜損傷
ふらつき目立	めまい	顔面せつ
近位筋痛	筋肉痛	項背部筋痛
ノカルジア脳膿瘍	ノカルジア症	アメーバ性脳膿瘍
右前腕皮疹	発疹	四肢発疹
後腹膜浸潤	後腹膜悪性腫瘍	腹膜癒着
網状紫斑	紫斑病	色素性紫斑
胚細胞腫瘍	腫瘍	卵巣胚細胞腫瘍
ゲノタイプ１ｂ型Ｃ型肝硬変	Ｃ型肝硬変	Ｂ型肝硬変
類円形腫大	リンパ節腫大	線維形成性小円形細胞腫瘍
中枢性気管支拡張像	気管支拡張症	先天性気管支拡張症
小股歩行	歩行異常	内反歩行
糖尿病末梢神経障害	糖尿病性単ニューロパチー	糖尿病性末梢神経障害
ルンバール後頭痛	腰椎穿刺後頭痛	典型的前兆に頭痛を伴う片頭痛
急性重症Ｂ型肝炎	Ｂ型肝炎	Ｂ型急性肝炎
下垂時疼痛	疼痛	下肢痛
頚部蜂窩織炎	頚部蜂巣炎	蜂窩織炎
腹満不変	腹部膨満	小腹硬満
結核性喉頭狭窄	喉頭狭窄症	喉頭結核
両側鼻内ポリープ	鼻茸	後鼻孔ポリープ
手掌潮紅	紅潮	手掌紅斑
低血糖歴何年	低血糖	夜間低血糖症
離床時眩暈	めまい	起立性眩暈
ＳＬＥ発症	全身性エリテマトーデス	ＬＧＬ症候群
軽度咽頭違和感	咽頭異常感症	咽喉頭異常感症
体熱感	不明熱	体感異常
両側大腰筋血腫	血腫	腰部血管腫
ＰＳＬＮ転移	大動脈周囲リンパ節転移	テント上下転移性腫瘍
肺腫瘍塞栓症	肺腫瘍	肺塞栓症
圧迫性脊髄症	脊髄症	脊髄圧迫症
出血源不明	出血	出血傾向
椎間板突出	椎間板症	椎間板変形
カルチノイド腫瘍	カルチノイド	胸腺カルチノイド
心臓内腫瘤	腫瘤	心臓腫瘍
日中気分不快	悪心	気分異常
けいれん再発	痙攣	てんかん様発作
手指痺れ	しびれ感	手指こわばり
左卵管水腫	卵管留水症	胎児水腫
歩行時呼吸困難	労作時呼吸困難	夜間呼吸困難
ガーゼ出血	出血	点状出血
右被殻脳梗塞	被殻出血	再発性脳梗塞
腺腫内癌	癌	大腸腺腫内癌
膣転移	腟癌	転移性腎腫瘍
左小脳陳旧性梗塞	陳旧性脳梗塞	陳旧性小脳梗塞
淡黄色粘稠痰	喀痰	膿性痰
外傷所見	外傷	頭部外傷
左末梢性肺動脈狭窄	肺動脈狭窄症	末梢性肺動脈狭窄症
骨代謝異常	代謝障害	骨異栄養症
心陰影拡大	胸部異常陰影	異常心陰影
腎動脈下腹部大動脈瘤	腹部大動脈瘤	腎動脈瘤
腸管壁内気腫	皮下気腫	口腔粘膜下気腫
慢性活動性ＥＢＶ感染症	ＥＢウイルス感染症	急性ＨＩＶ感染症候群
足関節圧痛	関節痛	足関節痛
顔面紅班	紅斑症	顔面紅潮
排便痛	排便障害	排尿痛
代謝異常	代謝障害	基礎代謝率異常
両下肢リンハ゜浮腫	下肢リンパ浮腫	上肢浮腫
左頸部ＬＮ腫脹	肘リンパ節腫脹	縦隔リンパ節腫脹
肺門部リンパ節腫脹	リンパ節腫大	肺門リンパ節腫脹
呼吸困難感軽度	呼吸麻痺	呼吸困難
左膝窩動脈血栓症	動脈血栓症	大腿静脈血栓症
開口制限	開口不全	開口障害
変形性関節炎	変形性関節症	破壊性関節炎
鼠径部血腫	血腫	頭部血腫
暗赤色嘔吐	嘔吐症	糞便性嘔吐
左増殖性糖尿病網膜症	糖尿病網膜症	増殖性糖尿病性網膜症
レム睡眠行動異常	異常行動	レム睡眠行動障害
声帯癌	声門癌	仮声帯癌
左大腿部疼痛	大腿痛	大腿内側部痛
中枢神経浸潤	中枢神経系損傷	中枢神経ループス
直腸皮下瘻孔	難治性瘻孔	直腸皮膚瘻
胆嚢腫大	胆のう肥大	胆管腫瘍
Ｈｅｅｒｆｏｒｄｔ症候群	ぶどう膜耳下腺熱	ＭＥＲＲＦ症候群
失見当障害	見当識障害	失認
ツツガムシ感染症	つつが虫病	アニサキス幼虫感染症
前立腺浮腫	浮腫	全身性浮腫
右鼠径リンパ節腫脹	鼡径部リンパ節腫脹	縦隔リンパ節腫脹
ＡＡＡ破裂	腹部大動脈瘤	ＣＡＤ／ＣＡＭ冠破損
夜間覚醒	不眠症	深昏睡
機会誤嚥	嚥下障害	異物誤嚥
大腿静脈血栓	静脈血栓症	大腿静脈血栓症
新生血管緑内障	緑内障	血管新生緑内障
甲状腺低下症	甲状腺機能低下症	副甲状腺機能低下症
アメーバ肝膿瘍	肝アメーバ症	アメーバ性肝膿瘍
先天性真珠腫	真珠腫	仮性真珠腫
右肺門部浸潤影	胸部異常陰影	肺門部異常陰影
食道悪性腫瘍	食道癌	食道良性腫瘍
レントゲン異常	胸部異常陰影	フィブリノゲン異常症
低酸素症状	低酸素性脳症	低酸素血症
粘稠痰少量	喀痰	膿性痰
ダンベル型腫瘍	腫瘍	ＣＲＨ産生腫瘍
感染性仮性嚢胞	仮性膵のう胞	オザルド糸状虫感染
乳房熱感	ほてり	乳房よう
大腸穿孔	腸穿孔	小腸穿孔
腎瘢痕	瘢痕	腎瘻
孤立性左室緻密化障害	孤立性心筋緻密化障害	房室伝導障害
進行性顔面片側萎縮症	顔面痙攣症	顔面半側萎縮症
非逆流性食道炎	食道炎	逆流性食道炎
甲状腺萎縮	後天性甲状腺萎縮	先天性甲状腺萎縮
呼吸苦自覚症状	呼吸困難	外傷性呼吸困難症
多発単神経障害	多発性単ニューロパチー	多発性神経障害
右肺上葉結節影	胸部異常陰影	肺野円形陰影
リステリア感染症	リステリア症	リケッチア感染症
アルコール性脂肪性肝炎	アルコール性脂肪肝	非アルコール性脂肪性肝炎
脳室穿破	脳出血	脳梁離断術後
鼠径部リンパ節腫大	鼡径部リンパ節腫脹	リンパ節腫大
原発不明癌頸部リンパ節転移	頚部リンパ節転移	肺門リンパ節転移
右下葉原発扁平上皮癌	下葉肺扁平上皮癌	上葉肺扁平上皮癌
便秘悪化	便秘症	習慣性便秘
潜血３	顕微鏡的血尿	便潜血
アレルギー性血管浮腫	浮腫	アレルギー性浮腫
顕微的血尿	血尿	顕微鏡的血尿
日中痛み	疼痛	全身痛
眼球運動痛	疼痛	眼球運動痙攣
Ｙｅｒｓｉｎｉａ　ｅｎｔｅｒｏｃｏｌｉｔｉｃａ感染症	エルシニア菌食中毒	ＭＲＣＮＳ感染症
多発肺内転移	転移性肺癌	転移性肺腫瘍
糖尿病性自律神経障害	糖尿病性自律神経ニューロパチー	糖尿病性末梢神経障害
抗原血症	サイトメガロウイルス感染症	循環性抗凝血因子症
甲状軟骨浸潤	甲状軟骨の悪性腫瘍	甲状軟骨裂
潜在性副腎皮質機能低下症	副腎皮質機能低下症	続発性副腎皮質機能低下症
眼球陷凹	眼球陥没	眼瞼瘻孔
両足趾潰瘍	趾皮膚潰瘍	手指皮膚潰瘍
左鎖骨下リンパ節転移	リンパ節転移	鎖骨上リンパ節転移
両眼糖尿病性網膜症	糖尿病網膜症	２型糖尿病性網膜症
踵部発赤	発赤	下腿発赤
痔疾患	痔核	胼胝
非結核性抗酸菌性人工関節感染症	非結核性抗酸菌症	非結核性抗酸菌性股関節炎
前胸痛	胸痛	前胸部痛
結腸皮膚瘻	皮膚瘻	結腸瘻
患肢熱感	ほてり	下肢冷感
両側腎膿瘍	腎膿瘍	腎周囲膿瘍
潜血	顕微鏡的血尿	便潜血
右鼡径部皮下出血	皮下出血	頭部皮下出血
右下腿筋肉内出血	筋肉内血腫	大腿部皮下出血
気分悪	悪心	気分異常
遠位弓部嚢状動脈瘤	動脈瘤	弓部大動脈瘤
尿潜血遷延	顕微鏡的血尿	便潜血
造骨性骨転移	骨転移癌	骨盤転移
リンハ゜節腫大	リンパ節腫大	鼡径部リンパ節腫脹
皮疹拡大傾向	発疹	全身発疹
依然浮腫	浮腫	全身性浮腫
右足底部蜂窩織炎	足蜂巣炎	蜂窩織炎
進行性直腸癌	直腸癌	胃進行癌
二次性血小板増多症	血小板増加症	二次性血小板増加症
最近浮腫	浮腫	全身性浮腫
労作時頻脈	頻脈症	徐脈発作
重症胆管炎	胆管炎	急性胆管炎
右側胸部痛	胸痛	側胸部痛
右上肢発赤	発赤	下腿発赤
呂律のまわりにくさ	構音障害	排便習慣の変化
アミオダロン誘発性甲状腺中毒症	薬剤性甲状腺機能障害	人為的甲状腺中毒症
左胸部痛	胸痛	側胸部痛
左下腿ＤＶＴ	下腿静脈血栓症	多発性下腿血管損傷
致死性不整脈出現	不整脈	術中心室性不整脈
顆粒膜細胞腫	卵巣顆粒膜細胞腫	悪性顆粒細胞腫
一瞬痛み	疼痛	持続痛
難治性皮膚非定型抗酸菌症	非結核性抗酸菌症	多剤耐性腸球菌感染症
頚部鈍痛	鈍痛	頚部痛
右肺上葉陰影	胸部異常陰影	下肺野陰影
右上葉肺結節	結節性肺結核	皮下結節
味覚変化	味覚障害	味覚消失
浮腫悪化	浮腫	全身性浮腫
凝固異常症	血液凝固異常	凝固因子欠乏症
右側頭葉脳梗塞	脳梗塞	脳幹梗塞
両側下顎骨折	下顎骨骨折	下顎頭骨折
多発性肝腫瘤	肝腫瘍	肝腫瘤
意味性錯語	文意失語症	錯味
ｃｏａｒｓｅ　ｃｒａｃｋｌｅｓ	湿性ラ音	ＣＡＲＡＳＩＬ
緑色下痢便	下痢症	白色便性下痢症
ＡＶブロック	房室ブロック	ＡＶＭ
前縦隔ＬＮ転移	縦隔リンパ節転移	テント上下転移性腫瘍
間質性肺炎発症	間質性肺炎	特発性間質性肺炎
外側脱臼	脱臼	前方脱臼
左殿部疼痛	殿部痛	急性疼痛
両足しびれ	下肢しびれ	四肢しびれ
膜性増殖性	膜性増殖性糸球体腎炎	強膜拡張症
頻脈性心房粗動	心房粗動	頻脈性心房細動
実質外腫瘤	腫瘤	皮下腫瘤
間質性肺炎悪化	間質性肺炎	急性間質性肺炎
重症低体温症	低体温	本態性高体温症
関節炎悪化	関節炎	慢性関節炎
両手指浮腫	浮腫	足部浮腫
浸潤癌化	癌	肺未分化癌
就寝後呼吸困難	呼吸困難	夜間呼吸困難
訪室時疼痛	疼痛	急性疼痛
軽度黄染	黄疸	黄熱
転移性膵癌	膵癌	転移性肝癌
間歇跛行	間欠性跛行	跛行
動脈瘤コイル塞栓術	動脈瘤	脳底動脈先端塞栓症
右膝疼痛	膝関節痛	膝窩部痛
皮内腫瘍	腫瘍	皮膚腫瘍
左前床突起部髄膜腫	髄膜腫	前頭髄膜腫
軽度腹部痛	腹痛症	背部痛
多発毛細血管拡張	オスラー病	毛細血管拡張症
左肺動脈ＰＥ	肺動脈血栓塞栓症	主要大動脈肺動脈側副血行路
胃潰瘍再発	胃潰瘍瘢痕	再発性胃潰瘍
境界域精神発達遅滞	知的障害	自閉性精神発達遅滞
外陰部ｐａｇｅｔ癌	外陰部パジェット病	外陰部アポクリン腺癌
リウマチ様症状	関節リウマチ	リウマチ反応陽性
骨盤位妊娠	骨盤位	自然骨盤位分娩
左椎間孔狭窄	結合組織性椎間孔狭窄症	椎間板性椎間孔狭窄症
前立腺軽度腫大	前立腺肥大症	前立腺上皮内腫瘍
大腸憩室症	多発性大腸憩室症	小腸憩室症
右腹痛	腹痛症	下腹痛
嚥下耳痛	耳痛症	嚥下痛
原発性ヘモクロマトーシス	ヘモクロマトーシス	続発性ヘモクロマトーシス
逆行性Ｐ波	心電図異常	異常脳波
臀部圧痛	圧痛	腹部圧痛
多発皮下転移	皮下腫瘍	テント上下転移性腫瘍
副鼻腔病変	副鼻	副鼻腔異物
安静時呼吸苦	呼吸困難	夜間呼吸困難
陰嚢疼痛	陰のう痛	陰茎部疼痛
上眼瞼腫脹	眼瞼浮腫	眼瞼外傷性腫脹
右下肢複雑骨折	開放骨折	下肢多発骨折
可動性良好腫瘤	腫瘤	眼瞼良性腫瘤
両頬部発赤	発赤	咽頭発赤
感染性肝嚢胞	肝のう胞	巨大肝蛭感染症
皮下出血斑	皮下出血	下肢出血斑
右下腿骨髄炎	大腿骨骨髄炎	下腿骨骨髄炎
平行機能障害	平衡異常	知的障害・要治療の行動機能障害あり
元々杖歩行	歩行障害	痙性歩行
毎回失禁	尿失禁症	切迫性尿失禁
非医原性左尿管狭窄	尿管狭窄	先天性尿管狭窄症
下腿血腫	血腫	下腿血管腫
逆流性膀胱炎	膀胱尿管逆流	反復性膀胱炎
覚醒時疼痛	疼痛	術後疼痛
左大転子部発赤	発赤	下腿発赤
リンパ腫再発	悪性リンパ腫	リンパ腫
重度運動障害性構音障害	構音障害	運動障害性構音障害
癌性胸腹膜炎	癌性腹膜炎	癌性胸膜炎
帯状疱疹ウイルス脳炎	帯状疱疹性脳炎	ウイルス性脳炎
齲蝕	う蝕	腐蝕
腎性急性腎障害	腎障害	急性腎性腎不全
喉頭嚢胞	喉頭のう胞	喉頭蓋のう胞
左上下肢しびれ	半身しびれ	下肢しびれ
心筋傷害	心筋疾患	心筋症
胆嚢胆石	胆泥	総胆管結石性胆のう炎
縱隔リンパ節転移	縦隔リンパ節転移	鼡径部リンパ節転移
悪性細胞	癌	軟部悪性巨細胞腫
Ｌｉｓｔｅｒｉａ　ｍｏｎｏｃｙｔｏｇｅｎｅｓ敗血症	敗血症	ＭＲＣＮＳ敗血症
左下肢原発性リンパ浮腫	リンパ浮腫	上下肢リンパ浮腫
呼気時喘鳴	喘鳴	先天性喘鳴
落ち着かない	多動性障害	落ち込み
周術期喘息発作	気管支喘息発作	気管支喘息重積発作
薬剤性副腎不全	副腎皮質機能低下症	急性腎不全
乳がん	乳癌	乳頭びらん
右上顎洞真菌症	上顎洞炎	深在性皮膚真菌症
右足滑液包炎	滑液包炎	足関節滑液包炎
左大腿部痛	大腿痛	大腿内側部痛
隆起性病変	胃ポリープ症	持久性隆起性紅斑
腫瘤状構造	腫瘤	頭部腫瘤
細菌性赤痢感染症	赤痢	細菌感染症
多数骨折	骨折	重複骨折
３型進行癌	癌	進行性前立腺癌
全頭脱毛症	脱毛症	全身性脱毛症
ｆａｎ症候群	マルファン症候群	ＣＦＣ症候群
脊椎椎間板炎	椎間板炎	頚椎椎間板炎
起始異常	冠動脈起始異常	勃起不全
ふらつき感自覚	よろめき歩行	感覚異常症
腎嚢胞出血	傍腎盂のう胞	腎出血
無症候性キャリア	ＨＴＬＶ−１キャリア	ＨＥＶキャリア
中等度腹水	腹水症	異常腹水
受容体脳炎	抗ＮＭＤＡ受容体脳炎	続発性脳炎
肛門部軽度発赤	肛門部周囲炎	咽頭発赤
側方リンパ節転移	リンパ節転移	多部位リンパ節転移
肺腫瘤影	胸部異常陰影	肺腫瘤陰影
複雑型異型子宮内膜増殖症	腺腫性子宮内膜増殖症	複雑型子宮内膜異型増殖症
肝肥大	肝型糖原病	肝腫大
紅斑腫脹	紅斑症	多形滲出性紅斑
腰部圧痛	腰痛症	腰殿部痛
肺血症性ショック	敗血症性ショック	出血性ショック
凝固線溶系異常	血液凝固異常	先天性血液凝固因子異常
異所性静脈瘤	静脈瘤	静脈瘤性動脈瘤
腫瘍崩壊	腫瘍	腫瘍崩壊症候群
右腸骨ＬＮ転移	腸骨リンパ節転移	直腸癌骨転移
右腎被膜下血腫	血腫	外傷性腎被膜下血腫
脱分化型脂肪肉腫	脂肪肉腫	線維脂肪肉腫
非機能性下垂体腫瘍	下垂体腫瘍	下垂体良性腫瘍
小人症	低身長症	小児性愛
右臼蓋転移	骨盤転移	側頭部転移性腫瘍
右頭頂葉脳梗塞	脳梗塞	脳幹梗塞
右眼網膜症	網膜症	近視性網膜症
足趾壊疽	趾壊死	足壊疽
左肺尖部腺癌	肺腺癌	肺門部腺癌
紅色皮疹	発疹	紅色汗疹
頚管狭窄	子宮頚管狭窄症	卵管狭窄症
脳梗塞後後遺症	脳梗塞	脳梗塞後遺症
紅斑熱	日本紅斑熱	紅斑症
多発頭蓋骨転移	骨転移癌	転移性頭蓋骨腫瘍
Ｄａｎｌｏｓ症候群	エーラス・ダンロス症候群	ＭＥＬＡＳ症候群
運動低下性構音障害	構音障害	運動障害性構音障害
両側腸腰筋血腫	血腫	腰部血管腫
肝嚢胞感染	肝のう胞	巨大肝蛭感染症
顔面骨圧痛	圧痛	骨痛
会陰部疼痛	外陰部痛	陰茎部疼痛
咀嚼時痛	咀嚼筋痛障害	鼡径部痛
２次性副甲状腺機能亢進症	副甲状腺機能亢進症	二次性甲状腺機能亢進症
右前大脳動脈未破裂動脈瘤	前大脳動脈瘤	未破裂脳動脈瘤
リウマチ性胸水	リウマチ性肺疾患	血性胸水
右眼白内障手術	白内障	白内障術後
悪性リンハ゜腫	悪性リンパ腫	鼡径部リンパ節腫脹
右基底核梗塞	脳梗塞	再発性脳梗塞
境界型耐糖能障害	耐糖能異常	糖質不耐性吸収不良症
リウマチ疾患	関節リウマチ	リウマチ性肺疾患
ＶＨＬ病	フォンヒッペル・リンダウ病	ＨＤＬＳ
陰嚢部腫脹	陰のう腫大	胸部腫脹
高分化型腺癌	癌	甲状腺未分化癌
Ｍｙｃｏｂａｃｔｅｒｉｕｍ　ｓｈｉｇａｅｎｓｅ感染症	非結核性抗酸菌症	ＭＲＣＮＳ感染症
両側肺動脈血栓塞栓	動脈血栓症	肺動脈血栓塞栓症
臀部炎症性粉瘤	粉瘤	静脈瘤性皮膚炎
左耳耳鳴	耳鳴症	頚性耳鳴
鼠経ヘルニア	鼡径ヘルニア	腹壁ヘルニア
薬剤性腎不全	薬剤性腎障害	慢性腎不全
腫瘍増悪	腫瘍	悪性腫瘍
完全型ベーチェット病	ベーチェット病	不全型ベーチェット病
筋肉痙攣	痙攣	筋痙直
癌性髄膜腫症	悪性髄膜腫	髄膜癌腫症
化膿性脊椎椎間板炎	化膿性椎間板炎	頚椎化膿性椎間板炎
呼吸性雑音	胸部音異常	異常呼吸
両肩関節圧痛	圧痛	関節痛
多発肝細胞癌	肝腫瘍	肝細胞癌
右腎小嚢胞	傍腎盂のう胞	多房性腎のう胞
進行性食道癌	食道癌	早期食道癌
大腿骨近位部骨折	大腿骨骨折	大腿骨遠位端骨折
刺激性皮膚炎	皮膚炎	虫刺性皮膚炎
慢性緑膿菌感染	緑膿菌感染症	多剤耐性緑膿菌感染症
回腸閉塞	回腸狭窄	回腸閉鎖
尾部嚢胞	膵のう胞	類皮のう胞
虫刺症	蜂刺症	刺虫症
膵仮性嚢胞破裂	仮性膵のう胞	閉鎖性膵臓破裂
シェーンラインヘノッホ紫斑病	ＩｇＡ血管炎	高グロブリン血性紫斑病
チャーグ－ストラウス症候群	好酸球性多発血管炎性肉芽腫症	アダムス・ストークス症候群
低ＡＴⅢ血症	アンチトロンビン欠乏症	高ＩｇＤ血症
超皮質性感覚性失語	皮質下感覚性失語症	超皮質性失語
ＮＯＭＩ	腸壊死	ＭＮＧＩＥ
左踵骨裂離骨折	踵骨骨折	腓骨剥離骨折
慢性糸球体炎	糸球体腎炎	急性毛様体炎
左眼結膜下出血	結膜下出血	眼瞼結膜出血
四肢圧痛	圧痛	四肢痛
関節変形	関節奇形	股関節変形
気分変動	気分変調症	気分異常
立位バランス練習重症筋無力症	重症筋無力症	全身型重症筋無力症
左上葉小細胞肺癌	上葉小細胞肺癌	上葉非小細胞肺癌
食道カンジタ症合併ＨＩＶ感染症	ＨＩＶカンジダ病	ＨＴＬＶ−１感染症
固縮無動	こわばり	固縮性扁平足
小体認知症	認知症	レビー小体型認知症
突然腹痛	腹痛症	持続腹痛
生検部感染徴候	創傷感染症	生検後感染
右眼下鼻側視野異常	視野障害	単眼性視力障害
右肺Ｓ４原発腺癌	肺腺癌	原発性肺癌
喘息コントロール不良	咳喘息	非アトピー性喘息
腹部大動脈狭窄症	大腿動脈狭窄症	大動脈狭窄症
頚部血腫	頚部表在損傷	頭部血腫
肺雑聴取	胸部音異常	中枢性難聴
低活動型せん妄	せん妄	老人性夜間せん妄
右内頸動脈血栓閉塞	動脈血栓症	内頚動脈血栓症
ＣＮＩ腎症	薬剤性腎障害	ＮＳＡＩＤ腎症
胃液様	嘔吐症	胃液分泌過多
右鼡径部出血	出血	腟断端出血
門亢症	門脈圧亢進症	肛門疾患
創内異物	外傷性異物	腟内異物
肢痛	疼痛	上肢痛
腸管内血腫	血腫	胃血管腫
完全右脚ブロック指摘	完全右脚ブロック	完全左脚ブロック
臀部紅斑	紅斑症	環状紅斑
末節骨骨折	骨折	環指末節骨骨折
脊椎症性変化	脊椎症	変形性脊椎症
腸閉塞気味	イレウス	直腸閉鎖
浅呼吸	呼吸困難	多呼吸
痛覚消失	異常知覚	片側痛覚消失
膵炎再燃	膵炎	急性膵炎
肘頭部潰瘍	前腕皮膚潰瘍	亀頭部潰瘍
反復性腸閉塞	イレウス	先天性大腸閉鎖
胎児腹水	胎児水腫	胎児胸水
皮膚ツルゴール低下	脱水症	ムコール症
右肩悪性軟部腫瘍	悪性軟部腫瘍	肩部悪性軟部腫瘍
右中指スワンネック変形肩関節	スワンネック変形	変形性肩関節症
胸郭運動異常	胸郭異常	異常頭部運動
腹部肥満	肥満症	腹部膨満
Ｓ状結腸粘膜下腫瘤	腫瘤	Ｓ状結腸粘膜下腫瘍
本日疼痛	疼痛	急性疼痛
出血軽度	出血	多量出血
胸水排出	胸水貯留	漏出性胸水
ＡＩＤＳ非定型抗酸菌症	非結核性抗酸菌症	ＨＢｓ抗原検査陽性
尺側神経麻痺	尺骨神経麻痺	正中神経麻痺
てんかんの発作	てんかん	てんかん大発作
下痢〜水様便	下痢症	慢性下痢症
コレステロールポリープ	ポリープ	コレステロール尿症
１型糖尿除	糖尿	１型糖尿病
肺多型癌	癌	肺癌
気分不快出現	悪心	反復性気分障害
内腸骨静脈血栓症	静脈血栓症	腸骨動脈血栓症
舌根扁桃炎	扁桃炎	舌扁桃炎
右肺上葉小細胞癌	上葉小細胞肺癌	上葉非小細胞肺癌
ＣＭＶ網膜症	サイトメガロウイルス網膜炎	ＨＩＶ網膜症
脊椎側弯症	脊柱側弯症	胸椎側弯症
悪心Ｇ１	悪心	術後悪心
脊髄視神経炎	視神経炎	視神経脊髄炎
印環細胞癌	癌	環指基底細胞癌
左内頸動脈中等度狭窄	頚動脈硬化症	内頚動脈狭窄症
右鼡径部ヘルニア	鼡径ヘルニア	外鼡径ヘルニア
ＭＬＦ症候群	核間性眼筋麻痺	ＬＧＬ症候群
右手痺れ	上肢しびれ	下肢痙攣
逆流感	胃食道逆流症	動揺病
左尿管導管吻合部狭窄	吻合部狭窄	尿管回腸導管吻合部狭窄
時折不整	不整脈	調節不全
僧帽弁狭窄症兼閉鎖不全症	僧帽弁狭窄症	僧帽弁狭窄兼閉鎖不全症
伸筋腱脱臼	脱臼	総指伸筋腱脱臼
内転障害	眼球運動痙攣	過外転症候群
びまん性リンパ腫	リンパ腫	びまん性大細胞型Ｂ細胞性リンパ腫
足首骨折	足関節骨折	足背骨折
高Ｂｉｌ血症	高ビリルビン血症	高ＨＤＬ血症
右足小指骨折	小指骨折	中足骨骨折
歩行時創部痛	術創部痛	前足部痛
パニック	パニック障害	パニック発作
ＡＰＳ	抗リン脂質抗体症候群	ＡＩＤＳ
脳圧亢進症状	頭蓋内圧亢進症	急性脳症
二次性ヘモクロマトーシス	ヘモクロマトーシス	続発性ヘモクロマトーシス
潜在性副甲状腺機能低下症	副甲状腺機能低下症	特発性副甲状腺機能低下症
右内腸骨動脈狭窄	動脈狭窄	外腸骨動脈狭窄
Ⅱａ型高脂血症	高脂血症	二次性高脂血症
右手橈骨骨折	橈骨骨折	手骨骨折
右睾丸痛	精巣痛	鼡径部痛
後頭蓋下髄膜腫	髄膜腫	後頭蓋窩髄膜腫
急性前壁中隔梗塞	急性前壁中隔心筋梗塞	陳旧性前壁中隔心筋梗塞
尿道口発赤	発赤	咽頭発赤
労作時胸部不快	労作時呼吸困難	胸部不快感
Ｓａｌｍｏｎｅｌｌａ　ｅｎｔｅｒｉｔｉｄｉｓ敗血症	サルモネラ敗血症	ＭＲＣＮＳ敗血症
グル音異常	異常腸音	心音図異常
鉄吸収障害	鉄欠乏症	鉄代謝障害
本日右眼白内障	白内障	併発白内障
水疱後びらん	水疱症	皮膚びらん
胆管内結石	胆管結石症	総胆管結石
処置後膵炎	膵炎	術後膵炎
両側性末梢性顔面神経麻痺	末梢性顔面神経麻痺	特発性末梢性顔面神経麻痺
息苦しく	呼吸困難	口苦
無菌性腸炎	非感染性腸炎	細菌性腸炎
骨盤内リンパ嚢腫	骨盤部感染性リンパのう胞	骨盤内リンパ節の悪性腫瘍
平坦Ｔ波	心電図異常	異常脳波
ペーシング不全	両室ペーシング機能付き植込型除細動器不全	ペースメーカ不全
ふらつきあり	めまい	こわばり感
右鼡径ヘルニア	鼡径ヘルニア	外鼡径ヘルニア
職業性ストレス	急性ストレス反応	重度ストレス反応
卵管水腫	卵管留水症	卵管筋腫
左下葉原発性肺扁平上皮癌	肺扁平上皮癌	下葉肺扁平上皮癌
外陰部血腫	外陰血腫	会陰部血腫
左乳突蜂巣炎	乳様突起炎	頚部蜂巣炎
未破裂左内頸動脈瘤	内頚動脈瘤	未破裂脳動脈瘤
中咽頭側壁扁平上皮癌	癌	中咽頭側壁癌
両肺多発結節性陰影	胸部異常陰影	肺部異常陰影
脾臓腫瘤	腫瘤	腎腫瘤
腫瘍感染合併	腫瘍	混合腫瘍
ＩＰ合併	間質性肺炎	ＡＩＤＳ
ゾメタ骨髄炎	骨髄炎	細菌性骨髄炎
右胸膜原発血管肉腫	血管肉腫	胸壁血管肉腫
拘縮気味	筋拘縮症	下肢拘縮
手関節圧痛	圧痛	手関節痛
浮腫残存	浮腫	全身性浮腫
非てんかん性心因性発作	てんかん	アトニー性非特異性てんかん発作
下腸間膜動脈閉塞	腸間膜動脈塞栓症	急性上腸間膜動脈閉塞症
右中大脳動脈領域梗塞	中大脳動脈閉塞症	脳外主幹動脈閉塞脳梗塞
消化管腫瘤	腫瘤	食道腫瘤
脛骨前面圧痕性浮腫	浮腫	上腕浮腫
多少眠気	非器質性過眠症	不眠症
高濃度腫瘤	腫瘤	皮膚腫瘤
ＤＧＥ症状	消化管術後後遺症	高ＩｇＥ症候群
過形成性ポリープ	胃過形成ポリープ	若年性ポリープ
日光アレルギー	光線過敏症	アレルギー
慢性炎症性腸疾患	腸炎	炎症性腸疾患
尺骨頭脱臼	脱臼	橈骨頭脱臼
けいれん症状	痙攣	痙性めまい
右下肢感覚鈍麻	感覚異常症	片側感覚鈍麻
慢性進行性肺アスペルギルス症	肺アスペルギルス症	侵襲性肺アスペルギルス症
手指皮疹	発疹	手指湿疹
廃用	廃用症候群	廃用性弱視
浮動感	めまい	栄養失調性浮腫
右膝蜂窩織炎	膝部蜂巣炎	蜂窩織炎
強制換気	人工呼吸器装着状態	換気量減少
左下肢ガス壊疽	ガス壊疽	下肢壊疽
喚語障害	不全失語症	発語障害
多動多弁	多動性障害	異所性拍動
右手背浮腫	限局性浮腫	足部浮腫
足趾しびれ	下肢しびれ	四肢しびれ
突然意識障害	意識障害	急性意識障害
足底痺れ	しびれ感	足切創
食思不振症状	食欲不振	神経性食欲不振症
細菌性食道炎	食道炎	感染性食道炎
転移性腫瘤	転移性腫瘍	転移性縦隔腫瘍
夜間尿意	夜間頻尿症	夜尿症
神経性疼痛	神経痛	神経障害性疼痛
房室接合部調律	異所性調律	接合部調律
眼瞼下垂自覚	眼瞼下垂症	先天性眼瞼下垂
左尾状核ラクナ硬塞	ラクナ梗塞	初期う蝕小窩裂溝填塞材脱離
ＳＭＡ閉塞	急性上腸間膜動脈閉塞症	ＡＶＭ
めまいの発作	めまい	めまい発作
呼吸切迫	急性呼吸窮迫症候群	呼吸促迫
劇症型連鎖球菌感染症	連鎖球菌感染症	劇症型Ａ群連鎖球菌感染症
腹部疝痛	仙痛	側腹部痛
胆嚢多発ポリープ	胆のうポリープ	多発性胆のうポリープ
柑皮症	カロチン血症	皮膚萎縮症
陰部掻痒	外陰部そう痒症	そう痒
両側眼球外転障害	眼球運動障害	先天性眼球運動障害
夜間失禁	尿失禁症	夜間頻尿症
褥瘡発生リスク低い	褥瘡	褥瘡・ＤＴＩ
Ⅱ度熱傷	熱傷	多発性第２度熱傷
重度感覚障害	体感異常	感覚異常症
婦人入院脳梗塞	脳梗塞	急性右室梗塞
炎症性ポリープ多発	ポリープ	炎症性ミオパチー
右坐骨結節転移再発	転移性腫瘍	鎖骨上転移性腫瘍
右上肢痺れ	しびれ感	上肢両側麻痺
ＭＣＴＤ	混合性結合組織病	ＨＤＬＳ
昨日水様便	下痢症	便異常
気分不快増強	悪心	気分異常
拡張期高血圧	高血圧症	収縮期高血圧症
左頸部リンパ節腫大	薬剤性自己免疫性溶血性貧血	リンパ節腫大
右低音部感音難聴	感音難聴	両側性感音難聴
ＰＨＴ	肺高血圧症	ＨＤＬＳ
夜間失見当	見当識障害	夜驚症
劇症型髄膜炎菌感染症	髄膜炎菌感染症	侵襲性髄膜炎菌感染症
物忘れ気	健忘症	気逆
両眼白内障手	白内障	併発白内障
右手関節滑膜炎	滑膜炎	膝関節滑膜炎
声門上喉頭癌	喉頭癌	声門上癌
右膝メルケル細胞癌	メルケル細胞癌	膝部メルケル細胞癌
加害妄想	妄想反応	被害妄想
嚢胞性胸腺腫	胸腺腫	被包型胸腺腫
急性乳突洞炎	急性中耳炎	急性乳様突起炎
左肺下葉腫瘤影	肺腫瘤	肺腫瘤陰影
左感音性難聴	感音難聴	両側性感音難聴
ＣＯＰＤＩ期	慢性閉塞性肺疾患	ＣＡＤＡＳＩＬ
転倒歴多数	よろめき歩行	左旋転位
ＤＩＨＳ	薬疹	ＨＤＬＳ
インスリン依存性糖尿病	１型糖尿病	インスリン抵抗性糖尿病
頸部椎間板ヘルニア	頚椎椎間板ヘルニア	椎間板ヘルニア
拍動性疼痛	疼痛	急性疼痛
ＤＭ性腎不全	糖尿病性腎不全	急性腎不全
膝関節軽度屈曲拘縮	屈曲拘縮	膝関節屈曲拘縮
ＡＴＬ	成人Ｔ細胞白血病リンパ腫	ＨＤＬＳ
肺動脈弁閉鎖不全	肺動脈弁閉鎖	肺動脈弁閉鎖不全症
熱感軽度	ほてり	温度感覚異常
術後肝転移	転移性肝癌	転移性肝腫瘍
顔皮疹	発疹	顔面真菌性湿疹
再出血徴候	出血	出血傾向
アシネトバクター敗血症	敗血症	ＭＲＳＡ敗血症
左腎盂腎炎治癒後	腎盂腎炎	術後腎盂腎炎
二次性水頭症	外傷後水頭症	先天性水頭症
ダグラス窩播種	腹膜播種	播種性ムコール症
中耳炎症状	中耳炎	外傷性中耳炎
動揺性めまい	めまい	回転性めまい
褥瘡発生歴	褥瘡	背部褥瘡
水分摂取困難	嚥下障害	水分欠乏症
右下葉原発低分化腺癌	癌	甲状腺未分化癌
細菌性扁桃炎	扁桃炎	急性扁桃炎
正常圧緑内障	緑内障	絶対緑内障
副睾丸炎	精巣炎	腟炎
慢性アレルギー性鼻炎	季節性アレルギー性鼻炎	アレルギー性鼻炎
夕食前低血糖	低血糖	夜間低血糖症
先天性代謝異常症	代謝障害	先天性糖代謝異常
単頸双角子宮	双角子宮	単頚双角子宮
原発性肺高血圧症	肺高血圧症	二次性肺高血圧症
左鎖骨リンパ節転移	リンパ節転移	鎖骨上リンパ節転移
殿部色素沈着	色素異常症	皮膚色素沈着
舌浮腫	浮腫	喉頭浮腫
舌損傷	損傷	舌咽神経損傷
軽度痺れ	しびれ感	全身痙攣
星芒状血管腫	血管腫	陰茎海綿状血管腫
右房内腫瘤	腫瘤	胸腔内腫瘤
Ｓ状結腸転移	転移性消化器腫瘍	転移性直腸腫瘍
肉芽腫性腸疾患	腸疾患	大腸肉腫
両足圧痕性浮腫	浮腫	足部浮腫
発作後精神病	精神病	精神運動発作
虫垂粘液嚢胞腺腫	虫垂粘液のう胞	卵巣粘液性腺腫
若年性リウマチ	関節リウマチ	若年性関節リウマチ
体陽性脳炎	脳炎	慢性脳炎
境界域ＤＭ	糖尿病	ＡＶＭ
劇症敗血症	敗血症	ＧＢＳ敗血症
慢性血腫	血腫	多発性血腫
骨破壊病変	関節リウマチ	人工骨頭破損
口腔内発赤腫脹	発赤	口腔外傷性腫脹
中咽頭再発腫瘍	咽頭腫瘍	中咽頭良性腫瘍
リンパ管症	癌性リンパ管症	リンパ管腫症
遷延性抑うつ状態	うつ状態	遷延性抑うつ反応
結核性強膜炎	結核性胸膜炎	結核性硬膜炎
下腿筋萎縮	筋萎縮症	下肢筋萎縮
膵頭癌	癌	膵頭部癌
ＶＡＨＳ	ウイルス関連血球貪食症候群	ＨＤＬＳ
痰中等量引ける	喀痰	過剰喀痰
放射線障害	放射線宿酔	放射線性肺線維症
浅眠	不眠症	過眠
脳溢血	脳卒中	脳出血
背部筋緊張高い	筋強直	神経性緊張
全身紅斑	紅斑症	遊走性紅斑
右側下顎骨体部骨折	下顎骨骨折	上下顎骨骨折
微小多発脳梗塞	多発性脳梗塞	多発性小脳梗塞
糸球体血尿	血尿	糸球体性血尿
パニック様症状	全般性不安障害	パニック障害
爪囲紅斑	爪囲炎	環状紅斑
子宮頸癌Ｉｂ１期	子宮頚癌	子宮頚部微小浸潤癌
両側鎖骨上窩リンパ節腫大	リンパ節腫大	鎖骨上リンパ節腫脹
関節滑膜炎	滑膜炎	膝関節滑膜炎
立位保持困難	四肢筋力低下	不全足位
左足痺れ	しびれ感	四肢麻痺
Ｒｉｅｄｅｌ甲状腺炎	線維性甲状腺腫	急性甲状腺炎
鼻腔化膿性肉芽腫	細菌性肉芽腫症	化膿性口腔粘膜肉芽腫
右脛骨内果骨折	足関節内果骨折	脛骨骨折
左胸膜転移	胸膜播種	転移性胸膜腫瘍
右肺中葉転移	転移性肺癌	転移性肺腫瘍
下腿筋痛	下肢筋肉痛	下腿痛
右大腰筋血腫	血腫	腰部血管腫
十二指腸潰瘍再発	慢性十二指腸潰瘍	再発性十二指腸潰瘍
Ａｆ不変	心室細動	ＡＩＤＳ
左下腿部帯状疱疹	帯状疱疹	胸部帯状疱疹
外陰部湿疹	湿疹	外陰部帯状疱疹
左肘頭開放骨折	開放骨折	尺骨肘頭開放骨折
若干硬結	硬結	初期硬結
左骨盤内リンパ嚢胞	骨盤部感染性リンパのう胞	骨盤内リンパ節の悪性腫瘍
身体損傷	損傷	頭部損傷
右大腿骨骨腫瘍	大腿骨腫瘍	大腿骨遠位部骨腫瘍
慢性胆嚢炎	慢性胆のう炎	慢性胆管炎
偽性高Ｋ血症	高カリウム血症	高ＴＳＨ血症
反応性胸水	胸水貯留	血性胸水
元々痛み	疼痛	持続痛
肝形質細胞腫	形質細胞腫	肝硬化性血管腫
躁病相	躁状態	軽躁病
ジューリング疱疹状皮膚炎	ジューリング病	ウイルス性皮膚炎
副腎偶発腫	良性副腎皮質腫瘍	副腎腺腫
右下腿紅斑	紅斑症	麻疹様紅斑
腸管通過障害	消化管狭窄	直腸障害
努力様呼吸	起坐呼吸	努力性呼吸
発赤皮疹	発疹	赤色湿疹
赤痢アメーバ大腸炎	アメーバ赤痢	アメーバ性非赤痢性大腸炎
低ＡＬＢ血症	低アルブミン血症	高ＬＤＬ血症
関節痛症状	関節痛	肩関節痛症
肝膿瘍破裂	肝膿瘍	肝周囲膿瘍
総肺静脈還流異常症	肺静脈還流異常症	総肺静脈還流異常
左橈骨頭脱臼骨折	脱臼骨折	中足骨脱臼骨折
正中創感染	創傷感染症	刺創感染
左網膜分枝動脈閉塞症	動脈閉塞症	網膜動脈分枝閉塞症
低血圧自覚症状	低血圧症	非特異性低血圧症
常時痛み	疼痛	鈍痛
多発肝転移増大	転移性肝癌	転移性肝腫瘍
胆嚢十二指腸瘻	胆のう十二指腸瘻	総胆管十二指腸瘻
左鼠径部疼痛	鼡径部痛	急性疼痛
円盤状皮疹	円板状エリテマトーデス	ＬＥ蝶形皮疹
左手首疼痛	手部痛	頚部痛
アレルギー反応	アレルギー	薬物性光アレルギー性反応
膵体部小嚢胞	腫瘍性膵のう胞	膵漿液性のう胞腺腫
耳介脂漏性湿疹少	脂漏性皮膚炎	耳介周囲湿疹
両側急性硬膜下出血	急性硬膜下血腫	開放性外傷性くも膜下出血
喉頭蓋腫脹	喉頭蓋炎	頭蓋咽頭腫
深部感覚鈍麻	感覚異常症	片側感覚鈍麻
脊柱圧痛	圧痛	脊髄痛
嘔吐持続	嘔吐症	習慣性嘔吐
痙攣重積後脳症	痙攣重積型二相性急性脳症	痙攣重積型急性脳症
転移性膵体部癌	膵体部癌	膵臓癌骨転移
インフルエンザＡ型感染症	インフルエンザＡ型	インフルエンザ菌感染症
顕微鏡的大腸炎	大腸炎	急性大腸炎
直腸Ｒａ癌	直腸癌	ＫＲＡＳ遺伝子野生型直腸癌
足趾爪混濁肥厚	ころもじらみ寄生症	爪甲肥厚
ＣＭＶ肺炎	サイトメガロウイルス肺炎	ＭＲＣＮＳ肺炎
右ＩＣＡ狭窄	内頚動脈狭窄症	小脳動脈狭窄
痰貯留	喀痰	過剰喀痰
足趾蜂窩織炎	足蜂巣炎	蜂窩織炎
僧帽弁狭窄兼逆流症	僧帽弁狭窄症	僧帽弁逆流症
歯槽膿漏	歯周炎	歯槽膿瘍
左肘関節破壊	関節リウマチ・肘関節	人工肘関節の破損
皮下石灰化	皮膚石灰沈着症	背部石灰化上皮腫
軽度ＡＤＨＤ	注意欠陥多動障害	ＡＤＨ異常
両心房拡大	心肥大	巨大左心房
上転障害	眼球運動障害	外転足
嫌悪感	悪寒	悪心
二次性僧帽弁閉鎖不全症	僧帽弁閉鎖不全症	先天性僧帽弁閉鎖不全症
腹痛嘔気	嘔気	周期性腹痛
左大腿部骨外性粘液型軟骨肉腫	軟骨肉腫	大腿骨軟骨肉腫
高度異形成相当	子宮頚部高度異形成	腟上皮異形成・異型度２
腹緊なし	腹部膨満	腹皮拘急
右頚部ＬＮ腫大	リンパ節腫大	縦隔リンパ節腫脹
哺乳後嘔吐	嘔吐症	妊娠後期嘔吐
Ｃｒｏｎｋｈｉｔｅ−Ｃａｎａｄａ症候群	クロンカイト・カナダ症候群	ＳＡＰＨＯ症候群
右中大脳動脈梗塞	内頚動脈塞栓症	脳外主幹動脈閉塞脳梗塞
脾臓結核	結核	腎結核
高浸透圧血症	高血糖高浸透圧症候群	低浸透圧血症
陰嚢ヘルニア	陰のうヘルニア	陰唇ヘルニア
多形紅斑型薬疹	薬疹	紅皮症型薬疹
静脈内腫瘍栓	腫瘍	頚静脈小体腫瘍
進行再発大腸癌	大腸癌	遺伝性大腸癌
胃接合部癌	胃癌	食道胃接合部癌
手足しびれ	しびれ感	手指先しびれ
内膜損傷	損傷	硬膜損傷
咽頭知覚障害	咽頭異常感症	咽喉頭知覚麻痺
腸液貯留	体液貯留	後腹膜尿貯留
急性胆嚢胆管炎	胆管炎	原発性胆汁性胆管炎
扁平上皮癌	癌	肺扁平上皮癌
内痔核脱出	内痔核	脱出性内痔核
重症鬱血性心不全	うっ血性心不全	高血圧性心不全
Ａ型溶連菌感染症	溶連菌感染症	Ｂ群溶連菌感染症
悪性副腎外褐色細胞腫	褐色細胞腫	良性副腎皮質腫瘍
傍隔壁型肺気腫	肺気腫	一側性肺気腫
角膜糜爛	角膜びらん	角膜瘢痕
骨盤内播種新生	骨盤転移	多発性骨盤内臓器損傷・骨盤腔に達する開放創合併あり
急性非代償性心不全	心不全	急性心不全
最近便秘	便秘症	習慣性便秘
１型高ウイルスＣ型慢性肝炎	Ｃ型慢性肝炎	急性ウイルス性肝炎
Ｌｉｓｔｅｒｉａ腸炎	細菌性腸炎	ＭＲＳＡ腸炎
ヒリヒリ感	疼痛	ピリピリ感
大動脈弁下心室中隔欠損	心室中隔欠損症	心室中隔欠損を伴う肺動脈閉鎖症
右傍矢状静脈洞髄膜腫	髄膜腫	傍矢状洞髄膜腫
無自覚性低血糖	低血糖	低血糖性脳症
心尖部型肥大型心筋症	肥大型心筋症	心尖部肥大型心筋症
腎不全保存期	腎不全	末期腎不全
口腔内炎	口内炎	口腔粘膜炎
びまん性大細胞	びまん性大細胞型Ｂ細胞性リンパ腫	びまん性大細胞型・バーキット中間型分類不能Ｂ細胞性リンパ腫
大うつ病	単極性うつ病	うつ病
肝門部悪性リンパ腫	肝門部リンパ節転移	悪性リンパ腫
精神病性うつ病	うつ病	反復性精神病性うつ病
水疱性類天疱	水疱症	水疱性類天疱瘡
中枢性低換気	換気量減少	肺胞低換気症候群
右膝ＡＣＬ損傷	前十字靱帯損傷	ＴＦＣＣ損傷
混合難聴	難聴	混合性難聴
先天性巨大色素性母斑	巨大母斑細胞母斑	色素性母斑
不安大	不安障害	不安緊張状態
胸骨下液体貯留	体液貯留	胸水貯留
左聴器癌	癌	声門癌
上腹部リンパ節転移	リンパ節転移	多部位リンパ節転移
被殻梗塞	被殻出血	甲状腺梗塞
直腸Ｒａｂ癌	直腸癌	ＫＲＡＳ遺伝子野生型直腸癌
本日硬便少量	便異常	大量便
リンパ節圧痛	圧痛	リンパ節炎
小血栓	血液凝固異常	血栓性微小血管症
右耳失聴	聴覚消失	両側性感音難聴
急性期ＨＩＶ感染症	ＨＩＶ感染症	急性ＨＩＶ感染症候群
上行結腸腫瘤	腫瘤	腸間膜腫瘤
疾病不安	不安障害	疾病恐怖症
色素脱失	炎症後色素脱失	脱色素性色素失調症
膿貯留	膿瘍	膿尿
リンパ節腫脹	リンパ節腫大	縦隔リンパ節腫脹
右椎骨動脈巨大血栓化動脈瘤	椎骨動脈瘤	静脈瘤性動脈瘤
安心感	心気症	不安緊張状態
左鼡径ヘルニア再発	鼡径ヘルニア	再発性鼡径ヘルニア
左足背蜂窩織炎	足背蜂巣炎	蜂窩織炎
暗青色斑	青色母斑	黄斑部白斑
ＨＣＶ陽性	Ｃ型肝炎ウイルス感染	ＨＣＶ抗体検査陽性
感染性静脈血栓症	静脈血栓症	深部静脈血栓症
過敏性膀胱炎	膀胱炎	急性膀胱炎
包交時出血	出血	局所出血
進行肺癌	肺癌	胃進行癌
外傷性変化	外傷	化学外傷
中等度精神遅滞	中等度知的障害	自閉性精神発達遅滞
リポフスチン沈着	神経セロイドリポフスチン症	ヘモジデリン沈着症
中等度ＣＯＰＤ	慢性閉塞性肺疾患	ＡＩＤＳ
胸部圧痛	圧痛	腹部圧痛
気分不快症状	悪心	反復性気分障害
乳突蜂巣	乳様突起炎	精巣破裂
褥創形成	褥瘡	腟開放創
ガマ腫	がま腫	ゴム腫
夜間せん妄状態	せん妄	夜間せん妄
神経系腫瘍	腫瘍	神経細胞腫瘍
先天性側弯	肋骨異常を伴う先天性側弯症	先天性腟異常
非定型抗酸菌肺炎	肺炎	非定型肺炎
軽度甲状腺腫大	甲状腺腫	副甲状腺多発性腺腫
手足痺れ	四肢しびれ	手足症候群
節外性濾胞辺縁帯リンパ腫	脾辺縁帯リンパ腫	節性辺縁帯リンパ腫
Ｋｌｅｂｓｉｅｌｌａ　ｐｎｅｕｍｏｎｉａｅ敗血症	新生児クレブシエラ敗血症	ＭＲＣＮＳ敗血症
若年性認知症	認知症	二次性認知症
外腸骨域リンパ節腫大	リンパ節腫大	大腸ＭＡＬＴリンパ腫
分化型管状腺癌	癌	甲状腺未分化癌
孤発性ＣＪＤ	孤発性クロイツフェルト・ヤコブ病	ＨＤＬＳ
右下葉結節影	胸部異常陰影	下肺野陰影
食道がん	食道癌	食道びらん
肛門部発赤	発赤	咽頭発赤
成人Ｓｔｉｌｌ病	成人スチル病	ＨＤＬＳ
下咽頭がん	下咽頭癌	咽頭のう
両上肢痺れ	上肢しびれ	上肢両側麻痺
混合性肝癌	肝癌	混合型肝癌
甲状腺痛	甲状腺炎	前立腺痛
不消化便	消化不良性下痢	小便不利
末梢性めまい	めまい症	末梢性めまい症
四肢型運動失調	運動失調	四肢運動障害
産生胃癌	胃癌	胃管癌
左脛腓骨骨折	腓骨骨折	脛骨腓骨骨折
先天性脳血管異常	脳動静脈奇形	脳血管障害
臀部皮疹	発疹	全身発疹
歩行時軽度跛行	跛行	歩行異常
心室中隔扁平化	心室中隔欠損症	室上稜下部心室中隔欠損
フルニエ壊疽	外陰部壊死性筋膜炎	ガス壊疽
歯牙損傷	切歯破折	歯肉外傷
両側乳糜胸水	胸水貯留	乳び性腹水
麻疹罹患歴	麻疹	亜急性痒疹
尿漏れ	尿失禁症	尿道漏
心膜播種	腹膜播種	胸膜播種
髄液播種	腹膜播種	脊髄播種
後頭部皮下血腫	頭部皮下血腫	側頭部皮下血腫
篩骨蜂巣	篩骨洞炎	篩骨洞のう胞
仮性動脈瘤切除	偽性動脈瘤	解離性動脈瘤
鼻中隔血腫	血腫	鼻部皮下血腫
左嗅裂ポリープ	ポリープ	嗅覚脱失
軽度失調性構音障害	構音障害	発達性構音障害
びらんからの出血	出血	後出血
動揺性精神神経症状	神経症	精神運動興奮状態
過呼吸気味	過換気症	頻呼吸
真菌性感染性心内膜炎	細菌性心内膜炎	亜急性感染性心内膜炎
未分類関節炎	関節炎	増殖性関節炎
神経症性うつ病	抑うつ神経症	反復性精神病性うつ病
右浸潤影	胸部異常陰影	下肺野陰影
四肢近位筋筋力低下	筋力低下	四肢筋力低下
右乳腺良性腫瘍	乳腺腫瘍	乳房良性腫瘍
イレウス気味	偽性イレウス	イレウス
前立腺癌死	前立腺癌	前立腺癌再発
再度皮疹	発疹	風疹様発疹
低形成	骨髄低形成	右室低形成
血管原性浮腫	浮腫	血管神経性浮腫
Ｂｌｕｅ　ｔｏｅ　ｓｙｎｄｒｏｍｅ	末梢動脈疾患	Ｅｕｔｈｙｒｏｉｄ　Ｓｉｃｋ症候群
嚢胞様腫瘤像	腫瘤	卵巣腫瘤
婦人科癌	癌	女性性器癌
両側眼振	眼振	先天性眼振
過活動型せん妄	せん妄	夜間せん妄
左下肢鬱滞性皮膚炎	うっ滞性皮膚炎	だに皮膚炎
ＢＰＳＤ	認知症に重なったせん妄	ＡＩＤＳ
汎発性水痘感染症	水痘	細菌感染症
えん下障害	嚥下障害	症候性てんかん
左側頭葉挫傷	脳挫傷	前頭部挫傷
虚血性肝炎	肝炎	虚血性腸炎
幽門前部狭窄	幽門狭窄症	術後幽門狭窄
圧迫移植部ネクローシス	壊死	スケレトンタイプ拡大装置破損
舌乾燥	口腔乾燥症	口内乾燥
円形紅斑	紅斑症	多形紅斑
左眼後発性白内障	白内障	先天性白内障
膵尾部腫瘤性病変	膵腫瘤	膵頭部腫瘤
重症腸炎	腸炎	急性腸炎
左大腿骨転子下骨折	転子下骨折	大腿骨転子部骨折
肺野すりガラス状陰影	肺野異常陰影	肺野円形陰影
アテローム性血栓性脳梗塞	血栓性脳梗塞	アテローム血栓性脳梗塞
診察時皮疹	発疹	風疹
術後不整脈	不整脈	術中不整脈
起床時咳嗽	咳	慢性咳嗽
血性腹水貯留	腹水症	血性腹水
カンジダ肺炎	肺カンジダ症	カンジダ性口内炎
右小細胞癌	小細胞肺癌	前立腺小細胞癌
頬部悪性腫瘍	頬部腫瘍	頬部皮膚良性腫瘍
多源性ＰＶＣ散発	心室期外収縮	急性大動脈解離ＤｅＢａｋｅｙＩＩＩｂ
原発性甲状腺機能低下	甲状腺機能低下症	原発性甲状腺機能低下症
ヨードアレルギー	ヨード過敏症	アレルギー
右ＩＣ動脈瘤	内頚動脈脳動脈瘤	大動脈瘤
活動性肝炎	肝炎	活動性慢性肝炎
排便なし	便秘症	排便障害
全身性Ｃａｎｄｉｄａ感染症	カンジダ症	ＭＲＣＮＳ感染症
顔面神経痛	三叉神経痛	顔面痛
疣贅様構造物	疣贅	尋常性疣贅
アルコ−ル性肝硬変	肝硬変症	アルコール性肝硬変
皮質層状壊死	壊死	皮膚壊死
発熱随伴症状	発熱	心因性発熱
脳炎脳症	脳症	脳炎
辺縁性脳炎	脳炎	辺縁系脳炎
家族性ＣＪＤ	家族性クロイツフェルト・ヤコブ病	家族性ＬＣＡＴ欠損症
圧迫時疼痛	疼痛	急性疼痛
症型Ａ群溶連菌感染症	溶連菌感染症	Ｂ群溶連菌感染症
末梢肺動脈塞栓症	動脈塞栓症	末梢動脈塞栓症
歩容困難	歩行障害	歩行困難
脳室出血	出血	脳室内出血
顔面痺れ	しびれ感	顔面痙攣
重度失調性構音障害	構音障害	機能性構音障害
卵巣癌Ⅲｃ期	卵巣癌	卵巣小細胞癌
発赤潰瘍	発赤	扁桃潰瘍
左下肺浸潤影	肺部異常陰影	下肺野陰影
右大脳動脈未破裂動脈瘤	脳動脈瘤	未破裂脳動脈瘤
失語正常	失語症	全失語症
先週頭痛	頭痛	群発頭痛
ｃｅｌｌ　ｌｅｕｋｅｍｉａ	白血病	Ｅｕｔｈｙｒｏｉｄ　Ｓｉｃｋ症候群
ＧＣＡ	巨細胞動脈炎	ＨＣＡＨＣ
大動脈弁硬化症	大動脈弁狭窄症	大動脈弁閉鎖症
呼気喘鳴	喘鳴	努力性呼吸
ＡＣＴＨ非依存性Ｃｕｓｈｉｎｇ症候群	クッシング症候群	ＣＨＩＬＤ症候群
熱	発熱	微熱
Ｍａｌｌｏｒｙ−Ｗｅｉｓｓ症候群	マロリ・ワイス症候群	ＭＥＬＡＳ症候群
副鼻腔転移	副鼻腔癌	転移性副鼻腔癌
原発不明癌頸部転移	原発不明癌	多発性癌転移
再発腫瘤	腫瘤	多発性皮下腫瘤
犬吠様咳嗽	咳	感染後咳嗽
両下肢筋痛	下肢筋肉痛	下肢痛
左室ブロック波形	心電図異常	術後房室ブロック
有痛性腫瘤	腫瘤	頚部腫瘤
起床時頭痛	頭痛	睡眠時頭痛
眼白内障	白内障	層間白内障
慢性下気道感染	急性気管支炎	下気道感染を伴う慢性閉塞性肺疾患
乳頭様腎盂腫瘍	腎盂乳頭状癌	腎盂腫瘍
ＳＣＤ	脊髄小脳変性症	ＡＩＤＳ
無症候性腸アメーバ症	腸アメーバ症	慢性腸アメーバ症
手首痛	手部痛	手関節痛
左顔面神経麻痺症状	顔面神経麻痺	中枢性顔面神経麻痺
左顔面痛覚障害	片側痛覚鈍麻	顔面神経障害
元々疼痛	疼痛	急性疼痛
粘膿性鼻汁	鼻汁	粘液性鼻漏
膣原発横紋筋肉腫	横紋筋肉腫	鼡径部横紋筋肉腫
卵巣嚢腫ＯＰ	卵巣のう腫	卵巣門細胞腫
肺血管陰影増強	肺血管疾患	肺門部異常陰影
腎機能障害	腎機能低下	腎障害
Ｈｏｄｇｋｉｎ　Ｌｙｍｐｈｏｍａ	ホジキンリンパ腫	ＨＤＬＳ
術後創感染	術後膿瘍	術後創部感染
咳嗽法	咳	慢性咳嗽
高リスク前立腺癌	前立腺癌	進行性前立腺癌
膿梗塞	脳梗塞	全膿胸
下大静脈狭窄	大静脈狭窄症	先天性下大静脈狭窄症
入眠困難感	不眠症	レム睡眠行動障害
非定型カルチノイド腫瘍	カルチノイド	異所性ＡＣＴＨ産生腫瘍
軽度食欲低下	食欲不振	神経性食欲異常
両下腿壊疽性膿皮症様潰瘍	膿皮症	潰瘍性慢性膿皮症
恥骨骨髄炎	骨髄炎	恥骨骨炎
かすみ目	視力低下	くしゃみ
眩暈消失	めまい	起立性眩暈
手指関節腫脹	関節炎	足関節腫脹
ＳＰＮ	充実性偽乳頭状腫瘍	ＨＤＬＳ
低酸素虚血性脳症	低酸素性脳症	新生児低酸素性虚血性脳症
膵臓癌術後再発	膵癌	悪性膵内分泌腫瘍
歩行ふらつき	めまい	よろめき歩行
紅色腫瘤	腫瘤	皮膚腫瘤
気管支閉鎖症	気管支閉鎖	気管閉鎖症
咽頭粘膜発赤	発赤	咽頭発赤
新生児死亡	原因不明の死亡	新生児仮死
食道空腸吻合部狭窄	吻合部狭窄	尿管回腸導管吻合部狭窄
腎結石多発	腎結石症	多発性腎結石
Ｉｓｐポリープ	大腸ポリープ	ポリープ
咽頭部発赤	発赤	咽頭発赤
遅発性発疹	発疹	特発性発疹
肺炎悪化	肺炎	急性肺炎
骨外腫瘤形成	腫瘤	骨腫瘤
低悪性度Ｂ細胞性リンパ腫	びまん性大細胞型Ｂ細胞性リンパ腫	ＡＬＫ陽性大細胞型Ｂ細胞性リンパ腫
単形性ＶＴ	非持続性心室頻拍	非特異的ＳＴ−Ｔ変化
白色調腫瘍	腫瘍	皮膚腫瘍
Ｇｏｔｔｒｏｎ徴候	ゴットロン丘疹	Ｅｕｔｈｙｒｏｉｄ　Ｓｉｃｋ症候群
脊柱起立筋膿瘍	筋膿瘍	脊髄硬膜外膿瘍
胃癌幽門狭窄	幽門狭窄症	胃幽門部癌
拡張能障害	心不全	器質性緊張病性障害
小腸静脈瘤破裂	食道静脈瘤破裂	胃静脈瘤破裂
中枢性甲状腺機能低下症	甲状腺機能低下症	二次性甲状腺機能低下症
左肺動脈閉塞	肺動脈狭窄症	純型肺動脈閉鎖
単純性網膜症	網膜症	増殖性網膜症
Ｈｅｎｏｃｈ−Ｓｃｈｏｎｌｅｉｎ紫斑病	ＩｇＡ血管炎	Ｅｕｔｈｙｒｏｉｄ　Ｓｉｃｋ症候群
右胸腔内腫瘍	腫瘍	胸膜腫瘍
尿もれ	尿失禁症	尿溢出
下肢筋力低下自覚	筋力低下	上肢筋力低下
右足静脈瘤	静脈瘤	下肢静脈瘤
上気道浮腫	咽頭浮腫	陰のう浮腫
Ｃａｐｎｏｃｙｔｏｐｈａｇａ　ｃａｎｉｍｏｒｓｕｓ感染症	グラム陰性菌感染症	ＭＲＣＮＳ感染症
呼吸喘鳴	喘鳴	口呼吸
ヘルペス髄膜炎	髄膜炎	ヘルペスウイルス髄膜炎
左股関節破壊	股関節症	股関節損傷
膠原繊維性腸炎	腸炎	細菌性腸炎
食道期軽度障害	嚥下障害	食道障害
右外腸骨静脈狭窄	静脈狭窄	外腸骨動脈狭窄
呼内疾患ベース肺炎	肺炎	急性肺炎
白色粘性痰	喀痰	膿性痰
食道癌２病変	食道癌	食道小細胞癌
ｌｙｍｐｈｏｍａ	悪性リンパ腫	ＨＤＬＳ
左足首骨折	足関節骨折	足背骨折
子宮筋腫大	子宮筋腫	巨大子宮筋腫
抑うつあり	うつ状態	気うつ
出血腫脹	出血	血腫
急性感音性難聴	感音難聴	両側性感音難聴
リンパ節多発転移	多部位リンパ節転移	リンパ節転移
ｉｎｖａｓｉｖｅ　ｔｈｙｍｏｍａ	悪性胸腺腫	ＣＡＤＡＳＩＬ
分類不能型免疫不全	免疫不全	分類不能免疫不全症
非典型的胸痛	胸痛	反復性胸痛
棘波	心電図異常	棘刺創
黄色痰自己喀出	膿性痰	喀痰喀出困難
心膜腔内播種	転移性心腫瘍	胸膜播種
四肢末端しびれ	しびれ感	四肢端しびれ
胃部分壊死	壊死	腸壊死
転倒受傷	外傷	卒倒
左急性感音難聴	感音難聴	両側性感音難聴
タール便少量	黒色便	大量便
切除不能胃癌	胃癌	胃癌末期
後頭葉脳出血	脳出血	小脳出血
隅角結節	虹彩結節	隅角癒着
落ち着かなさ	多動性障害	落ち込み
脊椎多発圧迫骨折	圧迫骨折	胸椎多発圧迫骨折
左傍脊柱筋膿瘍	筋膿瘍	脊髄硬膜外膿瘍
Ⅰ型ＤＭ	糖尿病	ＨＤＬＳ
多発ＬＮ転移	多部位リンパ節転移	テント上下転移性腫瘍
大腸粘膜癌	癌	大腸粘液癌
大動脈損傷	上大動脈損傷	胸部大動脈損傷
仙骨前腫瘤	腫瘤	仙骨腫瘍
前頭葉脳出血	脳出血	小脳出血
社会不安症	不安神経症	社会不安障害
左頚部食道傍リンパ節転移	リンパ節転移	肝門部リンパ節転移
時折物忘れ	健忘症	記憶錯誤
左頬部未分化腺癌	癌	甲状腺未分化癌
ＩＩ型ＤＭ	２型糖尿病	ＨＤＬＳ
脊椎管狭窄	脊柱管狭窄症	頚部脊柱管狭窄症
膨満　グル音正常	腹部膨満	心音図異常
顔面神経麻痺静的再建	顔面神経麻痺	術後顔面神経麻痺
低分化性扁平上皮癌	癌	中葉肺扁平上皮癌
左房内粘液腫	心臓粘液腫	左心房粘液腫
左肺下葉浸潤影	胸部異常陰影	下肺野陰影
中葉舌区症候群	中葉無気肺	中葉症候群
軟部組織腫瘤	腫瘤	臍部腫瘤
慢性誤嚥	嚥下障害	異物誤嚥
Ｇｍ敗血症	敗血症	ＧＢＳ敗血症
病的腹水	腹水症	血性腹水
慢性疲労	疲労感	慢性疲労症候群
Ｃｈｏｌｅｄｏｃｈｏｃｅｌｅ	総胆管のう腫	ＨＣＡＨＣ
癌再発	癌	前立腺癌再発
肺門腫瘤	縦隔腫瘍	肺腫瘤
右鎖骨転移	骨転移癌	鎖骨上転移性腫瘍
緑内症	緑内障	偽緑内障
夕方痛み	疼痛	持続痛
左側副部痛	側腹部痛	側胸部痛
後腹膜腫瘍上行結腸浸潤	後腹膜腫瘍	下行結腸腫瘍
重症ＣＭＶ腸炎	サイトメガロウイルス腸炎	ＭＲＳＡ腸炎
膿瘍形成	膿瘍	水晶体膿瘍
ブドウ球菌検出	ぶどう球菌感染症	Ｂ群溶連菌保菌者
Ｅｓｃｈｅｒｉｃｈｉａ　ｃｏｌｉ	大腸菌感染症	ＣＡＲＡＳＩＬ
右房浸潤	乳房悪性腫瘍	移植性前房のう胞
屈筋腱鞘炎	腱鞘炎	手屈筋腱腱鞘炎
原発性肺腫瘍	肺腫瘍	肺良性腫瘍
低悪性度リンパ腫	ホジキンリンパ腫	悪性リンパ腫
陰部腫脹	陰のう腫大	胸部腫脹
腹水浸出	腹水症	濾出性腹水
ＴＡＡ	胸部大動脈瘤	ＣＡＤＡＳＩＬ
腸管皮膚瘻	腸瘻	直腸皮膚瘻
ライン感染	カテーテル感染症	ＨＩＶ感染
多発擦過傷	擦過創	多発性擦過創
肺嚢胞感染	肺のう胞	Ｂ群溶連菌感染症
Ｃｈｕｒｇ−Ｓｔｒａｕｓｓ　症候群	好酸球性多発血管炎性肉芽腫症	Ｅｕｔｈｙｒｏｉｄ　Ｓｉｃｋ症候群
脾結核	結核	腎結核
潰瘍性大腸炎急性増悪	潰瘍性大腸炎	急性潰瘍性大腸炎
肺抗酸菌感染症	肺非結核性抗酸菌症	多剤耐性腸球菌感染症
両眼網膜症	網膜症	近視性網膜症
左眼結膜炎	結膜炎	眼瞼結膜炎
右肺原発腺癌	肺腺癌	原発性肺癌
ＣＲＥＳＴ症候群	クレスト症候群	ＶＡＴＥＲ症候群
脳筋症	ミトコンドリア脳筋症	脳症
左大腿骨骨腫瘍	大腿骨腫瘍	大腿骨近位部骨腫瘍
右後頭葉塞栓性脳梗塞	塞栓性脳梗塞	塞栓性小脳梗塞
僧房弁疣贅	疣贅	尋常性疣贅
慢性突発性血小板減少性紫斑病	血小板減少性紫斑病	慢性特発性血小板減少性紫斑病
下部消化管穿孔	腸穿孔	根管側壁穿孔
Ｔ字杖歩行可能	歩行障害	歩行困難
大腫瘤影	腫瘤	眼窩腫瘤
ヘルペス性脳炎	サル痘	ヘルペス脳炎
不安症様	不安神経症	不安障害
右前額部痛	前頭部痛	前胸部痛
骨折病変	骨折	病的骨折
下肢骨折	骨折	上肢骨折
アスピリンアレルギー	アスピリン不耐症	アレルギー
固形腫瘍	腫瘍	葉状腫瘍
統合失調症残遺状態	統合失調症	残遺型統合失調症
右上肢不全片麻痺	不全片麻痺	上肢不全麻痺
左大腿蜂窩織炎	蜂窩織炎	大腿部蜂巣炎
頭位性回転性めま	体位性めまい	頭位変換性めまい
口唇紅潮	紅潮	顔面紅潮
開腹腫瘤	腫瘤	腹部腫瘤
外側部乳癌	乳癌	乳房上外側部乳癌
両足関節以遠しびれ感	しびれ感	足関節強直
左再発性気胸	続発性気胸	特発性気胸
胃のむかつき	悪心	胃瘻開口部に対する手当て
痒疹結節散在	痒疹	結節性痒疹
先天性胆管欠損	胆管先天奇形	先天性胆のう欠損
冠性Ｔ波	心電図異常	ＲＡＥＢ−ｔ
カンジダ眼内炎	眼内炎	カンジダ性口内炎
度腟壁裂傷	腟裂傷	高位腟裂傷
仙骨部腫瘤	腫瘤	骨腫瘤
帯状疱疹再燃	帯状疱疹	汎発性帯状疱疹
喘息症状	咳喘息	夜間性喘息
ふらつく気	よろめき歩行	気うつ
拡張障害型心不全	心不全	急性心不全
アカシジア症状	錐体路障害	ノカルジア症
間歇的腹痛	腹痛症	周期性腹痛
星状細胞腫	星細胞腫	星状芽細胞腫
良性下垂体腫瘍	下垂体腫瘍	下垂体良性腫瘍
左側頭部帯状疱疹	帯状疱疹	後頭部帯状疱疹
頭蓋内出血性病変	非外傷性頭蓋内出血	外傷性頭蓋内出血
閉塞性睡眠呼吸障害	睡眠時無呼吸症候群	閉塞性睡眠時無呼吸
両膝変形	変形性膝関節症	足部変形
表在性腫瘍	腫瘍	良性腫瘍
左母指多指症	副母趾	多指症
アルコール性末梢神経障害	アルコール性多発ニューロパチー	アルコール性神経筋障害
暗紅色斑	紅斑症	環状紅斑
Ｌａｎｇｈａｎｓ巨細胞	ランゲルハンス細胞組織球症	Ｉ細胞病
気管支喘息発症	気管支喘息	気管支喘息発作
分葉状嚢胞性腫瘤	腫瘤	精巣上体腫瘤
甲状腺肥大	甲状腺疾患	甲状腺欠損
好中球浸潤	好中球増加症	好中球Ｇ６ＰＤ欠乏症
多房性腫瘤	腫瘤	乳房腫瘤
夜間不安	不安障害	不安緊張状態
左内耳障害	迷路障害	心耳相同
左耳介発赤	発赤	咽頭発赤
副腎性クッシング症侯群	クッシング症候群	副腎性器症候群
痛く	疼痛	全身痛
皮疹再燃	発疹	反応性発疹症
子宮筋腫手術	子宮筋腫	子宮筋腫術後
腕頭静脈血栓症	静脈血栓症	上腕静脈血栓症
脊椎病変	脊椎異常	脊椎疾患
歯状核	歯状核赤核淡蒼球ルイ体萎縮症	殻状歯
ＥＢＶ腸炎	細菌性腸炎	ＭＲＳＡ腸炎
足しびれ	下肢しびれ	しびれ感
膵内分泌腫瘍肝転移	転移性肝癌	転移性膵腫瘍