出現形	正解	予測
副腎原発神経芽腫	副腎神経芽腫	副腎神経芽腫
Ｗｅｎｃｋｅｂａｃｈ型房室ブロック	ウェンケバッハ型第２度房室ブロック	ウェンケバッハ型第２度房室ブロック
痰貯留多	喀痰	歯冠補綴物過高
皮膚リンパ腫	菌状息肉症	皮膚良性リンパ腺腫症
個細胞壊死	壊死	腎髄質壊死
左大腿骨顆上骨折	大腿骨外顆骨折	大腿骨顆上骨折
病原性大腸菌Ｏ−１５７感染性腸炎	病原性大腸菌感染症	非感染性大腸炎
口腔粘膜浮腫	浮腫	口腔粘膜下気腫
腟粘膜発赤	発赤	痂皮性膿痂疹
レム睡眠行動異常症	レム睡眠行動障害	レム睡眠行動障害
閉塞性膵炎	膵炎	閉塞性肺炎
脱髄性疾患	脱髄疾患	脱髄疾患
多発性脾膿瘍	脾膿瘍	多発性肝膿瘍
間質性肺水腫	肺水腫	非心原性肺水腫
無動性無言	無動性無言症	無動性無言症
舌扁平上皮癌	舌癌	肺扁平上皮癌
両側肺門部浸潤影	胸部異常陰影	肺門部異常陰影
軽度悪心	悪心	軽度難聴
慢性活動性ＥＢウルス感染症	ＥＢウイルス感染症	ＥＢウイルス伝染性単核症
蛋白尿減少	蛋白尿	蛋白尿
脳障害	脳症	腎障害
中心性奬液性網脈絡膜症	中心性漿液性網脈絡膜症	中心性漿液性網脈絡膜症
左一側性反回神経麻痺	一側性反回神経麻痺	一側性反回神経麻痺
イレウス様	イレウス	亜イレウス
膵炎併発	膵炎	肺炎合併肺膿瘍
ｈｅｍｏｐｈａｇｏｃｙｔｉｃ　ｓｙｎｄｒｏｍｅ	血球貪食症候群	肝ヘモクロマトーシス
抗癌剤漏出	薬剤漏出性皮膚障害	抗癌剤漏出性皮膚障害
水痘帯状疱疹	帯状疱疹	帯状疱疹
ｓｙｓｔｅｍｉｃ　ｍａｓｔｏｃｙｔｏｓｉｓ	肥満細胞腫症	Ｅｕｔｈｙｒｏｉｄ　Ｓｉｃｋ症候群
発汗多量	多汗症	多量出血
早発黄疸	早発性黄疸	早発性黄疸
急性細菌性気管支炎	急性気管支炎	慢性化膿性気管支炎
右上葉肺小細胞癌	上葉肺大細胞癌	上葉肺大細胞癌
腟癌１期	腟癌	痔瘻癌
会陰部発赤	発赤	ＭＲＳＡ術後創部感染
嚥下時痛軽度	嚥下痛	嚥下痛
左顔面血管腫	顔面血管腫	顔面血管腫
鼻汁多く	鼻汁	鼻汁
口腔内出血痕	口腔出血	口腔出血
ＳＩＡＤ	抗利尿ホルモン不適合分泌症候群	ＡＩＤＳ
夜両足痛	足痛	足背痛
左後頭葉梗塞	脳梗塞	急性後側部心筋梗塞
左内眼角基底細胞癌	眼角基底細胞癌	眼角基底細胞癌
難治性イレウス	イレウス	閉塞性イレウス
副鼻腔腫瘍	鼻副鼻腔腫瘍	鼻副鼻腔腫瘍
大腸菌菌血症	菌血症	大腸菌感染症
右前頭葉出血	脳出血	外陰部出血
左膝部痛	膝窩部痛	膝窩部痛
仙椎陳旧性骨折	陳旧性骨折	鼻骨陳旧性骨折
乳癌既往	乳癌	子宮筋腫摘出後後遺症
軽度咽頭発赤	咽頭発赤	咽頭発赤
痙攣起	痙攣	痙攣
下肢浮腫圧痕	下肢浮腫	下肢浮腫
左側頬部腫脹	頬部腫脹	頬部腫脹
心室中隔穿孔	心室中隔欠損症	鼻中隔穿孔
四肢浮腫軽度	四肢浮腫	四肢浮腫
大腸ポリープ　ポリペク後	大腸ポリープ	小腸ポリープ
腰椎椎体椎間板炎	腰椎椎間板炎	腰椎椎間板炎
左下葉肺炎悪化	大葉性肺炎	急性下後壁心筋梗塞
ぼんやり感持続	反応性低下	不潔恐怖症
右鼠径部痛	鼡径部痛	前胸壁痛
皮疹不変	発疹	神経皮膚症候群
創部痛	術創部痛	項部痛
軽度右気胸	気胸	漏斗胸
腸閉塞歴	イレウス	結腸閉塞
左大腿骨骨折	大腿骨骨折	大腿骨骨折
紅斑局面多発	紅斑症	急性後部多発性斑状色素上皮症
下部進行食道癌	食道癌	上部食道癌
無γグロブリン血症	無ガンマグロブリン血症	無ハプトグロブリン血症
子宮頸管ポリープ切除	子宮頚管ポリープ	子宮頚管ポリープ
手首疼痛	疼痛	手関節痛
ｓｐｌｅｎｉｃ　ｍａｒｇｉｎａｌ　ｚｏｎｅ　ｌｙｍｐｈｏｍａ	脾辺縁帯リンパ腫	Ｅｕｔｈｙｒｏｉｄ　Ｓｉｃｋ症候群
体動時息ぎれ	労作時呼吸困難	静止時振戦
一部浮腫	浮腫	四肢浮腫
ふらつき注意	よろめき歩行	腹部不快感
左中耳炎	中耳炎	中耳炎
胃食道逆流症状	胃食道逆流症	胃食道逆流症
両側卵巣子宮内膜症性嚢胞	卵巣子宮内膜症のう胞	母斑様限局性体幹被角血管腫
新出肝転移	転移性肝癌	軟産道伸展不良
脊椎カリエス	脊椎結核	陳旧性腰椎カリエス
行動障害	素行障害	歩行障害
妊娠性糖尿病	妊娠糖尿病	妊娠糖尿病
小豆大紅斑	紅斑症	水疱性多形紅斑
ＦＳＧＳ	巣状糸球体硬化症	ＨＤＬＳ
左寛骨臼骨折	寛骨臼骨折	寛骨臼骨折
原発性両眼内悪性リンパ腫	眼窩悪性リンパ腫	原発性皮膚濾胞中心リンパ腫
腹腔鏡補助下子宮筋腫核	子宮筋腫	壁内子宮平滑筋腫
両下肢静脈血栓	下肢静脈血栓症	下肢血栓性静脈瘤
神経根障害	神経根炎	末梢神経障害
クモ膜下出血	くも膜下出血	くも膜下出血
後鼻汁症候群	後鼻漏	濃縮胆汁症候群
糖尿病性腎症１期	腎性糖尿	１型糖尿病性腎症
左臀部慢性膿皮症	慢性膿皮症	大腿皮膚線維腫
メサンギウム増殖性腎炎	メサンギウム増殖性糸球体腎炎	メサンギウム増殖性糸球体腎炎
左前頭葉心原性脳梗塞	心原性脳塞栓症	再発性側壁心筋梗塞
閉塞性尿路感染	尿路感染症	急性尿路感染
顔面蝶形紅斑	ＬＥ蝶形皮疹	顔面扁平母斑
上行結腸癌肝転移	転移性肝癌	下行結腸癌
仙骨部色素沈着	色素異常症	鼻部外傷性色素沈着
肥満糖尿病	糖尿病	膵性糖尿病
左肩痛み	肩部筋痛	腓腹部痛
ＰＳＶＴ発作	発作性上室頻拍	パニック発作
顎変形症術後顎変形症	顎変形症	包茎術後変形
ＤＭＮ　２期	糖尿病	ＧＭ２ガングリオシドーシス１型
労作時胸部絞扼感	胸内苦悶	閉経後骨粗鬆症・大腿部病的骨折あり
右膝変形	変形性膝関節症	股関節変形
指趾潰瘍	趾皮膚潰瘍	指骨腫瘍
２型食道癌	食道癌	早期食道癌
骨性腫瘤	腫瘤	胸骨良性腫瘍
外傷性脊髄損傷	脊髄損傷	多発性脊髄損傷
下肢結節性紅斑	結節性紅斑	結節性紅斑性関節障害
左動眼神経麻痺	動眼神経麻痺	動眼神経麻痺
家族性海綿状血管腫	海綿状血管腫	多発性海綿状血管腫
術中直腸損傷	直腸損傷	術後頚髄損傷
下肢動脈瘤	下肢の動脈瘤	上肢動脈瘤
精神病様症状	精神病	症状精神病
項頸部痛	頚部痛	項背部筋痛
頸部白斑	白斑	側頭部青色母斑
左大腿骨転子部粉砕骨折	転子下骨折	大腿骨転子部開放骨折
最近眠気	非器質性過眠症	脚気心
ＶＨＤ	心臓弁膜症	ＡＶＭ
夜頻尿	夜間頻尿症	夜間頻尿症
回盲部炎	回盲部憩室炎	回盲部憩室炎
重症肺血栓塞栓症	肺塞栓症	肺血栓塞栓症
左歯痛	歯痛	母趾痛
腹膜播種切除	腹膜播種	胸膜播種
右乳突蜂巣	乳様突起炎	鼡径部蜂巣炎
右肺尖部気胸	気胸	左肺動脈右肺動脈起始症
骨盤内子宮内膜症	子宮内膜症	骨盤子宮内膜症
左頬部痛	頬部痛	頬部痛
局麻薬アレルギー	薬物過敏症	抗アレルギー薬中毒
肺クリプトコックス症	急性肺クリプトコッカス症	脳クリプトコッカス症
右肩関節亜脱臼半横指	肩関節亜脱臼	肩関節前方亜脱臼
慢性蕁麻疹	慢性じんま疹	慢性腟炎
マラセチア毛嚢炎	マラセチア毛包炎	マラセチア毛包炎
高分化型漿液性腺癌	癌	卵巣漿液性腺癌
腫瘍床	腫瘍	腫瘍
左膀胱尿管逆流症	膀胱尿管逆流	膀胱尿管逆流
外側疼痛	疼痛	陰茎部疼痛
卵巣癌再発卵巣癌	卵巣癌	再発卵巣癌
錐体路病変	錐体外路系疾患	錐体路障害
リンパ球性白血病	リンパ性白血病	リンパ性白血病
クラミジア感染	クラミジア感染症	クラミジア感染症
奬液性嚢胞腺腫	膵漿液性のう胞腺腫	卵巣粘液性腺腫
夜間倦怠感	倦怠感	倦怠感
脳血栓塞栓症	脳血管閉塞性脳梗塞	血栓塞栓症
左リウマチ性肘関節症	関節リウマチ・膝関節	非リウマチ性三尖弁狭窄症
右下腿潰瘍感染	下腿皮膚潰瘍	下腿皮膚潰瘍
気分不快時	悪心	気分異常
問題なし前立腺肥大	前立腺肥大症	前立腺肥大症
急性パルボウイルスＢ１９感染症	パルボウイルス感染症	パルボウイルス感染症
脂肪性腫瘤	脂肪腫	脊髄脂肪腫
ウィルス性肺炎	肺炎	ウイルス性肺炎
類円形紅斑	紅斑症	環状紅斑
書字不能	書痙	嚥下不能
肺動脈狭窄	肺動脈狭窄症	肺動脈狭窄症
夜間不眠状態	不眠症	退行期妄想状態
熱型	発熱	発熱
骨盤内充実性腫瘍	骨盤腫瘍	骨盤骨良性腫瘍
夢遊病	夢遊症	夢遊症
脊髄小脳変性症６型	脊髄小脳変性症	脊髄小脳失調症６型
左内頚動脈閉塞	内頚動脈閉塞症	内頚動脈閉塞症
両側角乾燥性結膜炎	結膜炎	前房蓄膿性角膜炎
脳虚血症状	脳虚血症	脳虚血症
微熱持続	微熱	持続熱
夕方浮腫	浮腫	月経前浮腫
眼性疲労	眼精疲労	眼精疲労
直腸肛門奇形	鎖肛	仙腸関節奇形
右大腿部腫瘍	大腿悪性軟部腫瘍	大腿軟部腫瘍
頚椎症神経根症	頚椎症性神経根症	頚椎症性神経根症
壊死性遊走性紅斑	遊走性紅斑	慢性遊走性紅斑
睡眠障害招くリスク	睡眠障害	睡眠リズム障害
上大静脈血栓	静脈血栓症	上大静脈欠損
骨盤内ＬＮ転移	骨盤内リンパ節転移	骨盤転移
ＰＫＤ	多発性のう胞腎	ＰＣＷＨ
分水嶺脳梗塞	脳梗塞	出血性脳梗塞
上皮性腫瘍	腫瘤	頭皮良性腫瘍
大球性正色素貧血	大球性貧血	正球性正色素性貧血
挙上空腸穿孔	腸穿孔	挙上空腸狭窄
腸管アメーバ感染症	腸アメーバ症	腸管アメーバ肉芽腫
放射線性皮膚炎	放射線皮膚炎	放射線皮膚炎
肛門周囲びらん	外痔びらん	肛門部びらん
髄膜炎徴候	髄膜炎	麻疹髄膜炎
胸部不快	胸内苦悶	胸部不快感
下葉肺炎	肺炎	大葉性肺炎
右足根部粉砕骨折	粉砕骨折	上腕骨粉砕骨折
蛋白漏出胃腸症	蛋白漏出性胃腸症	蛋白漏出性胃腸症
左大脳陳旧性ラクナ梗塞	陳旧性ラクナ梗塞	陳旧性ラクナ梗塞
出血多量	急性大量出血	多量出血
腹水多量	腹水症	異常腹水
腸間膜リンパ管腫	リンパ管腫	腸間膜リンパ節腫脹
右卵巣悪性腫瘍	卵巣悪性腫瘍	卵巣悪性腫瘍
糖尿病（２型）	２型糖尿病	１型糖尿病
化膿性胸鎖関節炎	化膿性関節炎・胸鎖関節	化膿性顎関節炎
右乳腺線維腫症	線維腫	乳腺線維腫
肺野鬱血像	肺野異常陰影	肺腫瘤陰影
児嘔気	嘔気	嘔気
尿閉歴	尿閉	流産後乏尿
陰嚢びらん	陰のうびらん	陰茎びらん
精神的ショック	ショック	心原性ショック
右上腕骨外側上顆炎	外側上顆炎	上腕骨外上顆開放骨折
子宮頚上皮内癌	子宮頚部上皮内癌	子宮頚部上皮内癌
難治性非定型性抗酸菌症	非結核性抗酸菌症	非結核性抗酸菌症
軽度腹水	腹水症	板状無気肺
湿疹様	湿疹	湿疹
大後頭孔狭窄	軟骨形成不全症	後鼻孔狭窄
熱型変化	発熱	熱性虚脱
右無機能腎	無機能腎	無機能腎
月経痛コントロール不十分	月経痛	維持療法の必要な術後難治性逆流性食道炎
左鎖骨下動脈閉塞	鎖骨下動脈閉塞症	鎖骨下静脈狭窄
右ＤＶＴ	深部静脈血栓症	ＩＵＤ挿入
非特異的胸痛	胸痛	非特異的反応性肝炎
Ａｅｒｏｍｏｎａｓ　ｈｙｄｒｏｐｈｉｌａ敗血症	敗血症	アミロイドーシス関節炎
重症細菌性敗血症	敗血症	連鎖球菌性敗血症
逆行性健忘	逆向性健忘	逆向性健忘
腹直筋膜下血腫	筋肉内血腫	腹壁下血腫
関連腎臓病	腎疾患	ＩｇＧ４関連腎臓病
認知症様症状	認知症	皮質認知症
顎骨骨折	下顎骨骨折	下顎骨骨折
高度大動脈弁狭窄	大動脈弁狭窄症	大動脈弁上狭窄症
右顔面骨骨折	顔面骨骨折	顔面骨骨折
炎症性粉瘤	粉瘤	炎症性斜頚
左腰部疼痛	腰痛症	腓腹部痛
ＨＣＶ重複感染症	Ｃ型肝炎ウイルス感染	ＨＴＬＶ−１感染症
脂質異常症（＋）	脂質異常症	間質性膀胱炎（ハンナ型）
上腹部圧痛	腹部圧痛	腹部圧痛
両側椎骨動脈瘤	椎骨動脈瘤	橈骨動脈瘤
非ケトン性高血糖	高血糖高浸透圧症候群	非ケトン性高グリシン血症
Ｙｅｒｓｉｎｉａ腸炎	エルシニア腸炎	Ｅｕｔｈｙｒｏｉｄ　Ｓｉｃｋ症候群
声帯浮腫	声帯炎	声門浮腫
誤嚥性肺炎併発	誤嚥性肺炎	誤嚥性肺炎
咳嗽持続	咳	持続熱
左側下顎骨嚢胞	顎骨のう胞	下顎骨骨肉腫
右末梢前庭障害	末梢前庭障害	末梢前庭障害
胆管閉鎖症	胆管閉塞症	胆管閉塞症
閉塞性動脈硬化症　症状	閉塞性動脈硬化症	閉塞性動脈硬化症
洞不全	洞不全症候群	左心不全
特発性リンパ浮腫	リンパ浮腫	頚部悪性リンパ腫
シャント吻合部狭窄	透析シャント狭窄	透析シャント狭窄
無気力	無力症	無気肺
胸骨炎	胸骨周囲炎	胸椎炎
ナッツアレルギー	ピーナッツアレルギー	ピーナッツアレルギー
甲状腺乳頭癌術後再発	甲状腺乳頭癌	直腸癌術後再発
上肢疼痛	疼痛	上肢痛
Ｔｕｒｎｅｒ症候群	ターナー症候群	ＶＡＴＥＲ症候群
肝臓機能障害用	肝機能障害	肝機能障害
左心不全徴候	心不全	左心不全
ＩＰＭＮ癌化	膵管内乳頭粘液性腺癌	ＭＲＳＡ肺化膿症
後発頚部転移	頚部転移性腫瘍	陳旧性顎関節脱臼
下痢治	下痢症	乳児下痢
朝方疼痛	疼痛	急性疼痛
蜂窩肺形成	蜂窩織炎	異型乳管過形成
右ＩＣＡ高度狭窄	内頚動脈狭窄症	右室漏斗部狭窄
膵体部嚢胞	膵のう胞	胃底部癌
右気管支狭窄	気管支狭窄症	気管支狭窄症
非ヘルペス性辺縁系脳炎	辺縁系脳炎	自己免疫性辺縁系脳炎
無症候性ＶＴ	心室頻拍	無症候性細菌尿
好酸球増多	好酸球増加症	好酸球増加症
口腔清掃	個人衛生の著しいレベル低下	口腔乾燥症
両下腿皮膚潰瘍	下腿皮膚潰瘍	下腿皮膚潰瘍
無石性胆嚢炎	胆のう炎	無症候性原発性胆汁性胆管炎
ｓ型ポリープ	ポリープ	腟ポリープ
時折頭痛	頭痛	片頭痛
関節リウマチ発症	関節リウマチ	関節リウマチ性心膜炎
残像腫瘍	腫瘍	坐骨腫瘍
両顎下腺腫大	顎下腺肥大	顎下腺腫瘤
夜間中途覚醒時	睡眠障害	中枢性睡眠時無呼吸
今朝頭痛	頭痛	先天梅毒
眼球偏移	眼球偏位	眼球偏位
腹腔内癒着高度	腹膜癒着	腹膜癒着
右母指多指症	多指症	母指三指節症
薬剤性骨髄抑制	骨髄機能低下	薬剤性骨軟化症
肥満	肥満症	肥満症
網膜中心動脈閉塞	網膜中心動脈閉塞症	網膜中心動脈閉塞症
中枢神経悪性リンパ腫再発	悪性リンパ腫	悪性リンパ腫骨髄浸潤
旅行者下痢症	下痢症	習慣性下痢
右声帯ポリープ	声帯ポリープ	声帯ポリープ
非Ｂ非Ｃ型肝硬変	肝硬変症	Ｂ型非代償性肝硬変
頭部皮下結節	皮下結節	皮下結節
足がむくみ	下肢浮腫	くしゃみ
下肢潰瘍	下肢皮膚潰瘍	下肢皮膚潰瘍
難治性胸腹水	難治性腹水	難治性腹水
幻覚症状	幻覚	器質性幻覚症
異常腫瘤	腫瘤	多発性皮下腫瘤
未破裂脳動脈瘤コイル塞栓	未破裂脳動脈瘤	未破裂先天性脳動静脈瘤
左下顎骨慢性骨髄炎	慢性顎骨骨髄炎	下腿骨慢性骨髄炎
左側頭葉膠芽腫	側頭葉膠芽腫	側頭葉膠芽腫
脳血管障害性パーキンソニズム	脳血管障害性パーキンソン症候群	脳血管障害性パーキンソン症候群
右後角脳室内出血	脳室内出血	視神経鞘内出血
難治性浮腫	高度浮腫	難治性胃潰瘍
Ｇｒａｎｕｌｏｍａｔｏｓｉｓ　ｗｉｔｈ　ｐｏｌｙａｎｇｉｉｔｉｓ	多発血管炎性肉芽腫症	Ｅｕｔｈｙｒｏｉｄ　Ｓｉｃｋ症候群
再発脊索腫	脊索腫	脊索腫
Ｃ型肝硬変症	Ｃ型肝硬変	Ｃ型肝硬変
左踵部悪性黒色腫	踵部悪性黒色腫	踵部悪性黒色腫
未分化癌	癌	食道未分化癌
両側副腎悪性リンパ腫	悪性リンパ腫	縦隔悪性リンパ腫
帯状疱疹無	帯状疱疹	湿疹状白癬
左膝痛み	膝関節痛	腓腹部痛
右下腿痛	下腿痛	下腿痛
気管支喘息症状	気管支喘息	気管支狭窄症
大腿骨内顆骨壊死	特発性大腿骨内顆骨壊死	大腿骨内顆軟骨損傷
炎症性貧血	貧血	症候性貧血
両下肢掻痒感	皮膚そう痒症	下肢脱力感
右後頭葉脳挫傷	脳挫傷	前頭部挫傷
女性化乳房	女性化乳房症	女性化乳房症
ｍａｓｓ　ｌｅｓｉｏｎ	腫瘤	急性大動脈解離ＳｔａｎｆｏｒｄＡ
右大脳半球多発脳梗塞	多発性脳梗塞	前大脳動脈閉塞症
大動脈弁膜症	大動脈弁弁膜症	大動脈弁弁膜症
鎮静困難	興奮状態	排尿困難
再発腫瘤近傍	腫瘤	多発性皮下腫瘤
右下腿麻痺	下肢麻痺	下肢麻痺
切除不能多発性肝転移	転移性肝腫瘍	急性出血性十二指腸潰瘍穿孔
腹腔内膿瘍形成	膿瘍	腹腔内膿瘍
発作性上室性頻拍	発作性上室頻拍	発作性上室頻拍
筋肉痛生	筋肉痛	筋肉痛
腰椎滑り症	腰椎すべり症	腰椎変性すべり症
淡血性胸水	血性胸水	漏出性胸水
腎被膜下出血	外傷性腎被膜下血腫	結膜下出血
仙骨部褥瘡痕	仙骨部褥瘡	腹壁瘢痕部潰瘍
左肝腫瘍	肝腫瘍	肝左葉腫瘍
非Ｃｌｏｓｔｒｉｄｉｕｍ性ガス壊疽	ガス壊疽	急性大動脈解離ＤｅＢａｋｅｙＩＩＩａ
リンパ腺腫脹	リンパ節腫大	リンパ節腫大
心室二段脈	心室性二段脈	心室性二段脈
鼻腔腫瘍摘出	鼻腔腫瘍	鼻腔腫瘍
疼痛時頓用	疼痛	睡眠時無呼吸症候群治療用咬合床不適合
多房性膿瘍	膿瘍	多発性汗腺膿瘍
右耳介後部痛	耳痛症	耳後部挫創
左胸壁腫瘍切除	胸壁腫瘍	開放性胃腸管穿孔破裂
無呼吸症候群	無呼吸発作	睡眠時無呼吸症候群
右尿管癌	尿管癌	尿管癌
出血過多	出血	多量出血
甲状腺嚢腫	甲状腺のう胞	甲状腺腺腫
両側浸出性中耳炎	滲出性中耳炎	穿孔性中耳炎
覚醒度	麻酔覚醒遅延	温度感覚過敏
高血糖	高血糖症	低血糖
有意弁膜症	弁膜炎	先天性喉頭狭窄症
胸痛無	胸痛	胸痛
右下肺野無気肺	無気肺	下葉無気肺
小脳性失調	小脳性運動失調症	急性小脳性失調症
好酸球増多症	好酸球増加症	好酸球増加症
右腎明細胞肉腫	腎明細胞肉腫	腎明細胞肉腫
甲状腺左葉濾胞腺腫	濾胞性甲状腺腺腫	濾胞性甲状腺腺腫
下位運動ニューロン徴候	運動ニューロン疾患	運動ニューロン疾患
主幹動脈狭窄	脳動脈狭窄症	動脈狭窄
創部皮下血腫	外傷性皮下血腫	頭部皮下血腫
掻痒感軽減	そう痒	汗疹湿疹化
両肺小結節影	肺野異常陰影	尺側手根伸筋腱損傷
造影剤アレルギー歴	薬物過敏症	アレルギー性咳嗽
左眼鼻涙管閉塞症	鼻涙管閉鎖症	鼻涙管閉鎖症
慢性的な抑うつ気分	うつ状態	神経症性抑うつ状態
鼻部異物肉芽腫	皮膚異物肉芽腫	皮膚異物肉芽腫
遠隔ＬＮ転移	リンパ節転移	非特異的ＳＴ−Ｔ変化
子宮がん	子宮癌	子宮頚部びらん
Ｂｉｃｋｅｒｓｔａｆｆ型脳幹脳炎	ビッカースタッフ脳幹脳炎	ＶＡＴＥＲ症候群
睾丸腫脹	精巣腫脹	鼡径部腫脹
右中皮腫	中皮腫	右心房粘液腫
ジベル薔薇色粃糠疹	ジベルばら色粃糠疹	ジベルばら色粃糠疹
脳実質外腫瘍	腫瘍	脳髄膜腫瘍
抑鬱感	気うつ	疲労感
扁桃腺腫大	扁桃肥大	扁桃腫瘍
口内出血	口腔出血	眼球内出血
右上方視野欠損	視野欠損	視野欠損
両側臼蓋形成不全症	臼蓋形成不全	頭蓋顔面骨形成不全症
進行肝癌	肝癌	進行乳癌
噴門部狭窄	胃狭窄	噴門狭窄
突発性腎出血	腎出血	特発性腎出血
前股関節症	股関節症	股関節症
多発肝嚢胞	多発性肝のう胞	多発脂肪腫
過換気状態	過換気症	過換気症
傍大動脈ＬＮ	大動脈周囲リンパ節転移	奇静脈肺葉
左椎骨動脈低形成	骨髄低形成	腎動脈過形成
左房拡張	心拡大	心房期外収縮
サルモネラ菌感染症	サルモネラ感染症	サルモネラ感染症
両側性多発性嚢胞腎	多発性のう胞腎	多発性神経膠腫
化学物質アレルギー	アレルギー	金属アレルギー
右手指腫脹	手指腫脹	手指腫脹
右足背発赤	発赤	足背膿瘍
脊柱管高度狭窄	脊柱管狭窄症	広範脊柱管狭窄症
右急性網膜壊死	急性網膜壊死	急性網膜壊死
皮膚硬化がまだかなり	新生児皮膚硬化症	皮膚はえ幼虫症
口腔内乾燥軽度	口腔乾燥症	口腔乾燥症
下肢筋痛	下肢筋肉痛	下肢筋肉痛
蠕動不良	異常腸音	振動病
四肢腱反射亢進	反射亢進	先天性筋緊張亢進
黒色丘疹	丘疹	紅色丘疹
胸部陰影	胸部異常陰影	胸部異常陰影
クモ膜下嚢胞	くも膜のう胞	下葉小細胞肺癌
２次性糖尿病	二次性糖尿病	二次性糖尿病
Ｈａｅｍｏｐｈｉｌｕｓ　ｉｎｆｌｕｅｎｚａｅ敗血症	敗血症	ＴＥＬ−ＡＭＬ１陽性Ｂリンパ芽球性白血病
慢性期疼痛	慢性疼痛	慢性疼痛
右上葉原発肺小細胞癌	小細胞肺癌	下葉非小細胞肺癌
出血源不詳	出血	原因不明の羊水過少症
一般細菌感染	細菌感染症	細菌感染症
急性小脳失調症	急性小脳性失調症	急性小脳性失調症
浸潤癌化所見	癌	非浸潤性乳管癌
痔核脱出	痔核	脱出性内痔核
重症膵炎	膵炎	重症急性膵炎
痛みアリ	疼痛	虹彩癒着
左心室内血栓症	心室内血栓症	心室瘤内血栓症
右足疼痛	疼痛	前足部痛
増殖前網膜症	網膜症	増殖性網膜症
傍神経節腫瘍	傍神経節腫	傍神経節腫
小腸膀胱瘻	膀胱皮膚瘻	直腸膀胱瘻
左小細胞肺癌	小細胞肺癌	小細胞肺癌
少量左胸水	胸水貯留	胎児胸水
多発ＨＣＣ再発	肝細胞癌	再発第２期梅毒
結核性嚢腫	結核	結核性膿瘍
右大腿骨外顆骨折	大腿骨外顆骨折	大腿骨外顆骨折
巨大膵仮性嚢胞	仮性膵のう胞	大腿胞巣状軟部肉腫
大腿腫脹	下腿腫脹	大腿部腫脹
全身性ＣＭＶ感染症	サイトメガロウイルス感染症	全身型若年性特発性関節炎
多発肝内転移	転移性肝腫瘍	多発性癌転移
右外耳道炎	外耳炎	外耳道痛
両下肢圧痕性浮腫	クインケ浮腫	下肢浮腫
下部腸間膜動脈出血	動脈性出血	腸間膜動脈損傷
ＩｇＭ型Ｍ蛋白	単クローン性免疫グロブリン血症	高ＩｇＭ血症
喘息発作様症状	気管支喘息発作	症候性痙攣発作
分食道癌	食道癌	食道癌
多少便秘気味	便秘症	老人性弱質
ポリープ状病変	ポリープ	Ｓ状結腸ポリープ
既往高血圧	高血圧症	術中異常高血圧症
右リウマチ性膝関節症	関節リウマチ・膝関節	非リウマチ性三尖弁狭窄症
急性骨髄性白血病（ＡＭＬ）	急性骨髄性白血病	急性骨髄性白血病
腹水大量	腹水症	濾出性腹水
全身皮膚発赤	発赤	全身毛孔性紅色粃糠疹
多発肺嚢胞	肺のう胞	多発性汗腺膿瘍
右小脳橋角部腫瘍	小脳橋角部腫瘍	小脳橋角部腫瘍
右眼網膜静脈分枝閉塞症	網膜静脈分枝閉塞症	網膜静脈分枝閉塞症
右脛骨腓骨開放骨折	脛骨腓骨開放骨折	脛骨腓骨開放骨折
左側卵巣腫瘍	卵巣腫瘍	卵管卵巣膿瘍
口腔内びらん	口唇びらん	鼻腔内びらん
紅斑熱群リケッチア症	リケッチア感染症	腺熱リケッチア症
ＩＴＰ	特発性血小板減少性紫斑病	ＰＣＷＨ
気管支喘息小発作	気管支喘息発作	気管支喘息発作
解離性動脈瘤破裂	解離性動脈瘤	解離性動脈瘤
左眼窩内腫瘍	眼窩腫瘍	眼窩偽腫瘍
肺外小細胞癌	小細胞肺癌	肺門部小細胞癌
高度大動脈弁狭窄症	大動脈弁狭窄症	大動脈弁上狭窄症
ｂｒｅａｋｔｈｒｏｕｇｈ　ｈｅｐａｔｉｔｉｓ	肝炎	Ｅｕｔｈｙｒｏｉｄ　Ｓｉｃｋ症候群
左室圧排	右室肥大	両室肥大
両側声帯外転障害	声帯外転筋麻痺	声帯外転筋麻痺
一部水疱形成	水疱症	膝部淡明細胞肉腫
糖尿病潰瘍	糖尿病性潰瘍	糖尿病性潰瘍
飲みこみにくさ	嚥下障害	会陰部せつ
左腎低形成	低形成腎	左心低形成症候群
左母趾疼痛	母趾痛	前胸壁痛
副腎ヒストプラズマ感染症	真菌症	マイコプラズマ感染症
右眼糖尿病網膜症	糖尿病網膜症	糖尿病性眼筋麻痺
下肢浮腫左	下肢浮腫	下肢浮腫
両松葉杖歩行	歩行障害	内反歩行
冠動脈狭窄３枝病変	狭心症３枝病変	冠状動脈狭窄症
遺伝性低尿酸血症	低尿酸血症	続発性高尿酸血症
低アルドステロン血症	低アルドステロン症	低アルドステロン症
小腸皮膚瘻	皮膚瘻	直腸皮膚瘻
重度僧帽弁狭窄症	僧帽弁狭窄症	僧帽弁狭窄症
非細菌性血栓性疣贅	疣贅	常染色体劣性先天性魚鱗癬
特発性腸間膜血腫	血腫	多発性腸間膜膿瘍
脳原発性悪性リンパ腫	脳悪性リンパ腫	脳悪性リンパ腫
抜管後両側反回神経麻痺	両側性反回神経麻痺	両側性反回神経麻痺
肝骨転移	骨転移癌	肝癌骨転移
乳腺線維腫症	線維腫	乳腺線維腫
術後左反回神経麻痺	反回神経麻痺	術後性反回神経麻痺
無症候性髄膜腫	髄膜腫	無症候性骨髄腫
左肺下葉肺癌	下葉肺癌	下葉肺癌
アルコール離脱症候群	アルコール離脱状態	アルコール性脳症候群
左腸骨骨肉腫	腸骨軟骨肉腫	腸骨軟骨肉腫
脳梁低形成	脳梁形成不全	舌低形成
表皮内水疱形成	先天性表皮水疱症	出血性網膜色素上皮剥離
後頚部圧痛	圧痛	側胸部痛
不定愁訴様	不定愁訴症	不定愁訴症
良性胆道狭窄	胆管狭窄症	淋菌性尿道狭窄
左下葉非小細胞肺癌	下葉非小細胞肺癌	下葉非小細胞肺癌
ＣＫＤ　腎硬化症	腎硬化症	Ｃ型非代償性肝硬変
前頭葉出血	出血	前頭葉腫瘍
有茎性乳頭状腫瘍	腫瘍	充実性偽乳頭状腫瘍
理解困難	言語理解障害	屈伸困難
スメア異常	腟スメア細胞診陽性	萌出異常
腹腔内敗血症	敗血症	気管切開部敗血症
膵尾部腫大	膵腫大	膵体尾部腫瘍
過呼吸状態	過換気症	睡眠時無呼吸症候群
右肺門部原発肺小細胞癌	小細胞肺癌	肺門部非小細胞癌
胃癌骨髄癌腫症	骨髄転移	髄膜癌腫症
眼乾燥感	ドライアイ	咽喉乾燥感
内側縦束症候群	核間性眼筋麻痺	上腕神経叢症候群
両足関節炎	足関節炎	足関節炎
夜低血糖	低血糖	夜間低血糖症
左上下肢軽度麻痺	四肢麻痺	下肢麻痺
下肢痙性	痙性対麻痺	下肢痙攣
皮疹状況	発疹	斑状類乾癬
不適応	適応障害	Ｄ不適合
陰茎部痛	陰茎部疼痛	陰茎部疼痛
髄外形質細胞腫	骨外性形質細胞腫	骨外性形質細胞腫
ｍａｌｉｇｎａｎｔ　ｌｙｍｐｈｏｍａ	悪性リンパ腫	ＴｒｉｐｌｅＡ症候群
重症ＡＧＨＤ	重症成人成長ホルモン分泌不全	ＮＳＡＩＤ腎症
両白内障	白内障	白内障
腎結石	腎結石症	腎結核
湿疹性病変	湿疹	汗疱性湿疹
穿刺部発赤	発赤	咽頭発赤
時々背部痛	背部痛	閉経後骨粗鬆症・大腿部病的骨折あり
手内筋萎縮	筋萎縮症	手指伸筋腱損傷
腎機能悪化	腎機能低下	腎機能低下
尾てい骨骨折	尾骨骨折	脛骨高原骨折
高度視力障害	視力障害	急性視力障害
周期性クッシング症候群	クッシング症候群	クッシング症候群
昨夜微熱	微熱	往来寒熱
腓腹筋痙攣	痙攣	四肢筋痙攣
左肋骨打撲	肋骨部打撲	肋骨弓部打撲
破壊性脊椎症	脊椎症	破壊性脊椎関節症
胆嚢破裂	胆のう管破裂	腸管破裂
独歩不可	歩行障害	屈伸困難
骨破壊進行	関節リウマチ	骨盤輪開放骨折
下肢白癬	白癬	四肢白癬
左鼓膜発赤	発赤	下腿発赤
潜在結核	結核	潜在胎児仮死
熱苦症状	発熱	熱中症
シャイドレジャー症候群	シャイ・ドレーガー症候群	シャイ・ドレーガー症候群
肺動脈弁閉鎖症	肺動脈弁閉鎖	肺動脈閉鎖症
脾摘施行Ｃ型肝炎	Ｃ型肝炎	肝間葉性過誤腫
胸水セルブロック	胸水貯留	一過性脚ブロック
右肺上葉すりガラス影	胸部異常陰影	腹部大動脈ステント植え込み状態
Ｆｏｌｌｉｃｕｌａｒ　ｌｙｍｐｈｏｍａ	濾胞性リンパ腫	Ｅｕｔｈｙｒｏｉｄ　Ｓｉｃｋ症候群
腫瘍性ＤＩＣ	線溶亢進	異所性ＡＤＨ産生腫瘍
右精巣上体炎	精巣上体炎	精巣上体炎
左肘関節亜脱臼	亜脱臼	肩鎖関節亜脱臼
左聴神経腫瘍	聴神経腫瘍	聴神経腫瘍
左肺感染性嚢胞	肺のう胞	侵襲性肺炎球菌感染症
母体出血	出血	卵胞出血
右足趾壊疽	下肢壊疽	下肢趾脱疽
胃腸障害	急性胃腸障害	直腸障害
残遺癌	癌	残胃癌
不安大きく	不安障害	不安うつ病
ＭＳ再発	多発性硬化症	ＣＡＤ／ＣＡＭ冠脱離
強直間代性痙攣発作	間代性痙攣	間代強直性痙攣
一過性意識消失発作	一過性脳虚血発作	一過性脳虚血発作
乳児白血病	白血病	乳児偽白血病
筋委縮	筋萎縮症	筋痙縮
水腎再燃	水腎症	乳癌再発
しびれていない	しびれ感	胎盤嵌頓・出血を伴わない
時々血痰	血痰	喀痰
左鼠経ヘルニア	鼡径ヘルニア	絞扼性腹壁ヘルニア
遺伝性腎性尿崩症	先天性腎性尿崩症	先天性腎性尿崩症
尿管結石	尿管結石症	腎尿管結石
体幹掻痒感	そう痒	皮膚弛緩症
右大腿部骨幹部骨折	大腿骨骨幹部骨折	大腿骨骨幹部骨折
糖尿病神経症	糖尿病性神経痛	糖尿病性腎症
古典的肝細胞癌再発	肝細胞癌	先天性肝腫大
左室低形成	左心低形成症候群	右室低形成
劇症肝炎亜急性型	劇症肝炎	重症急性膵炎
分岐部動脈瘤	内頚動脈後交通動脈分岐部動脈瘤	頚部解離性動脈瘤
腫瘍感染	腫瘍	感染性角膜潰瘍
悪性腫瘍スクリーニング	悪性腫瘍	染色体異常の分娩前スクリーニング
外陰部炎	外陰炎	外陰炎
軽度骨髄抑制	骨髄機能低下	骨吸収抑制薬関連顎骨壊死
右踵骨折	骨折	踵骨骨折
ＰＰＨ	肺高血圧症	ＳＡＰＨＯ症候群
頭痛時折	頭痛	睡眠時頭痛
血腫貯留	血腫	心膜液貯留
不整脈発作	不整脈	呼吸性不整脈
静脈炎症状	静脈炎	静脈炎後症候群
子宮間質肉腫	肉腫	子宮肉腫
右主気管支膜様部壊死	壊死	左肺動脈右肺動脈起始症
右下肺野スリガラス影	胸部異常陰影	下肺野陰影
時々頭痛	頭痛	睡眠時頭痛
胆嚢腺扁平上皮癌	癌	肺腺扁平上皮癌
上行結腸早期癌	上行結腸癌	上行結腸癌
突発性血小板減少性紫斑病	血小板減少性紫斑病	続発性血小板減少性紫斑病
意識変動	意識障害	部分的意識喪失
左閉鎖リンパ節転移	リンパ節転移	鎖骨上リンパ節転移
両側小脳梗塞	小脳梗塞	多発性小脳梗塞
胃癌多発肝転移	転移性肝癌	多発性癌転移
左前腕浮腫	浮腫	下腿浮腫
赤紫斑	紫斑病	白斑
偽腔閉塞型大動脈解離	解離性大動脈瘤	早期血栓閉鎖型大動脈解離
高度感音性難聴	感音難聴	両側性感音難聴
左耳介欠損	耳介欠損	耳介欠損
尿路感染	尿路感染症	尿管感染
縦隔炎再発	縦隔炎	虫垂切除後腹膜炎
前立腺肥大有	前立腺肥大症	前立腺無形成
胆嚢腫瘍	胆のう腫瘍	胆管腫瘍
胃がん	胃癌	脳炎後てんかん
左中大脳動脈梗塞	中大脳動脈塞栓症	脳外主幹動脈閉塞脳梗塞
Ｓｏｔｏｓ症候群	ソトス症候群	ＳＡＰＨＯ症候群
必要認知症	認知症	特異的会話構音障害
肝腫瘤性病変	肝腫瘤	肝腫瘤
大動脈瘤解離	解離性大動脈瘤	急性大動脈解離
挿入部出血	出血	気管切開部出血
眠前発熱	発熱	術後発熱
肺炎反復	肺炎	肺炎結核
子宮内発育不全	子宮発育不全	子宮発育不全
左眼窩内腫瘤	眼窩腫瘤	眼窩腫瘤
多発性腎梗塞	腎梗塞	多発性脳梗塞
多臓器不全状態	多臓器不全	多臓器不全
再度痙攣発作	痙攣発作	痙攣発作
変動一過性徐脈	徐脈	末梢性動静脈奇形
四肢色素沈着	皮膚色素沈着	眼瞼外傷性色素沈着
良性発作性頭位めまい	良性発作性頭位めまい症	良性発作性頭位めまい症
三角圧痛	肩部筋痛	上腕痛
両側声帯不全麻痺	声帯不全麻痺	声帯不全麻痺
舌痛	舌痛症	胸痛
肺動脈弁下狭窄	肺動脈弁下狭窄症	肺動脈弁下狭窄症
乳癌局所再発	乳癌	乳癌再発
頚椎症性神経根炎	頚椎症性神経根症	頚椎症性神経根症
痛みきつい	疼痛	涙のう瘻
両側顎下腺腫大	顎下腺肥大	顎下腺萎縮
中等度咽頭期嚥下障害	嚥下障害	術後嚥下障害
ビタミンＤ不足	ビタミンＤ欠乏症	ビタミンＤ欠乏症
日中下痢便	下痢症	食事性下痢
胸郭低形成	胸郭異常	乳頭低形成
肺スリガラス陰影	胸部異常陰影	肺ブラストミセス症
頻脈傾向変	頻脈症	発作性接合部頻拍
口蓋腫瘤	腫瘤	口蓋腫瘍
パーキンソン病関連疾患	パーキンソン病	パーキンソン病の認知症
グラム陰性桿菌菌血症	グラム陰性桿菌敗血症	グラム陰性桿菌感染症
右上肢腫脹	上肢腫脹	上肢腫脹
左肩甲骨部痛	肩甲骨痛	肩甲骨痛
開腹子宮筋腫核	子宮筋腫	壁内子宮平滑筋腫
白内障手術	白内障	白内障術後結膜炎
腫瘤残存	腫瘤	腫瘤
直腸癌Ｒａ	直腸癌	直腸Ｓ状部結腸癌
カルボプラチンアレルギー	薬物過敏症	ペニシリンアレルギー
肺原発ホジキンリンパ腫	ホジキンリンパ腫	Ｂ細胞性非ホジキンリンパ腫
循環障害	末梢循環障害	趾端循環障害
原発性空腸癌	空腸癌	原発性肺癌
右卵巣チョコレート嚢腫	チョコレートのう胞	充実性卵巣腫瘍
重度精神運動発達遅滞	混合性特異的発達障害	自閉性精神発達遅滞
左腎梗塞	腎梗塞	腎梗塞
筋緊張高く	筋強直	先天性筋緊張低下
母指潰瘍治癒遅延	皮膚潰瘍	抜歯窩治癒不全
歩行時呼吸困難感	労作時呼吸困難	夜間呼吸困難
滑液貯留	体液貯留	胸水貯留
痰症状	喀痰	症候性流涙症
腸管血流障害	末梢循環障害	腸管運動障害
発赤強い	発赤	産褥性発熱
全身性単純ヘルペスウイルス感染症	ヘルペスウイルス感染症	先天性ヘルペスウイルス感染症
冠動脈高度石灰化	冠動脈石灰化	冠動脈石灰化
劇症型腸アメーバ症	腸アメーバ症	慢性腸アメーバ症
慢性痛	慢性疼痛	慢性疼痛
不適応行動	適応障害	異常行動
心室内血栓	心室内血栓症	心室瘤内血栓症
腹膜播種結節摘出	腹膜播種	後腹膜血管肉腫
緑色痰	喀痰	赤緑色盲
冠動脈硬化	冠状動脈硬化症	冠動脈拡張
右中葉肺癌	中葉肺癌	中葉肺癌
ポンプポケット内血腫	血腫	ポンプポケット感染
血管免疫芽球型Ｔ細胞リンパ腫	血管免疫芽球性Ｔ細胞リンパ腫	血管免疫芽球性Ｔ細胞リンパ腫
腹部緊満	腹部膨満	乳房過度緊満
舌骨喉頭下垂	喉頭下垂症	披裂喉頭蓋ひだ下咽頭面癌
尿量低下	乏尿	腎血流量低下
脳梗塞症	脳梗塞	脳塞栓症
左非浸潤性乳管癌	非浸潤性乳管癌	非浸潤性乳管癌
むつかぶれ	おむつ皮膚炎	しぶり腹
水平亜脱臼	亜脱臼	反復性膝蓋骨亜脱臼
右反復性膝蓋骨脱臼	反復性膝蓋骨脱臼	反復性膝蓋骨脱臼
早期癌	癌	早期胃癌
吻合部出血	出血	気管切開部出血
子宮頸がん	子宮頚癌	子宮頚部びらん
腺扁平上皮癌	癌	肺腺扁平上皮癌
喉頭蓋サルコイドーシス	サルコイドーシス	鼻腔サルコイドーシス
結核性	結核	結核性発熱
声門部狭窄	喉頭狭窄症	先天性声門下狭窄症
両側急性硬膜外血腫	急性硬膜外血腫	急性硬膜外血腫
高レニン高血圧	高レニン性高血圧症	高レニン性高血圧症
頭蓋底髄膜腫	髄膜腫	中頭蓋窩髄膜腫
右前胸部痛	前胸部痛	前胸部痛
膵全体癌	膵癌	膵体部癌
両側血気胸	血気胸	外傷性気胸
穿刺部位出血	出血	外傷性中耳腔出血
手掌黄色腫	黄色腫症	手掌部悪性黒色腫
皮膚湿疹	湿疹	腋窩湿疹
唾石	唾石症	膝窩疣贅
非吻合部多発胆管狭窄	胆管狭窄症	尿管回腸導管吻合部狭窄
軽度肥満歴	肥満症	直腸重積症
左腎嚢胞不変	腎のう胞	肺血管狭窄症
軽度発赤腫脹	発赤	眼部外傷性腫脹
左手関節変形	変形性手関節症	手関節脱臼
蛋白尿（３＋）	蛋白尿	蛋白尿
左手首痛	手部痛	足背痛
びまん性肺胞出血	肺胞出血	びまん性肺胞傷害
続発性赤芽球癆	赤芽球ろう	常染色体劣性多発性のう胞腎
インフルエンザ菌	インフルエンザ	インフルエンザ
左舌区小細胞癌	小細胞肺癌	中葉肺大細胞癌
左足背疼痛	足背痛	腓腹部痛
成人発症Ｓｔｉｌｌ病（ＡＯＳＤ）	成人スチル病	解離性大動脈瘤ＤｅＢａｋｅｙＩＩＩａ
大球性正色素性貧血	正色素性貧血	正球性正色素性貧血
双極Ⅱ型障害	２型双極性障害	２型双極性障害
限局型全身性強皮症	全身性強皮症	全身性強皮症
右水晶体脱臼	水晶体脱臼	水晶体脱臼
心サルコイト゛ーシス	心サルコイドーシス	心サルコイドーシス
Ｓ状結腸高分化腺癌	Ｓ状結腸癌	直腸Ｓ状部結腸癌
右側頬部腫脹	頬部腫脹	頬部腫脹
右上背部痛	背部痛	胸背部痛
両下肢痛み	疼痛	上肢筋肉痛
多発海綿状血管腫	多発性海綿状血管腫	多発性海綿状血管腫
結核歴	結核	結核性喀血
ＳＭＡ浸潤	膵癌	ＭＲＳＡ肺化膿症
微小癌	癌	微細脳損傷
慢性疼痛性障害	慢性疼痛	神経障害性疼痛
高Ｃｌ血症	高クロール血症	高ＬＤＬ血症
乳頭状腺癌	癌	乳頭腺管癌
帯状疱疹ウイルス脊髄炎	ウイルス脊髄炎	ウイルス性髄膜脊髄炎
内臓播種性ＶＺＶ感染症	汎発性帯状疱疹	ＥＳＢＬ産生菌感染症
様皮疹	発疹	痂皮性膿痂疹
左帯状疱疹	帯状疱疹	胸部帯状疱疹
骨形成不全症Ⅲ型	骨形成不全症	骨形成不全症２型
高度肥満症	病的肥満症	病的肥満症
右前頭葉脳内血腫	血腫	後頭蓋窩硬膜外血腫
マルチミニコア病	マルチコア病	マルチコア病
四肢関節腫脹	関節炎	足関節腫脹
右腸骨静脈血栓症	腸骨静脈圧迫症候群	腸骨動脈血栓症
脳底動脈閉塞	脳底動脈閉塞症	小脳動脈閉塞
胸背部圧迫感	背部圧迫感	背部圧迫感
眼瞼結膜軽度貧血	貧血	眼瞼皮下血腫
子宮頸癌Ⅲｂ期	子宮頚癌	子宮筋腫術後
傍卵巣嚢胞	傍卵巣のう胞	卵巣門細胞腫
肝内腫瘤性病変	腫瘤	肝硬化性血管腫
血管性紫斑病	症候性紫斑病	血管新生性黄斑症
時々右股関節痛	股関節痛	股関節痛
ＡＳＤ	心房中隔欠損症	ＡＩＤＳ
緑膿菌肺感染症	緑膿菌肺炎	緑膿菌感染症
母子感染歴	母子感染	母子感染
ふらつきあり転倒リスク高い	めまい	骨粗鬆症・大腿部病的骨折あり
頸腕症候群	頚肩腕症候群	頚肩腕症候群
食道癌術後リンパ節転移	リンパ節転移	胸骨傍リンパ節転移
亜急性期小脳梗塞	小脳梗塞	陳旧性小脳梗塞
喘息コントロール	咳喘息	足関節後方インピンジメント症候群
右膝違和感	全身違和感	腓腹部痛
腓骨神経麻痺徴候	腓骨神経麻痺	腓骨神経麻痺
中高分化型腺癌	癌	肺未分化癌
軽度脳梗塞	脳梗塞	多発性脳梗塞
身体外傷	外傷	頭部外傷
心源性塞栓症	心原性脳塞栓症	心原性脳塞栓症
左上腕骨近位端骨折	上腕骨近位端骨折	上腕骨近位端粉砕骨折
神経根性痛	疼痛	神経痛性歯痛
白色壊死組織付着	壊死	鼻部外傷性色素沈着
夜間中途覚醒	睡眠障害	銀杏中毒
軽度肺動脈弁狭窄	肺動脈弁狭窄症	肺動脈弁狭窄症
転移性肝癌術後再発	転移性肝癌	直腸癌術後再発
無涙症	涙液分泌不全	無舌症
劇症Ａ型肝炎	Ａ型劇症肝炎	Ａ型劇症肝炎
ｃｒｉｔｉｃａｌ　ｉｌｌｎｅｓｓ　ｐｏｌｙｎｅｕｒｏｐａｔｈｙ	多発ニューロパチー	Ｅｕｔｈｙｒｏｉｄ　Ｓｉｃｋ症候群
右眼増殖性糖尿病網膜症	増殖性糖尿病性網膜症	増殖性糖尿病性網膜症
右上腕腫脹	上腕部腫脹	上腕部腫脹
右側胸水貯留	胸水貯留	胸水貯留
水疱瘡	水疱症	天疱瘡
軽度高Ｋ血症	高カリウム血症	高銅血症
肝性脳症再発	肝性脳症	肝性脳症
水様便流出	下痢症	尿溢出
二絨毛膜二羊膜性双胎第	二絨毛膜二羊膜性双胎	二絨毛膜二羊膜性双胎
浮腫傾向	浮腫	出血傾向
骨Ｐａｇｅｔ病	骨パジェット病	ＲＳ３ＰＥ症候群
Ｅｎｔａｍｏｅｂａ　ｈｉｓｔｏｌｙｔｉｃａ	アメーバ赤痢	ＣＡＲＡＳＩＬ
左頚部内頸動脈狭窄	内頚動脈狭窄症	外腸骨動脈狭窄
大腿筋横紋筋肉腫	横紋筋肉腫	大腿横紋筋肉腫
腸炎性関節炎	関節炎	淋菌性関節炎
ＰＭＳ	月経前症候群	ウール病
腓腹部圧痛	腹部圧痛	腓腹部痛
非チフス性Ｓａｌｍｏｎｅｌｌａ菌血症	菌血症	ＴＥＬ−ＡＭＬ１陽性Ｂリンパ芽球性白血病
微小多発肝膿瘍	肝膿瘍	多発性肝膿瘍
卵管狭窄	卵管狭窄症	涙小管狭窄
胸部大動脈解離	急性大動脈解離	腹腔動脈解離
蜂窩織炎発症	蜂窩織炎	胃蜂窩織炎
輪状披裂関節炎	関節炎	前腕部腱鞘炎
左下肢蜂窩織炎	下肢蜂巣炎	胃蜂窩織炎
肺塞栓	肺塞栓症	肺塞栓症
咽頭残留	嚥下障害	咽頭腐蝕
低髄圧症状	低髄液圧症	低髄液圧症
左腓骨開放骨折	腓骨開放骨折	脛骨腓骨開放骨折
大量水様下痢	下痢症	急性羊水過多症
処方右乳癌	乳癌	術後残胃胃炎
症候性けいれん	症候性てんかん	症候性てんかん
低血糖回避	低血糖	低血糖発作
左慢性閉塞隅角緑内障	慢性閉塞隅角緑内障	慢性閉塞隅角緑内障
弧発性古典的ＣＪＤ	孤発性クロイツフェルト・ヤコブ病	非特異的ＳＴ−Ｔ変化
呼吸機能低下	呼吸機能検査異常	腎機能低下
右大腿リンパ節転移	リンパ節転移	頚部リンパ節転移
左第３趾潰瘍	趾皮膚潰瘍	趾中節骨腫瘍
足変形	足部変形	手変形
膝関節水腫	膝関節水症	肘関節水腫
腹部瘢痕ヘルニア	腹壁瘢痕ヘルニア	腹壁瘢痕ヘルニア
月経困難	月経困難症	月経困難症
左局所進行乳癌	進行乳癌	胃進行癌
好酸球性胆嚢炎	胆のう炎	好酸球性胃腸炎
左下腿骨幹部骨折	骨折	大腿骨骨幹部骨折
即時型アレルギー	アレルギー	食物アレルギー
ふらつき有	めまい	そとわ歩行
ループス腎炎Ｖ型	ループス腎炎	ループス胸膜炎
閉塞性睡眠時無呼吸症侯群	睡眠時無呼吸症候群	睡眠時無呼吸症候群
右下肢しびれ	下肢しびれ	四肢しびれ
頭部脂漏性皮膚炎	脂漏性皮膚炎	脂漏性皮膚炎
結核性ブドウ膜炎	結核性ぶどう膜炎	結核性角膜炎
左真珠腫性中耳炎再発	真珠腫性中耳炎	真珠腫性中耳炎
傍大動脈ＬＮ転移	大動脈周囲リンパ節転移	両大血管右室起始症
痙直型四肢麻痺	四肢麻痺	痙性四肢麻痺
角化性紅斑散在	紅斑症	滲出型加齢黄斑変性
労作時呼吸苦自覚	労作時呼吸困難	労作時呼吸困難
慢性腎炎	慢性腎炎症候群	慢性膵炎
間質性肺炎像	間質性肺炎	間質性肺炎
嘔気様	嘔気	嘔気
左側頭葉皮質化出血	出血	顔面多発皮下出血
左上腕骨開放骨折	上腕骨開放骨折	上腕骨開放骨折
腹部膨満継続	腹部膨満	腹部腫脹
右足底腱膜炎	足底筋膜炎	腓骨骨髄炎
両側顎関節症	顎関節症	顎関節症
出血性黄体	出血性黄体のう胞	出血性貧血
右鼡径部疼痛	鼡径部痛	鼡径部腫脹
高～中分化型管状腺癌	癌	正中型口腔底癌
Ｌａｍｉｖｕｄｉｎｅ耐性Ｂ型肝硬変	Ｂ型肝硬変	ＢＣＲ−ＡＢＬ１陽性Ｂリンパ芽球性白血病
遺伝性腎炎	家族性腎炎	遺伝性膵炎
湿疹化	湿疹	汗疹湿疹化
左大腿部蜂窩織炎	大腿部蜂巣炎	大腿横紋筋肉腫
下肢対麻痺	対麻痺	下肢麻痺
成長発達遅滞	発達遅滞	発達遅滞
下腿点状出血	点状出血	大腿部皮下出血
脈管奇形	奇形	神経管奇形
手指欠損	手指欠損症	手指欠損症
咽頭粘膜軽度発赤	咽頭発赤	咽頭発赤
可動時痛	疼痛	常習性吃逆
下垂手	垂れ手	手足口病
左陰嚢内容腫大	陰のう腫大	眼周囲部外傷性腫脹
痰がからみ	喀痰	ころもじらみ寄生症
朝出血	出血	橋出血
右鼠経ヘルニア修復術	鼡径ヘルニア	術後食道裂孔ヘルニア
ステロイド骨粗鬆症	ステロイド性骨粗鬆症	ステロイド性骨粗鬆症
足趾冷感	下肢冷感	下肢冷感
不整腫瘤	腫瘤	腋窩腫瘤
腎前性脱水	脱水症	外傷性前房出血
左肩部痛	肩部痛	肩部痛
頸部皮下膿瘍	皮膚膿瘍	頭部皮下腫瘍
ウイルス性感冒	感冒	ウイルス性中毒疹
多発腫大リンパ節	リンパ節腫大	限局性リンパ節腫大
腹部自発痛	腹痛症	腹部圧痛
中分化型前立腺癌	前立腺癌	進行性前立腺癌
左一側性形成不全性股関節症	一側性形成不全性股関節症	一側性形成不全性股関節症
好酸球性気道炎症	好酸球性気管支炎	好酸球性食道炎
腸管蠕動障害	腸管運動障害	腸管運動障害
褥瘡形成リスク高い	褥瘡	ステロイド性骨粗鬆症・病的骨折あり
腰椎変性辷り症	腰椎変性すべり症	腰椎変性すべり症
手術高血圧	高血圧症	術中低血圧
嚥下下困難	嚥下障害	嚥下困難
てんかん脳波	異常脳波	脳炎後てんかん
巨大血腫	血腫	巨大産道血腫
十二指腸原発神経内分泌腫瘍	十二指腸神経内分泌腫瘍	十二指腸神経内分泌腫瘍
腹水多量貯留	腹水症	胸水貯留
内腸骨リンパ節転移	腸骨リンパ節転移	腸骨リンパ節転移
ＣＭＶ胃腸炎	サイトメガロウイルス腸炎	中等症潰瘍性大腸炎
瘢痕痙性	瘢痕	心因性腟痙
両Ｔ字杖歩行	歩行障害	内転歩行
便性状変化	便異常	小局面状類乾癬
右血栓閉塞	血栓塞栓症	脳血管閉塞性脳梗塞
出血付着程度	出血	流行性出血熱
右海綿静脈洞髄膜腫	髄膜腫	頭頂葉静脈性血管腫
虚血性心疾患合併	虚血性心疾患	心室内血栓症・急性心筋梗塞に合併
壊死性筋炎	筋炎	壊死性筋膜炎
全肺腫瘍	肺腫瘍	肺炎合併肺膿瘍
軽度構音障害	構音障害	構音障害
両下腿紅斑	紅斑症	下腿扁平母斑
低Ｃａ血症	低カルシウム血症	高ＩｇＡ血症
二次性副腎不全	副腎クリーゼ	急性腎前性腎不全
一週間程度眠気	非器質性過眠症	閉塞性睡眠時無呼吸
子宮内腔癒着	子宮内膜症	子宮頚部癒着
項部硬直軽度	項部硬直	項部硬直
下熱	発熱	高熱
右母指陳旧性尺側側副靱帯損傷	靱帯損傷	陳旧性中指側副靱帯損傷
左気管支狭窄	気管支狭窄症	膵管狭窄
皮膚型ＰＮ	結節性多発動脈炎	環指皮膚癌
肺線維化	肺線維症	肺線維症
副鼻腔軽度粘膜肥厚	副鼻腔炎	副鼻腔軟骨肉腫
味覚異常Ｇｒ１	味覚異常	味覚異常
中心視野欠損	視野欠損	視野欠損
昨晩低血糖	低血糖	夜間低血糖症
両水腎症	両側水腎症	両側水腎症
前回貧血	貧血	術後貧血
骨粗鬆症性圧迫骨折	骨粗鬆症・病的骨折あり	肋骨不顕性骨折
右肺原発肺腺癌	肺腺癌	肺腺癌
脊髄原発悪性リンパ腫	悪性リンパ腫	精巣悪性リンパ腫
手指浮腫	浮腫	手指腫脹
口内炎再発	口内炎	慢性中耳炎術後再燃
皮質性認知症	皮質下認知症	皮質認知症
足背発赤	発赤	発赤
後縦隔腫瘤	縦隔腫瘍	後縦隔腫瘍
頚椎症性脊椎症	脊椎症	頚椎症性脊髄症
中部延髄右外側脳梗塞	脳梗塞	脳外主幹動脈閉塞脳梗塞
仙骨部瘻孔	難治性瘻孔	仙骨部褥瘡
軽鎖沈着症	単クローン性軽鎖重鎖沈着症	単クローン性軽鎖重鎖沈着症
右傍気管リンパ節転移	リンパ節転移	肺門リンパ節転移
ｓｍａｌｌ　ｃｅｌｌ　ｃａｒｃｉｎｏｍａ	癌	ＣＡＲＡＳＩＬ
遺伝性出血性毛細血管拡張症	オスラー病	特発性傍中心窩毛細血管拡張症
胸椎後縦靭帯骨化症	胸椎後縦靱帯骨化症	胸椎後縦靱帯骨化症
重症敗血症性ショック	敗血症性ショック	敗血症性ショック
間質性肺炎評価	間質性肺炎	通常型間質性肺炎
右腎損傷	腎損傷	副腎損傷
右肺門部原発	原発性肺癌	先天性殿部奇形
再発食道癌	食道癌	早期食道癌
不定愁訴多い	不定愁訴症	骨粗鬆症・多発病的骨折あり
発熱再燃	発熱	突発性発熱
左肩関節痛	肩関節痛症	肘関節痛
瘢痕様変化	瘢痕	潜函病性骨壊死
元々頻尿	頻尿症	流産後乏尿
浮腫対策	浮腫	腹部腫瘤
核下性顔面神経麻痺	顔面神経麻痺	末梢性顔面神経麻痺
皮膚原発悪性リンパ腫	悪性リンパ腫	原発性皮膚濾胞中心リンパ腫
市中感染型ＭＲＳＡ	ＭＲＳＡ感染症	ＨＴＬＶ−１感染症
左尿管結石	尿管結石症	鼻涙管結石
乾性咳嗽頻回	乾性咳	乾性咳
首痛	頚部痛	頭痛
右側頭部紫斑	紫斑病	側頭部母斑
薬剤過敏性症候群	薬物過敏症	薬剤性過敏症症候群
延長症候群	ＱＴ延長症候群	ＱＴ延長症候群
紫斑形成軽度	紫斑病	重症多形滲出性紅斑・急性期
両側肺動脈狭窄症	肺動脈狭窄症	肺動脈狭窄症
子宮筋腫核出後妊娠	妊娠	子宮筋層内妊娠
ＡＲＤＳ合併	急性呼吸窮迫症候群	ＣＡＤ／ＣＡＭ冠脱離
胆道系閉塞	胆道閉塞	胆道閉塞
軟骨損傷	肋軟骨損傷	肋軟骨損傷
右副腎原発	副腎腫瘍	上部心臓型総肺静脈還流異常症
ｋｌｅｂｓｉｅｌｌａ　ｐｎｅｕｍｏｎｉａｅ感染症	クレブシェラ属感染	Ｅｕｔｈｙｒｏｉｄ　Ｓｉｃｋ症候群
パ−キンソン症候群	パーキンソン症候群	パーキンソン症候群
右原発性肺癌	原発性肺癌	原発性肺癌
敗血症性ショック状態	敗血症性ショック	敗血症性ショック
時々発疹	発疹	発疹
めまい軽度	めまい	突発性めまい
右横隔膜筋欠損	筋欠損	横隔膜欠損
脳症後遺症	脳症	脳炎後遺症
胸膜悪性中皮腫	悪性胸膜中皮腫	悪性胸膜中皮腫
漿膜損傷	損傷	硬膜損傷
頸椎症性	頚椎症	頚椎症性脊髄症
多発外傷	多発性外傷	多発性外傷
皮膚損傷起	皮膚損傷	皮膚損傷
ふらつき目立	めまい	顔面せつ
近位筋痛	筋肉痛	神経痛性頭痛
採血上脱水	脱水症	採卵後腹腔内出血
脳血管芽腫	小脳血管芽腫	小脳血管芽腫
右慢性中耳炎	慢性中耳炎	慢性中耳炎
アレルギー様	アレルギー	アレルギー
ノカルジア脳膿瘍	ノカルジア症	肺ノカルジア症
大腸ポリープ有	大腸ポリープ	大腸ポリープ
右後頭部帯状疱疹	後頭部帯状疱疹	後頭部帯状疱疹
右頚部結核性リンパ節炎	結核性リンパ節炎	頚部化膿性リンパ節炎
陳旧性多発アテローム血栓性脳梗塞	陳旧性アテローム血栓性脳梗塞	二次性糖尿病・末梢循環合併症あり
誤嚥徴候	異物誤嚥	先天性盲係蹄症候群
右前腕皮疹	発疹	前腕皮膚線維腫
多発肺腫瘤	肺腫瘤	肺腫瘤
後腹膜浸潤	後腹膜悪性腫瘍	後腹膜線維肉腫
網状紫斑	紫斑病	網状皮斑
胚細胞腫瘍	腫瘍	脳胚細胞腫瘍
ゲノタイプ１ｂ型Ｃ型肝硬変	Ｃ型肝硬変	ＥＧＦＲ遺伝子変異陽性非小細胞肺癌
類円形腫大	リンパ節腫大	小脳虫部腫瘍
中枢性気管支拡張像	気管支拡張症	先天性血管拡張性大理石様皮斑
小股歩行	歩行異常	内転歩行
脳血管傷害	脳血管障害	腎血管損傷
糖尿病末梢神経障害	糖尿病性単ニューロパチー	糖尿病性末梢神経障害
ルンバール後頭痛	腰椎穿刺後頭痛	ドゥ・ケルバン腱鞘炎
急性重症Ｂ型肝炎	Ｂ型肝炎	重症急性膵炎
下垂時疼痛	疼痛	下肢関節痛
頚部蜂窩織炎	頚部蜂巣炎	胃蜂窩織炎
腹満不変	腹部膨満	不安緊張状態
一過性心筋虚血	心筋虚血	一過性脊髄虚血
日勤帯発熱	発熱	会陰第１度熱傷
結核性喉頭狭窄	喉頭狭窄症	先天性喉頭狭窄症
両側鼻内ポリープ	鼻茸	後鼻孔ポリープ
手掌潮紅	紅潮	手切創
低血糖歴何年	低血糖	若年高血圧症
離床時眩暈	めまい	尋常性疣贅
高齢者Ｃ型慢性肝炎	Ｃ型慢性肝炎	Ｃ型慢性肝炎
ＳＬＥ発症	全身性エリテマトーデス	ＳＬＥ母体児
軽度咽頭違和感	咽頭異常感症	肛門部違和感
体熱感	不明熱	眼球熱傷
悪性腫瘍評価	悪性腫瘍	悪性腫瘍
発赤領域	発赤	頭蓋内占拠性病変
閉塞性大腸癌	大腸癌	閉塞性大腸炎
子宮頚部ポリープ	子宮頚管ポリープ	子宮頚管ポリープ
両側大腰筋血腫	血腫	大腿横紋筋肉腫
ＰＳＬＮ転移	大動脈周囲リンパ節転移	ＲＳ３ＰＥ症候群
咽頭部疼痛	咽頭痛	舌咽神経痛
肺腫瘍塞栓症	肺腫瘍	肺血栓塞栓症
羊水過多	羊水過多症	羊水過多症
筋肉痛症状	筋肉痛	甲状腺中毒症性筋無力症候群
心外膜石灰化	心膜石灰化	心膜石灰化
右下肢急性動脈閉塞症	下肢急性動脈閉塞症	下肢急性動脈閉塞症
４型進行胃癌	胃進行癌	胃進行癌
圧迫性脊髄症	脊髄症	脊髄圧迫症
出血源不明	出血	原因不明の死亡
貧血性網膜症	貧血網膜症	貧血網膜症
椎間板突出	椎間板症	胸部椎間板断裂
カルチノイド腫瘍	カルチノイド	胸腺カルチノイド
心臓内腫瘤	腫瘤	心内膜腫瘍
日中気分不快	悪心	夜間呼吸困難
多発性嚢胞肝	多発性肝のう胞	多発性肝膿瘍
仙骨奇形	仙骨部奇形	仙骨部奇形
けいれん再発	痙攣	らせん骨折
遊走性静脈炎	遊走性血栓性静脈炎	遊走性血栓性静脈炎
左胸膜炎	胸膜炎	胸膜炎
直腸癌術後異時性肝転移	転移性肝癌	直腸癌骨転移
手指痺れ	しびれ感	手指脱疽
左卵管水腫	卵管留水症	卵管留血腫
歩行時呼吸困難	労作時呼吸困難	夜間呼吸困難
ガーゼ出血	出血	ガレン静脈奇形
老人性紅皮症	紅皮症	老人性乾皮症
右被殻脳梗塞	被殻出血	片頭痛性脳梗塞
自律神経ニューロパチー	自律神経性ニューロパチー	自律神経性ニューロパチー
子宮頚部嚢胞	子宮頚部腫瘍	子宮頚部腫瘍
右原発閉塞隅角緑内障	原発閉塞隅角緑内障	原発閉塞隅角緑内障
腺腫内癌	癌	大腸腺腫内癌
両下肢浮腫軽度	下肢浮腫	下肢浮腫
右化膿性肩関節炎	化膿性関節炎・肩関節	肩関節硬結性腱炎
膣転移	腟癌	胃癌骨転移
体力低下著明	体力低下	術後吸収不良性骨粗鬆症・病的骨折あり
左小脳陳旧性梗塞	陳旧性脳梗塞	陳旧性小脳梗塞
淡黄色粘稠痰	喀痰	赤緑色弱
外傷所見	外傷	外傷
発赤局面	発赤	心濁音界縮小
膀胱癌既往	膀胱癌	転移性膀胱癌
左末梢性肺動脈狭窄	肺動脈狭窄症	末梢性肺動脈狭窄症
骨代謝異常	代謝障害	脂質代謝異常
心陰影拡大	胸部異常陰影	心拡大
腎動脈下腹部大動脈瘤	腹部大動脈瘤	胸腹部大動脈瘤
腸管壁内気腫	皮下気腫	気管内肉芽腫
慢性活動性ＥＢＶ感染症	ＥＢウイルス感染症	急性ＨＩＶ感染症候群
足関節圧痛	関節痛	足関節痛
夕方発熱	発熱	発熱
顔面紅班	紅斑症	顔面紅潮
排便痛	排便障害	排尿痛
左水腎	水腎症	腎瘻
代謝異常	代謝障害	脂質代謝異常
両下肢リンハ゜浮腫	下肢リンパ浮腫	下肢浮腫
左頸部ＬＮ腫脹	肘リンパ節腫脹	前胸部腫脹
肺門部リンパ節腫脹	リンパ節腫大	肺門リンパ節腫脹
呼吸困難感軽度	呼吸麻痺	呼吸困難
左膝窩動脈血栓症	動脈血栓症	内頚動脈血栓症
左股関節脱臼	股関節脱臼	股関節脱臼
ルーフ゜ス腎炎	ループス腎炎	ループス腎炎
鼠径部腫脹	鼡径部腫脹	鼡径部腫脹
内鼠径ヘルニア	内鼡径ヘルニア	胸骨傍ヘルニア
左頬部血管腫	頬部血管腫	頬部血管腫
開口制限	開口不全	開排制限
変形性関節炎	変形性関節症	変形性関節症
初回歩行時ふらつき	よろめき歩行	小刻み歩行
洞性頻脈	洞頻脈	洞頻脈
腹膜播種巣	腹膜播種	腹膜播種
アレルギ—性結膜炎	アレルギー性結膜炎	アレルギー性結膜炎
鼠径部血腫	血腫	鼡径部腫瘍
暗赤色嘔吐	嘔吐症	脳性嘔吐
直腸癌ＯＰ	直腸癌	直腸癌
左増殖性糖尿病網膜症	糖尿病網膜症	増殖性糖尿病性網膜症
レム睡眠行動異常	異常行動	レム睡眠行動障害
左大腿有棘細胞癌	大腿有棘細胞癌	大腿有棘細胞癌
声帯癌	声門癌	声帯炎
左大腿部疼痛	大腿痛	大腿部腫脹
右顎関節症	顎関節症	顎関節症
骨頭壊死	骨壊死	骨壊死
中枢神経浸潤	中枢神経系損傷	中枢神経系損傷
直腸皮下瘻孔	難治性瘻孔	直腸肛門周囲膿瘍
胆嚢腫大	胆のう肥大	胆管腫瘍
Ｈｅｅｒｆｏｒｄｔ症候群	ぶどう膜耳下腺熱	ＶＡＴＥＲ症候群
前立腺癌既往	前立腺癌	前立腺癌再発
ダグラス窩腹水	腹水症	ダグラス窩膿瘍
失見当障害	見当識障害	構語障害
ツツガムシ感染症	つつが虫病	ブタクサ花粉症
特発性血小板減少症紫斑病	特発性血小板減少性紫斑病	特発性血小板減少性紫斑病
前立腺浮腫	浮腫	前立腺肉腫
胞性腫瘤	腫瘤	化膿性腫瘤
右鼠径リンパ節腫脹	鼡径部リンパ節腫脹	鼡径部リンパ節腫脹
ＡＡＡ破裂	腹部大動脈瘤	ＣＡＤ／ＣＡＭ冠破損
夜間覚醒	不眠症	広場恐怖症
初発癌	癌	初期硬結
右迷走神経鞘腫	神経鞘腫	馬尾神経鞘腫
痙攣様	痙攣	痙攣
機会誤嚥	嚥下障害	異物誤嚥
大腿静脈血栓	静脈血栓症	大腿血栓性静脈炎
股関節部骨折	股関節骨折	股関節骨折
吸収不全症侯群	吸収不良症候群	吸収不良症候群
新生血管緑内障	緑内障	血管新生緑内障
甲状腺低下症	甲状腺機能低下症	甲状腺機能低下症
アメーバ肝膿瘍	肝アメーバ症	アメーバ性肝膿瘍
先天性真珠腫	真珠腫	先天性脳腫瘍
頭部皮膚欠損	頭部皮膚欠損創	頭部皮膚欠損創
右肺門部浸潤影	胸部異常陰影	肺門部異常陰影
食道悪性腫瘍	食道癌	食道良性腫瘍
傍大動脈リンパ節転移	大動脈周囲リンパ節転移	大動脈周囲リンパ節転移
ビタミンＤ欠乏	ビタミンＤ欠乏症	ビタミンＤ欠乏症
レントゲン異常	胸部異常陰影	フィブリノゲン異常症
器質的心疾患	心疾患	遺伝性心疾患
温痛覚	温痛覚過敏	温痛覚過敏
両側内反足	内反足	内反足
低酸素症状	低酸素性脳症	低酸素血症
粘稠痰少量	喀痰	細動脈硬化性萎縮腎
ダンベル型腫瘍	腫瘍	セルトリ・ライディック細胞腫
催不整脈作用	不整脈	抗不整脈剤副作用
左腋窩汗腺癌	汗腺癌	腋窩皮膚癌
感染性仮性嚢胞	仮性膵のう胞	感染性角膜潰瘍
乳房熱感	ほてり	乳房熱傷
大腸穿孔	腸穿孔	小腸穿孔
腎瘢痕	瘢痕	胸膜瘢痕
孤立性左室緻密化障害	孤立性心筋緻密化障害	孤立性心筋緻密化障害
進行性顔面片側萎縮症	顔面痙攣症	顔面半側萎縮症
左手関節痛	手関節痛	手関節痛
右鼠径部腫脹	鼡径部腫脹	前胸部腫脹
びりびりしたしびれ	しびれ感	半身しびれ
発赤軽減	発赤	原発性陣痛微弱
悪寒等	悪寒	悪寒
非逆流性食道炎	食道炎	逆流性食道炎
甲状腺萎縮	後天性甲状腺萎縮	後天性甲状腺萎縮
呼吸苦自覚症状	呼吸困難	呼吸性嗅覚障害
多発単神経障害	多発性単ニューロパチー	多発性神経障害
中毒性	中毒	中毒性精神病
右肺上葉結節影	胸部異常陰影	上行結腸憩室穿孔
骨膜肥厚	肥厚性皮膚骨膜症	滑膜肥厚
リステリア感染症	リステリア症	リステリア性敗血症
アルコール性脂肪性肝炎	アルコール性脂肪肝	非アルコール性脂肪性肝炎
脳室穿破	脳出血	腸憩室穿孔
鼠径部リンパ節腫大	鼡径部リンパ節腫脹	鼡径部リンパ節腫脹
吐気治	嘔気	術中頻脈発作
右鼡径部リンパ節腫脹	鼡径部リンパ節腫脹	鼡径部リンパ節腫脹
多発肺塞栓	肺塞栓症	多発性脳梗塞
右腋窩リンパ節転位	腋窩リンパ節転移	腋窩リンパ節転移
重度右片麻痺	片麻痺	同側性片麻痺
両側乳房腫瘤	乳房腫瘤	乳房乳頭部腫瘤
原発不明癌頸部リンパ節転移	頚部リンパ節転移	胸骨傍リンパ節転移
後腹膜脂胞肉腫	後腹膜脂肪肉腫	後腹膜脂肪肉腫
胆管閉塞機転	胆管閉塞症	内腸骨動脈閉塞症
右下葉原発扁平上皮癌	下葉肺扁平上皮癌	下葉肺扁平上皮癌
腰椎圧迫骨折既往	腰椎圧迫骨折	胸腰椎圧迫骨折
便秘悪化	便秘症	便秘症
潜血３	顕微鏡的血尿	血友病Ａ
アレルギー性血管浮腫	浮腫	アレルギー性浮腫
肺動脈分岐部狭窄	肺動脈分岐部狭窄症	肺動脈分岐部狭窄症
顕微的血尿	血尿	顕微鏡的血尿
右鼡径リンパ節腫脹	鼡径部リンパ節腫脹	鼡径部リンパ節腫脹
左足多趾症	多趾症	多合趾症
日中痛み	疼痛	七日熱
不安感	不安障害	不安障害
眼球運動痛	疼痛	眼球運動痙攣
腰椎変性側弯症	腰椎側弯症	腰椎側弯症
右腎低形成	低形成腎	右心低形成症候群
Ｙｅｒｓｉｎｉａ　ｅｎｔｅｒｏｃｏｌｉｔｉｃａ感染症	エルシニア菌食中毒	ＭＲＣＮＳ感染症
膿胸合併肺放線菌症	肺放線菌症	肺放線菌症
チクチク痛む	チクチク感	ネマリンミオパチー
左水尿管症	水尿管症	水腎水尿管症
多発肺内転移	転移性肺癌	多発性癌転移
左下葉肺癌断端再発	下葉肺癌	腸重積症再発
右大腿部発赤	下腿発赤	下腿発赤
右顔面打撲	顔面打撲傷	脛骨腓骨近位端開放骨折
糖尿病性自律神経障害	糖尿病性自律神経ニューロパチー	糖尿病性末梢神経障害
分破水	破水	破水
重症マイコプラズマ肺炎	マイコプラズマ肺炎	マイコプラズマ肺炎
卵巣嚢腫破裂	卵巣のう腫破裂	卵巣腫瘍破裂
抗原血症	サイトメガロウイルス感染症	非結核性抗酸菌症
褥瘡発症	褥瘡	褥瘡感染
甲状軟骨浸潤	甲状軟骨の悪性腫瘍	甲状軟骨欠損
潜在性副腎皮質機能低下症	副腎皮質機能低下症	続発性副腎皮質機能低下症
眼球陷凹	眼球陥没	瞼裂縮小
両足趾潰瘍	趾皮膚潰瘍	足底皮膚潰瘍
過換気症状	過換気症	過換気症
左鎖骨下リンパ節転移	リンパ節転移	鎖骨上リンパ節転移
上右卵管留血腫	卵管留血腫	卵管留血腫
濾胞性リンパ腫再発	濾胞性リンパ腫	濾胞性リンパ腫
両眼糖尿病性網膜症	糖尿病網膜症	糖尿病性中心性網膜症
左外傷性大腿骨頭壊死	外傷性大腿骨頭壊死	外傷性大腿骨頭壊死
肝臓病変	肝疾患	肝炎後肝硬変
右第１趾潰瘍	趾皮膚潰瘍	第５趾皮膚癌
腋窩痛	腋窩部痛	腋窩部痛
踵部発赤	発赤	下腿発赤
両側ぶどう膜炎	ぶどう膜炎	中間部ぶどう膜炎
右アスペルギルス肺炎	肺アスペルギルス症	肺アスペルギルス症
痔疾患	痔核	咀嚼筋痛障害
無疱疹帯状疱疹	帯状疱疹	劇症帯状疱疹
吐き気軽度	嘔気	吐物嚥下性肺炎
非結核性抗酸菌性人工関節感染症	非結核性抗酸菌症	非結核性抗酸菌性股関節炎
両下肢不随意運動	不随意運動症	異常不随意運動
前胸痛	胸痛	前腕痛
洞結節不全症候群	洞不全症候群	洞不全症候群
結腸皮膚瘻	皮膚瘻	直腸皮膚瘻
患肢熱感	ほてり	眼熱傷後遺症
両側腎膿瘍	腎膿瘍	腎周囲膿瘍
右喉頭腫瘍	喉頭腫瘍	喉頭腫瘍
潜血	顕微鏡的血尿	便潜血
細菌性脳動脈瘤破裂	脳動脈瘤破裂	先天性脳動脈瘤破裂
右鼡径部皮下出血	皮下出血	前額部皮下出血
右下腿筋肉内出血	筋肉内血腫	大腿部皮下出血
痒感	そう痒	痒疹
大動脈リンパ節転移	大動脈周囲リンパ節転移	大動脈周囲リンパ節転移
心内血栓	心内血栓症	心内血栓症
術後出血	後出血	術後貧血
気分悪	悪心	悪心
腰部脊椎管狭窄症	腰部脊柱管狭窄症	腰部脊柱管狭窄症
遠位弓部嚢状動脈瘤	動脈瘤	内頚動脈後交通動脈分岐部動脈瘤
左総腸骨動脈狭窄	総腸骨動脈狭窄	総腸骨動脈狭窄
尿潜血遷延	顕微鏡的血尿	遷延分娩
夜間悪寒	悪寒	悪寒発熱
造骨性骨転移	骨転移癌	骨盤転移
腫瘍制御	腫瘍	腫瘍崩壊症候群
失調性構音障害	構音障害	機能性構音障害
右上腕骨頸部骨折	上腕骨頚部骨折	上腕骨頚部骨折
リンハ゜節腫大	リンパ節腫大	鼡径部リンパ節腫脹
皮疹拡大傾向	発疹	出血傾向
依然浮腫	浮腫	限局性浮腫
右足底部蜂窩織炎	足蜂巣炎	足関節部蜂巣炎
血栓閉塞型大動脈解離	早期血栓閉鎖型大動脈解離	早期血栓閉鎖型大動脈解離
急性期脳血管障害	脳血管障害	閉塞性脳血管障害
朝方痰	喀痰	夜間咳
進行性直腸癌	直腸癌	進行性前立腺癌
小腸型クローン病	小腸クローン病	小腸クローン病
軽度すりガラス影	胸部異常陰影	ペースメーカ植え込み後皮膚圧迫壊死
二次性血小板増多症	血小板増加症	二次性血小板増加症
胃膵嚢胞	膵のう胞	膵腺房細胞癌
最近浮腫	浮腫	限局性浮腫
右顔面疼痛	顔面痛	顔面腫脹
便失禁多量	便失禁	便失禁
労作時頻脈	頻脈症	労作時呼吸困難
両下肢結節性紅斑	結節性紅斑	多形紅斑性関節障害
重症胆管炎	胆管炎	総胆管結石性胆管炎
右側胸部痛	胸痛	側胸部痛
右小指基節骨骨折	小指基節骨骨折	小指基節骨骨折
右足背腫脹	足背腫脹	足背腫脹
右上肢発赤	発赤	下腿発赤
呂律のまわりにくさ	構音障害	会陰部せつ
アミオダロン誘発性甲状腺中毒症	薬剤性甲状腺機能障害	薬物誘発性男性ホルモン性脱毛症
左胸部痛	胸痛	前胸部痛
右大腿痛	大腿痛	大腿筋痛
左下腿ＤＶＴ	下腿静脈血栓症	大腿骨骨幹部開放性粉砕骨折
動悸等症状	動悸	蠕動亢進
紫斑	紫斑病	白斑
致死性不整脈出現	不整脈	期外収縮性不整脈
顆粒膜細胞腫	卵巣顆粒膜細胞腫	卵巣顆粒膜細胞腫
一瞬痛み	疼痛	七日熱
意識障害患者	意識障害	意識障害
切迫早産腹緊	切迫早産	切迫早産
難治性皮膚非定型抗酸菌症	非結核性抗酸菌症	皮膚非結核性抗酸菌症
頚部鈍痛	鈍痛	頚部痙直
発赤範囲	発赤	咽頭発赤
左腕腫脹	前腕腫脹	前腕腫脹
右肺上葉陰影	胸部異常陰影	肺門部異常陰影
右上葉肺結節	結節性肺結核	中葉肺扁平上皮癌
空腹時高血糖	高血糖症	妊娠中一過性高血圧症
右麻痺	片麻痺	外直筋麻痺
味覚変化	味覚障害	味覚消失
器質化肺炎	特発性器質化肺炎	特発性器質化肺炎
浮腫悪化	浮腫	黄斑部術後浮腫
凝固異常症	血液凝固異常	軟骨形成異常症
右側頭葉脳梗塞	脳梗塞	急性下側壁心筋梗塞
両側下顎骨折	下顎骨骨折	上下顎骨骨折
左頭頂葉神経膠腫	頭頂葉神経膠腫	頭頂葉神経膠腫
骨盤内多発リンパ節転移	骨盤内リンパ節転移	骨盤内リンパ節転移
直腸閉塞	直腸閉鎖	結腸閉塞
運動ニューロン病	運動ニューロン疾患	運動ニューロン疾患
肺犬糸状虫症	犬糸状虫症	犬糸状虫症
軽度骨棘	骨棘	骨性強直
疲労感少	疲労感	疲労感
多発性肝腫瘤	肝腫瘍	多発性肝血管腫
意味性錯語	文意失語症	文意失語症
ｃｏａｒｓｅ　ｃｒａｃｋｌｅｓ	湿性ラ音	ＣＡＲＡＳＩＬ
緑色下痢便	下痢症	習慣性下痢
皮膚損傷リスク	皮膚損傷	皮膚損傷
左母指痛	母指痛	母指痛
ＡＶブロック	房室ブロック	洞房ブロック
前縦隔ＬＮ転移	縦隔リンパ節転移	ＭＲＳＡ術後創部感染
間質性肺炎発症	間質性肺炎	特発性間質性肺炎
外側脱臼	脱臼	前方脱臼
右環指基節骨骨折	環指基節骨骨折	環指中節骨骨折
左殿部疼痛	殿部痛	坐骨部痛
両側錐体路障害	錐体路障害	錐体路障害
両足しびれ	下肢しびれ	四肢しびれ
膜性増殖性	膜性増殖性糸球体腎炎	増殖性網膜症
頻脈性心房粗動	心房粗動	頻脈性心房細動
下肢血流障害	下肢血行障害	下肢血行障害
左肺上葉大細胞癌	上葉肺大細胞癌	上葉肺大細胞癌
結核性肋膜炎	結核性胸膜炎	結核性胸膜炎
疼痛有	疼痛	有痛性筋痙攣
実質外腫瘤	腫瘤	骨盤内腫瘤
骨盤部リンパ節転移	骨盤内リンパ節転移	骨盤内リンパ節転移
左三叉神経帯状疱疹	三叉神経帯状疱疹	三叉神経帯状疱疹
間質性肺炎悪化	間質性肺炎	通常型間質性肺炎
仙骨部骨折	仙骨骨折	仙骨亀裂骨折
重症低体温症	低体温	本態性高体温症
関節炎悪化	関節炎	赤痢後関節障害
右尖足	尖足	右胸心
両手指浮腫	浮腫	手指腫脹
左主気管支狭窄	気管支狭窄症	気管支狭窄症
浸潤癌化	癌	浸潤型胸腺腫
就寝後呼吸困難	呼吸困難	労作時呼吸困難
仮性膵嚢胞	仮性膵のう胞	卵巣粘液性腺癌
右肺上葉癌	上葉肺癌	右心房粘液腫
訪室時疼痛	疼痛	季肋部痛
膠原病様症状	膠原病	膠原病
軽度黄染	黄疸	老人性紫斑
転移性膵癌	膵癌	転移性肝癌
除皮質硬直様	除皮質硬直	除皮質硬直
間歇跛行	間欠性跛行	跛行
動脈瘤コイル塞栓術	動脈瘤	肝内門脈下大静脈短絡ステント狭窄
紅斑散在	紅斑症	滲出型加齢黄斑変性
右膝疼痛	膝関節痛	膝窩部痛
食思不振傾向	食欲不振	食欲不振
皮内腫瘍	腫瘍	皮下腫瘍
左前床突起部髄膜腫	髄膜腫	下腿胞巣状軟部肉腫
右脳梗塞	脳梗塞	片頭痛性脳梗塞
軽度腹部痛	腹痛症	腹部圧痛
多発毛細血管拡張	オスラー病	毛細血管拡張症
不整脈誘発	不整脈	頻脈性不整脈
左肺動脈ＰＥ	肺動脈血栓塞栓症	左肺動脈右肺動脈起始症
胃潰瘍再発	胃潰瘍瘢痕	再発性胃潰瘍
境界域精神発達遅滞	知的障害	自閉性精神発達遅滞
胆石膵炎	胆石性膵炎	胆石性膵炎
右腕頭動脈瘤	腕頭動脈瘤	腕頭動脈瘤
外陰部ｐａｇｅｔ癌	外陰部パジェット病	急性大動脈解離ＤｅＢａｋｅｙＩＩ
リウマチ様症状	関節リウマチ	リウマチ性肺疾患
肺癌性リンパ管症	癌性リンパ管症	癌性リンパ管症
左上腕骨顆部骨折	上腕骨顆部骨折	上腕骨顆部骨折
骨盤位妊娠	骨盤位	卵管峡部妊娠
大腿骨骨折後	大腿骨骨折	大腿骨疲労骨折
左椎間孔狭窄	結合組織性椎間孔狭窄症	膵管狭窄
前立腺軽度腫大	前立腺肥大症	前立腺肥大症
下顎腫脹	下顎部腫脹	下顎部腫脹
鼻中隔弯曲	鼻中隔弯曲症	鼻中隔弯曲症
大腸憩室症	多発性大腸憩室症	小腸憩室症
逆流性食道炎無	逆流性食道炎	逆流性食道炎
致死性偽膜性腸炎	偽膜性腸炎	偽膜性腸炎
眼窩蜂窩織炎	眼窩蜂巣炎	眼窩蜂巣炎
排尿後痛	排尿痛	排尿痛
右腹痛	腹痛症	手背部痛
嚥下耳痛	耳痛症	嚥下痛
茶色出血	出血	黄斑下出血
左下葉扁平上皮癌	下葉肺扁平上皮癌	下葉肺扁平上皮癌
右腎梗塞	腎梗塞	腎梗塞
原発性ヘモクロマトーシス	ヘモクロマトーシス	続発性ヘモクロマトーシス
右前頭葉膠芽腫	前頭葉膠芽腫	前頭葉膠芽腫
急性水頭症	水頭症	先天性水頭症
活動性肺結核所見	活動性肺結核	活動性肺結核
右眼白内障	白内障	黒内障性瞳孔強直
本日胸痛	胸痛	胸痛
直腸膀膀胱窩	直腸膀胱瘻	膀胱前壁部膀胱癌
頚部結核性リンパ節炎	結核性リンパ節炎	頚部化膿性リンパ節炎
左橈骨遠位骨折	橈骨遠位端骨折	橈骨遠位端骨折
逆行性Ｐ波	心電図異常	異常脳波
しびれない	しびれ感	しびれ感
臀部圧痛	圧痛	腹部圧痛
咽頭血腫	咽頭部血腫	咽頭部血腫
膀胱癌再発	膀胱癌	膀胱結核
多発皮下転移	皮下腫瘍	多発皮下膿瘍
両側肺動脈血栓塞栓症	肺動脈血栓塞栓症	肺動脈血栓塞栓症
副鼻腔病変	副鼻	副鼻腔癌
安静時呼吸苦	呼吸困難	睡眠時無呼吸症候群
左胸膜播種	胸膜播種	胸膜播種
陰嚢疼痛	陰のう痛	陰茎部疼痛
上眼瞼腫脹	眼瞼浮腫	下眼瞼浮腫
右下肢複雑骨折	開放骨折	一側下肢多発骨折
可動性良好腫瘤	腫瘤	殿部皮膚良性腫瘍
両頬部発赤	発赤	咽頭発赤
感染性肝嚢胞	肝のう胞	細菌性肝膿瘍
左鼡径部腫脹	鼡径部腫脹	鼡径部腫脹
突然呼吸困難	呼吸困難	夜間呼吸困難
皮下出血斑	皮下出血	皮下出血
右下腿骨髄炎	大腿骨骨髄炎	下腿骨骨髄炎
平行機能障害	平衡異常	胃運動機能障害
元々杖歩行	歩行障害	内反歩行
両下肢腫脹	下肢腫脹	下肢腫脹
左傍矢状洞髄膜腫	傍矢状洞髄膜腫	傍矢状洞髄膜腫
限局性皮膚硬化型全身性強皮症	全身性強皮症	限局性強皮症
毎回失禁	尿失禁症	便失禁
右小脳腫瘍	小脳腫瘍	小脳橋角部腫瘍
続発性サルコペニア	サルコペニア	遅発性ジスキネジア
非医原性左尿管狭窄	尿管狭窄	淋菌性尿道狭窄
下腿血腫	血腫	下腿血管腫
逆流性膀胱炎	膀胱尿管逆流	反復性膀胱炎
覚醒時疼痛	疼痛	睡眠時頭痛
左大転子部発赤	発赤	大転子部剥離骨折
卵巣原発腫瘍	卵巣腫瘍	卵巣胚細胞腫瘍
リンパ腫再発	悪性リンパ腫	リンパ節腫大
重度運動障害性構音障害	構音障害	運動障害性構音障害
右肩周囲炎	肩周囲炎	肩周囲炎
軽度動悸	動悸	肺動静脈瘻
左ポスナーシュロスマン症候群	ポスナーシュロスマン症候群	ポスナーシュロスマン症候群
液体貯留	体液貯留	体液貯留
低張性低ナトリウム血症	低ナトリウム血症	低ナトリウム血症
癌性胸腹膜炎	癌性腹膜炎	癌性胸膜炎
心臓内腫瘍	心臓腫瘍	心臓腫瘍
左坐骨神経麻痺	坐骨神経麻痺	坐骨神経麻痺
リステリア髄膜脳炎	リステリア性髄膜脳炎	リステリア性髄膜脳炎
点圧痛	圧痛	高血圧性頭痛
帯状疱疹ウイルス脳炎	帯状疱疹性脳炎	ウイルス性髄膜脳炎
齲蝕	う蝕	膝窩疣贅
腎性急性腎障害	腎障害	急性腎性腎不全
喉頭嚢胞	喉頭のう胞	喉頭蓋腫瘍
甲状腺乳頭腺癌	甲状腺乳頭癌	甲状腺乳頭癌
左上下肢しびれ	半身しびれ	下肢しびれ
心筋傷害	心筋疾患	心臓挫傷
圧迫性骨折	圧迫骨折	圧迫骨折
胆嚢胆石	胆泥	肝門部胆管癌
縱隔リンパ節転移	縦隔リンパ節転移	鼡径部リンパ節転移
悪性細胞	癌	悪性肥満細胞腫
Ｌｉｓｔｅｒｉａ　ｍｏｎｏｃｙｔｏｇｅｎｅｓ敗血症	敗血症	ＴＥＬ−ＡＭＬ１陽性Ｂリンパ芽球性白血病
パニック症侯群	パニック障害	パニック障害
アレルギー性肺アスペルギルス症	アレルギー性気管支肺アスペルギルス症	アレルギー性気管支肺アスペルギルス症
左下肢原発性リンパ浮腫	リンパ浮腫	遅発性内リンパ水腫
呼気時喘鳴	喘鳴	睡眠時無呼吸症候群
落ち着かない	多動性障害	情緒不安定状態
苦悶症状	胸内苦悶	挫滅症候群
トルーソー症候群	トルソー症候群	トルソー症候群
全身浮腫不変	全身性浮腫	全身痙攣
左側頭円蓋部髄膜腫	円蓋部髄膜腫	円蓋部髄膜腫
周術期喘息発作	気管支喘息発作	未熟児無呼吸発作
薬剤性副腎不全	副腎皮質機能低下症	薬剤性腎障害
乳がん	乳癌	脾のう胞
巣状分節状糸球体硬化症	巣状糸球体硬化症	巣状糸球体硬化症
口腔乾燥感	口腔乾燥症	咽喉乾燥感
右手関節尺側部痛	手関節痛	大腿内側部痛
右上顎洞真菌症	上顎洞炎	上顎骨線維腫
鮮血便	血便	粘血便
心配症	心配	心配
アシドーシス進行	アシドーシス	ケトアシドーシス
右足滑液包炎	滑液包炎	肩滑液包炎
第５胸椎転移	胸椎転移	第５腰椎第１仙椎間椎間板変性
表出性言語発達遅滞	言語発達遅滞	言語発達遅滞
発作性心房細動既往	発作性心房細動	発作性頻脈性心房細動
左リウマチ性膝関節症	関節リウマチ・膝関節	非リウマチ性三尖弁狭窄症
左大腿部痛	大腿痛	腓腹部痛
隆起性病変	胃ポリープ症	持久性隆起性紅斑
腫瘤状構造	腫瘤	腫瘍性病的骨折
細菌性赤痢感染症	赤痢	感染性白癬症
多数骨折	骨折	趾多発開放骨折
門脈右枝血栓	門脈血栓症	前腕血栓性静脈炎
３型進行癌	癌	腰仙部移行椎
倦怠感等	倦怠感	倦怠感
全頭脱毛症	脱毛症	完全脱毛症
筋攣縮	筋痙縮	筋痙縮
元々徐脈	徐脈	軟産道伸展不良
特発性側彎症	特発性側弯症	特発性側弯症
回盲部放線菌症	放線菌症	顎放線菌症
ｆａｎ症候群	マルファン症候群	ＴＡＲ症候群
脊椎椎間板炎	椎間板炎	頚椎椎間板炎
起始異常	冠動脈起始異常	肺動脈起始異常
右眼球破裂	眼球破裂	眼球破裂
介助　疼痛	疼痛	抜歯後疼痛
前失神	失神	失神
ふらつき感自覚	よろめき歩行	腹部不快感
低分化型肝細胞癌	肝細胞癌	肝細胞癌
右葉間胸水	葉間胸水	葉間胸水
子宮内膜症性卵巣嚢胞	卵巣子宮内膜症のう胞	卵巣子宮内膜症
腎嚢胞出血	傍腎盂のう胞	髄膜出血
無症候性キャリア	ＨＴＬＶ−１キャリア	性的無快楽症
中等度腹水	腹水症	中等度難聴
受容体脳炎	抗ＮＭＤＡ受容体脳炎	嗜眠性脳炎
肛門部軽度発赤	肛門部周囲炎	肛門部悪性黒色腫
側方リンパ節転移	リンパ節転移	縦隔リンパ節転移
左硝子体混濁	硝子体混濁	硝子体混濁
統合失調症既往	統合失調症	統合失調症
平衡機能障害	平衡障害	平衡障害
肺腫瘤影	胸部異常陰影	肺腫瘤陰影
複雑型異型子宮内膜増殖症	腺腫性子宮内膜増殖症	複雑型子宮内膜異型増殖症
皮膚潰瘍形成	皮膚潰瘍	皮膚潰瘍
肝肥大	肝型糖原病	舌肥大
紅斑腫脹	紅斑症	眼部外傷性腫脹
腰部圧痛	腰痛症	腹部圧痛
元々不眠症	不眠症	不眠症
左肩甲骨軟骨肉腫	肩甲骨軟骨肉腫	肩甲骨軟骨肉腫
肺血症性ショック	敗血症性ショック	敗血症性ショック
凝固線溶系異常	血液凝固異常	先天性血液凝固因子異常
異所性静脈瘤	静脈瘤	上肢血栓性静脈瘤
腫瘍崩壊	腫瘍	腫瘍崩壊症候群
破壊性甲状腺炎	甲状腺炎	放射線性甲状腺炎
右腸骨ＬＮ転移	腸骨リンパ節転移	大腸癌骨転移
右腎被膜下血腫	血腫	外傷性腎被膜下血腫
全身性サルコイドーシス	サルコイドーシス	全身性アミロイドーシス
脱分化型脂肪肉腫	脂肪肉腫	脂肪肉腫
非機能性下垂体腫瘍	下垂体腫瘍	非機能性下垂体腺腫
ＡＣＴＨ分泌不全	ＡＣＴＨ分泌低下症	ＡＣＴＨ分泌低下症
時々残尿感	残尿感	残尿感
小人症	低身長症	小児心身症
右臼蓋転移	骨盤転移	外反母趾
右頭頂葉脳梗塞	脳梗塞	片頭痛性脳梗塞
マルファン症候群合併	マルファン症候群	クラミジア感染症合併妊娠
右眼網膜症	網膜症	眼瞼内反症
咽喉頭炎	咽頭喉頭炎	咽頭喉頭炎
右下葉肺扁平上皮癌	下葉肺扁平上皮癌	下葉肺扁平上皮癌
足趾壊疽	趾壊死	手指脱疽
左肺尖部腺癌	肺腺癌	肺門部腺癌
潰瘍型間質性膀胱炎	間質性膀胱炎	間質性膀胱炎
紅色皮疹	発疹	紅色丘疹
遺尿	遺尿症	遺糞
頚管狭窄	子宮頚管狭窄症	膵管狭窄
右腎門部腹側脂肪肉腫	腎周囲脂肪肉腫	坐骨直腸窩脂肪肉腫
左中頭蓋窩髄膜腫	中頭蓋窩髄膜腫	中頭蓋窩髄膜腫
脳梗塞後後遺症	脳梗塞	脳梗塞後遺症
含歯性嚢胞	含歯性のう胞	上顎角化のう胞性歯原性腫瘍
紅斑熱	日本紅斑熱	紅斑症
多発頭蓋骨転移	骨転移癌	転移性頭蓋骨腫瘍
Ｄａｎｌｏｓ症候群	エーラス・ダンロス症候群	ＭＥＬＡＳ症候群
運動低下性構音障害	構音障害	運動障害性構音障害
右重症下肢虚血	重症虚血肢	上肢末梢神経損傷後遺症
両側腸腰筋血腫	血腫	腸腰筋膿瘍
亀頭部発赤	発赤	咽頭発赤
肝嚢胞感染	肝のう胞	尿管感染
重症強迫性障害	強迫性障害	強迫性障害
顔面骨圧痛	圧痛	顔面多発骨折
左椎間板ヘルニア	椎間板ヘルニア	腰椎椎間板ヘルニア
会陰部疼痛	外陰部痛	陰茎部疼痛
咀嚼時痛	咀嚼筋痛障害	腟痙
左膝関節偽痛風	膝関節偽痛風	膝関節偽痛風
２次性副甲状腺機能亢進症	副甲状腺機能亢進症	続発性副甲状腺機能亢進症
右上腕蜂窩織炎	上腕蜂巣炎	胃蜂窩織炎
右前大脳動脈未破裂動脈瘤	前大脳動脈瘤	内頚動脈後交通動脈分岐部動脈瘤
リウマチ性胸水	リウマチ性肺疾患	リウマチ性癒着性心膜炎
右眼白内障手術	白内障	白内障術後
悪性リンハ゜腫	悪性リンパ腫	悪性リンパ腫
胆管腫瘍栓	胆管腫瘍	胆管腫瘍
右基底核梗塞	脳梗塞	急性右室梗塞
境界型耐糖能障害	耐糖能異常	混合型酸塩基平衡障害
リウマチ疾患	関節リウマチ	リウマチ性肺疾患
白内障Ｏ	白内障	前極白内障
心房細動停止	心房細動	心房静止
帯状疱疹既往	帯状疱疹	劇症帯状疱疹
腫瘤所見	腫瘤	腫瘍随伴症候群
ＶＨＬ病	フォンヒッペル・リンダウ病	ＶＬＣＡＤ欠損症
時折血痰	血痰	喀痰
陰嚢部腫脹	陰のう腫大	頚部腫脹
帰室時疲労感	疲労感	疲労感
高分化型腺癌	癌	松果体未分化胚細胞腫
糖尿病等	糖尿病	糖尿病
Ｍｙｃｏｂａｃｔｅｒｉｕｍ　ｓｈｉｇａｅｎｓｅ感染症	非結核性抗酸菌症	ＥＳＢＬ産生菌感染症
後腹膜腫瘍切除術	後腹膜腫瘍	術後腹腔内膿瘍
肺転移発覚	転移性肺腫瘍	顎堤異常吸収
右中咽頭癌	中咽頭癌	中咽頭側壁癌
両側肺動脈血栓塞栓	動脈血栓症	肺動脈血栓塞栓症
臀部炎症性粉瘤	粉瘤	強直脊椎炎性虹彩毛様体炎
左耳耳鳴	耳鳴症	無難聴性耳鳴
鼠経ヘルニア	鼡径ヘルニア	絞扼性腹壁ヘルニア
鼻閉塞	鼻閉	喉頭閉塞
疲労感等	疲労感	疲労感
日中掻痒感	そう痒	排尿時灼熱感
前交通動脈未破裂脳動脈瘤	未破裂脳動脈瘤	内頚動脈後交通動脈分岐部動脈瘤
夜間低酸素血症	低酸素血症	低酸素血症
薬剤性腎不全	薬剤性腎障害	薬剤性腎障害
気管支狭窄	気管支狭窄症	気管支狭窄症
腫瘍増悪	腫瘍	悪性腫瘍合併皮膚筋炎
急性軸索障害	びまん性軸索損傷	急性意識障害
完全型ベーチェット病	ベーチェット病	外陰ベーチェット病
筋肉痙攣	痙攣	四肢筋痙攣
癌性髄膜腫症	悪性髄膜腫	髄膜癌腫症
化膿性脊椎椎間板炎	化膿性椎間板炎	胸椎化膿性椎間板炎
呼吸性雑音	胸部音異常	遷延性無呼吸
真菌塊	真菌症	真菌性足菌腫
両肩関節圧痛	圧痛	肩鎖関節痛
多発肝細胞癌	肝腫瘍	多発性肝血管腫
右腎小嚢胞	傍腎盂のう胞	右心房粘液腫
左横隔膜神経麻痺	横隔神経麻痺	横隔神経麻痺
右高度水腎症	水腎症	後天性水腎症
創傷治癒遅延	創傷	手外傷後変形治癒
上腫瘍	腫瘍	皮下腫瘍
進行性食道癌	食道癌	食道基底細胞癌
複雑性熱性痙攣	熱性痙攣	無熱性痙攣
先天性鼻咽腔閉鎖不全症	先天性鼻咽腔閉鎖不全	先天性鼻咽腔閉鎖不全
右眼鼻涙管閉塞症	鼻涙管閉鎖症	鼻涙管閉鎖症
縦隔原発Ｂ細胞大細胞型リンパ腫	縦隔原発大細胞型Ｂ細胞性リンパ腫	縦隔原発大細胞型Ｂ細胞性リンパ腫
左半視野障害	視野障害	心因性視野障害
大腿骨近位部骨折	大腿骨骨折	大腿骨遠位端骨折
左踵部痛	踵痛	腓腹部痛
ポリープ様隆起	ポリープ	腟断端ポリープ
刺激性皮膚炎	皮膚炎	刺激物質性接触皮膚炎
慢性緑膿菌感染	緑膿菌感染症	多剤耐性緑膿菌感染症
回腸閉塞	回腸狭窄	回腸閉鎖
尾部嚢胞	膵のう胞	背部基底細胞癌
虫刺症	蜂刺症	刺虫症
第二趾爪囲炎	爪囲炎	第２趾基底細胞癌
膵仮性嚢胞破裂	仮性膵のう胞	肝細胞癌破裂
シェーンラインヘノッホ紫斑病	ＩｇＡ血管炎	ハイデンハイン疾患
記銘障害	記銘力低下	記憶障害
上歯肉癌	上顎歯肉癌	上顎歯肉癌
チャーグ－ストラウス症候群	好酸球性多発血管炎性肉芽腫症	スティックラー症候群
低ＡＴⅢ血症	アンチトロンビン欠乏症	高ＩｇＡ血症
超皮質性感覚性失語	皮質下感覚性失語症	超皮質性失語
ＮＯＭＩ	腸壊死	ＭＮＧＩＥ
肥厚性幽門狭窄	肥厚性幽門狭窄症	肥厚性幽門狭窄症
問題なし脊柱管狭窄症	脊柱管狭窄症	脊柱管狭窄症
左踵骨裂離骨折	踵骨骨折	踵骨開放骨折
慢性糸球体炎	糸球体腎炎	慢性糸球体腎炎
左眼結膜下出血	結膜下出血	眼瞼結膜出血
子宮頸部上皮内腫瘍	子宮頚部上皮内腫瘍	子宮頚部上皮内腫瘍
左腰部有棘細胞癌	腰部有棘細胞癌	腰部有棘細胞癌
糖尿病罹患	糖尿病	糖尿病足壊疽
四肢圧痛	圧痛	四肢神経痛
関節変形	関節奇形	股関節変形
気分変動	気分変調症	気分変調症
左鎖骨下動脈起始異常	鎖骨下動脈起始異常	鎖骨下動脈起始異常
立位バランス練習重症筋無力症	重症筋無力症	全身型重症筋無力症
腰椎脊柱管狭窄	腰部脊柱管狭窄症	腰部脊柱管狭窄症
左上葉小細胞肺癌	上葉小細胞肺癌	上葉小細胞肺癌
左後縦隔腫瘍	後縦隔腫瘍	後縦隔腫瘍
食道カンジタ症合併ＨＩＶ感染症	ＨＩＶカンジダ病	ＨＩＶ−１感染症
固縮無動	こわばり	純粋無動症
小体認知症	認知症	皮質認知症
突然腹痛	腹痛症	胸痛
尿閉気味	尿閉	混濁尿
生検部感染徴候	創傷感染症	生検後感染
痛風症状	痛風	痛風発作
脳転移新出	転移性脳腫瘍	卵巣癌全身転移
両側肩関節痛	肩関節痛症	肩鎖関節痛
右眼下鼻側視野異常	視野障害	眼瞼先天異常
右肺Ｓ４原発腺癌	肺腺癌	肺未分化癌
右肘関節骨折	肘関節骨折	肘関節骨折
両耳下腺腫脹	耳下腺腫脹	耳下腺腫脹
再下血	下血	下血
両変形性股関節症	変形性股関節症	変形性股関節症
喘息コントロール不良	咳喘息	術後膀胱機能低下
腹部大動脈狭窄症	大腿動脈狭窄症	腹部大動脈閉塞症
左肺良性腫瘍	肺良性腫瘍	肺良性腫瘍
頸動脈狭窄症	内頚動脈狭窄症	内頚動脈狭窄症
若年結核性腹膜炎	結核性腹膜炎	結核性胸膜炎
発赤部分	発赤	腸音欠如
大腸疾患	腸疾患	大腸腫瘍
頚部血腫	頚部表在損傷	頚部肉腫
肺雑聴取	胸部音異常	顎堤異常吸収
急性冠症候群発症	急性冠症候群	急性冠症候群
皮下浮腫	浮腫	皮下気腫
低活動型せん妄	せん妄	老人性夜間せん妄
左化膿性耳下腺炎	化膿性耳下腺炎	化膿性耳下腺炎
痔核症状	痔核	潰瘍性痔核
拘束性心筋症	拘束型心筋症	拘束型心筋症
右内頸動脈血栓閉塞	動脈血栓症	冠状動脈血栓塞栓症
肝うっ血	うっ血肝	胃うっ血
ＣＮＩ腎症	薬剤性腎障害	ＮＳＡＩＤ腎症
浮腫軽減	浮腫	胸水蛋白増加
胃液様	嘔吐症	円柱尿
右鼡径部出血	出血	腟断端出血
右肺上葉肺炎	肺炎	下葉肺癌
膠原病外来	膠原病	腫瘍性腰椎病的骨折
門亢症	門脈圧亢進症	門脈圧亢進症性胃症
在型食道癌	食道癌	先天性気管食道瘻
創内異物	外傷性異物	舌異物
膀胱内尿貯留	後腹膜尿貯留	心膜液貯留
肢痛	疼痛	幻肢痛
肺結核性腹膜炎	結核性腹膜炎	結核性腹膜炎
腸管内血腫	血腫	大腸血管腫
ネフローゼ状態	ネフローゼ症候群	ネフローゼ症候群
軽度僧帽弁逆流症	僧帽弁逆流症	僧帽弁逆流症
前胸部粉瘤	粉瘤	前胸部腫瘤
左室中部閉塞性肥大型心筋症	閉塞性肥大型心筋症	心室中部閉塞性心筋症
しびれがきつい	しびれ感	全身のしびれ感
両側内耳奇形	内耳先天奇形	内耳先天奇形
完全右脚ブロック指摘	完全右脚ブロック	完全右脚ブロック
肛門部潰瘍	肛門潰瘍	肛門潰瘍
臀部紅斑	紅斑症	胸部扁平母斑
アレルギ—性鼻炎	アレルギー性鼻炎	アレルギー性鼻炎
末節骨骨折	骨折	趾末節骨骨折
脊椎症性変化	脊椎症	腰部椎間板症性脊髄症
腸閉塞気味	イレウス	小腸閉鎖
浅呼吸	呼吸困難	口呼吸
無症候性狭心症	狭心症	無症候性多発性硬化症
右顎下リンパ節腫脹	顎下リンパ節腫脹	顎下リンパ節腫脹
左側頭葉海綿状血管腫	側頭葉海綿状血管腫	側頭葉海綿状血管腫
直腸癌術後直腸癌	直腸癌	直腸癌
痛覚消失	異常知覚	片側痛覚消失
膵炎再燃	膵炎	潰瘍性大腸炎再燃
肘頭部潰瘍	前腕皮膚潰瘍	亀頭部潰瘍
反復性腸閉塞	イレウス	結腸閉塞
胎児腹水	胎児水腫	胎児胸水
失見当識障害	見当識障害	見当識障害
皮膚ツルゴール低下	脱水症	ヨード欠乏性甲状腺機能低下症
右肩悪性軟部腫瘍	悪性軟部腫瘍	肩部悪性軟部腫瘍
非定型うつ	非定型うつ病	非定型うつ病
右中指スワンネック変形肩関節	スワンネック変形	第１手根中手関節脱臼骨折
胸郭運動異常	胸郭異常	胸郭異常
前頭蓋底腫瘍	頭蓋底腫瘍	後頭蓋窩腫瘍
腹部肥満	肥満症	腹部膨満
Ｓ状結腸粘膜下腫瘤	腫瘤	Ｓ状結腸粘膜下腫瘍
両側下腿圧痕性浮腫	下腿浮腫	下腿滑膜肉腫
動脈瘤様骨嚢腫	動脈瘤様骨のう腫	脈絡叢乳頭腫
軟性腫瘤	腫瘤	頚椎悪性腫瘍
本日疼痛	疼痛	新規発症持続性連日性頭痛
出血軽度	出血	急性大量出血
軽度間歇性跛行	間欠性跛行	間欠性跛行
蛋白血症	異常蛋白血症	高蛋白血症
不眠時２錠	不眠症	閉塞性睡眠時無呼吸
後縦隔膿瘍	縦隔膿瘍	後縦隔腫瘍
胸水排出	胸水貯留	羊水漏出
ＡＩＤＳ非定型抗酸菌症	非結核性抗酸菌症	ＨＩＶ非結核性抗酸菌症
尺側神経麻痺	尺骨神経麻痺	尺骨神経麻痺
徐脈等	徐脈	徐脈
てんかんの発作	てんかん	てんかん様発作
腹部大動脈石灰化	大動脈石灰化症	冠動脈石灰化
サルコイドーシス疑	サルコイドーシス	コクシジオイデス症
左片麻痺	片麻痺	片麻痺
足部冷感	下肢冷感	下肢冷感
下痢〜水様便	下痢症	水痘後急性扁桃炎
コレステロールポリープ	ポリープ	胆のうコレステロールポリープ
１型糖尿除	糖尿	２型糖尿病
関節固縮	関節拘縮	足関節拘縮
肺多型癌	癌	肺癌肉腫
慢性アレルギ—性鼻炎	アレルギー性鼻炎	慢性アレルギー性中耳炎
下顎骨正中部骨折	下顎正中部骨折	下顎正中部骨折
後嘔吐	嘔吐症	嘔吐症
気分不快出現	悪心	不潔恐怖症
劇症Ａ群溶連菌感染症	劇症型Ａ群連鎖球菌感染症	Ｂ群溶連菌感染症
内腸骨静脈血栓症	静脈血栓症	腸骨動脈血栓症
軽度咽頭期嚥下障害	嚥下障害	術後嚥下障害
舌根扁桃炎	扁桃炎	舌扁桃炎
右肺上葉小細胞癌	上葉小細胞肺癌	上葉肺大細胞癌
ＣＭＶ網膜症	サイトメガロウイルス網膜炎	ＨＩＶ網膜症
脊椎側弯症	脊柱側弯症	脊柱側弯症
悪心Ｇ１	悪心	悪心
上腹部鈍痛	上腹部痛	上腹部痛
脊髄視神経炎	視神経炎	視神経脊髄炎
本日血尿	血尿	韓国型出血熱
クラミジア頸管炎	クラミジア頚管炎	クラミジア頚管炎
性急性リンパ性白血病	急性リンパ性白血病	急性リンパ性白血病
周囲リンパ節腫大	リンパ節腫大	リンパ節腫大
印環細胞癌	癌	卵巣小細胞癌
６月肝転移	転移性肝腫瘍	第１色弱
左内頸動脈中等度狭窄	頚動脈硬化症	外腸骨動脈狭窄
左外耳道閉鎖	外耳道閉鎖	外耳道閉鎖
右鼡径部ヘルニア	鼡径ヘルニア	鼡径ヘルニア
ＭＬＦ症候群	核間性眼筋麻痺	ＬＧＬ症候群
醜形恐怖	醜形恐怖症	醜形恐怖症
肩関節疼痛	肩関節痛症	肩鎖関節痛
右手痺れ	上肢しびれ	手母指壊疽
逆流感	胃食道逆流症	動揺病
播種性クリプトコックス症	播種性クリプトコッカス症	播種性クリプトコッカス症
左尿管導管吻合部狭窄	吻合部狭窄	尿管回腸導管吻合部狭窄
口唇落屑	皮膚落屑	上口唇挫傷
時折不整	不整脈	月経不順
僧帽弁狭窄症兼閉鎖不全症	僧帽弁狭窄症	僧帽弁狭窄兼閉鎖不全症
伸筋腱脱臼	脱臼	腓骨筋腱脱臼
両下腿潰瘍	下腿皮膚潰瘍	下腿皮膚潰瘍
内転障害	眼球運動痙攣	直腸障害
びまん性リンパ腫	リンパ腫	びまん性大細胞型Ｂ細胞性リンパ腫
多発嚢胞腎	多発性のう胞腎	萎縮腎
足首骨折	足関節骨折	足背骨折
右目白内障	白内障	後極白内障
嘔吐１回	嘔吐症	嘔吐症
深夜低血糖	夜間低血糖症	夜間低血糖症
過敏症状	過敏症	過敏症
高Ｂｉｌ血症	高ビリルビン血症	高ＬＤＬ血症
右足小指骨折	小指骨折	母指中手骨骨折
第一腰椎破裂骨折	腰椎破裂骨折	第３頚椎破裂骨折
せん妄発言	せん妄	てんかん様発作
ヒステリー症状	ヒステリー反応	ヒステリー性失声症
歩行時創部痛	術創部痛	閉経後骨粗鬆症・大腿部病的骨折あり
パニック	パニック障害	パニック発作
正色素性正球性貧血	正球性正色素性貧血	正球性正色素性貧血
右足腫脹	足部腫脹	足背腫脹
両肺胸膜肥厚	胸膜肥厚	胸膜脂肪肉腫
ＡＰＳ	抗リン脂質抗体症候群	ＡＩＤＳ
脳圧亢進症状	頭蓋内圧亢進症	頭蓋内圧亢進症
眼鏡　近視	近視	遠視
二次性ヘモクロマトーシス	ヘモクロマトーシス	続発性ヘモクロマトーシス
潜在性副甲状腺機能低下症	副甲状腺機能低下症	偽性副甲状腺機能低下症
両眼瞼黄色腫	眼瞼黄色腫	眼瞼黄色腫
右内腸骨動脈狭窄	動脈狭窄	外腸骨動脈狭窄
正中頚嚢胞	正中頚のう胞	上腕胞巣状軟部肉腫
両側尿管結石	尿管結石症	下部尿路結石
高血圧状態	高血圧症	高血圧症
喀血症状	喀血	腟留血症
指発赤	発赤	小指痛
Ⅱａ型高脂血症	高脂血症	家族性高リポ蛋白血症２ａ型
右手橈骨骨折	橈骨骨折	橈骨尺骨骨折
右睾丸痛	精巣痛	鼡径部痛
本日血便	血便	韓国型出血熱
回腸出血	腸出血	直腸出血
左副腎出血	副腎出血	副腎出血
後頭蓋下髄膜腫	髄膜腫	後頭蓋窩髄膜腫
急性前壁中隔梗塞	急性前壁中隔心筋梗塞	急性前壁中隔心筋梗塞
右顔面部帯状疱疹	顔面帯状疱疹	顔面帯状疱疹
びまん性管内増殖性糸球体腎炎	慢性びまん性管内増殖性糸球体腎炎	急性びまん性管内増殖性糸球体腎炎
傍腹部大動脈リンパ節腫大	リンパ節腫大	前胸部リンパ管腫
左上腕脂肪腫	上腕脂肪腫	上腕脂肪腫
尿道口発赤	発赤	外尿道口狭窄
冠動脈狭窄症	冠状動脈狭窄症	冠状動脈狭窄症
膵石灰化	膵石灰化症	膵石灰化症
丘疹様	丘疹	丘疹
肺上葉原発性肺癌	原発性肺癌	原発性肺癌
労作時胸部不快	労作時呼吸困難	労作時呼吸困難
２型＋ステロイド性糖尿病	ステロイド糖尿病	ステロイド糖尿病
腫瘤縮小	腫瘤	腫瘤
Ｓａｌｍｏｎｅｌｌａ　ｅｎｔｅｒｉｔｉｄｉｓ敗血症	サルモネラ敗血症	Ｅｕｔｈｙｒｏｉｄ　Ｓｉｃｋ症候群
グル音異常	異常腸音	アルダー異常
鉄吸収障害	鉄欠乏症	鉄代謝障害
水中毒症状	水中毒	水中毒
鼻中隔彎曲	鼻中隔弯曲症	鼻中隔弯曲症
本日右眼白内障	白内障	黒内障性瞳孔強直
過敏性腸症侯群	過敏性腸症候群	過敏性腸症候群
会話性幻聴	幻聴	感音性耳鳴
筋疲労感	筋疲労	筋疲労
水疱後びらん	水疱症	尿道口びらん
胆管内結石	胆管結石症	総胆管結石
時々せん妄	せん妄	疲憊せん妄
処置後膵炎	膵炎	輸血後肝炎
術後右反回神経麻痺	術後性反回神経麻痺	術後性反回神経麻痺
反復性細菌感染	細菌感染症	溶連菌感染後急性糸球体腎炎
ｗｉｄｅ　ＱＲＳ頻拍	頻拍症	解離性大動脈瘤ＤｅＢａｋｅｙＩＩ
両側性末梢性顔面神経麻痺	末梢性顔面神経麻痺	末梢性顔面神経麻痺
皮膚軟部組織感染症	皮膚感染症	皮膚感染症
腰痛ヘルニア	椎間板ヘルニア性腰痛症	筋ヘルニア
イレウス合併	イレウス	胎便イレウス
息苦しく	呼吸困難	悪寒戦慄
肺好酸球性肉芽腫	肺好酸球性肉芽腫症	肺好酸球性肉芽腫症
無菌性腸炎	非感染性腸炎	細菌性腸炎
骨盤内リンパ嚢腫	骨盤部感染性リンパのう胞	骨盤内リンパ節の悪性腫瘍
両側眼瞼下垂症	眼瞼下垂症	眼瞼下垂症
両側性結核性胸膜炎	結核性胸膜炎	結核性胸膜炎
甲状腺機能亢進症状	甲状腺機能亢進症	甲状腺機能亢進症
平坦Ｔ波	心電図異常	異常脳波
ペーシング不全	両室ペーシング機能付き植込型除細動器不全	ペースメーカ不全
後頭部打撲	頭部打撲	後頭部打撲傷
薬剤性過敏症候群	薬剤性過敏症症候群	薬剤性過敏症症候群
両側喉頭肉芽腫	喉頭肉芽腫	喉頭肉芽腫
ふらつきあり	めまい	ひきつけ
右鼡径ヘルニア	鼡径ヘルニア	鼡径ヘルニア
職業性ストレス	急性ストレス反応	筋ストレイン
卵管水腫	卵管留水症	卵管留血腫
左下葉原発性肺扁平上皮癌	肺扁平上皮癌	下葉肺扁平上皮癌
外気胸	気胸	気胸
ポリープ数個	ポリープ	食道ポリープ
右低音障害型感音難聴	急性低音障害型感音難聴	急性低音障害型感音難聴
外陰部血腫	外陰血腫	会陰部血腫
左乳突蜂巣炎	乳様突起炎	腋窩蜂巣炎
未破裂左内頸動脈瘤	内頚動脈瘤	未破裂脳動脈瘤
中咽頭側壁扁平上皮癌	癌	上咽頭側壁癌
ＥＶＡＮＳ症候群	エバンス症候群	エバンス症候群
右聴神経腫瘍	聴神経腫瘍	聴神経腫瘍
両肺多発結節性陰影	胸部異常陰影	肝限局性結節性過形成
左血腫	血腫	左心房粘液腫
早期乳癌	乳癌	早期胃癌
脾臓腫瘤	腫瘤	腎腫瘤
多発髄膜腫	多発性髄膜腫	多発性髄膜腫
術中出血多	多量出血	術中低血圧
先天性嚢胞肺	先天性のう胞肺	先天性肺胞蛋白症
手背部疼痛	手背部痛	手背部痛
腹部大動脈嚢状瘤	腹部大動脈瘤	胸腹部大動脈瘤
腫瘍感染合併	腫瘍	潰瘍性大腸炎合併妊娠
ＩＰ合併	間質性肺炎	示指ＰＩＰ開放創
左腫瘤	腫瘤	腋窩腫瘤
ゾメタ骨髄炎	骨髄炎	環指骨髄炎
葉酸欠乏	葉酸欠乏症	葉酸欠乏症
右胸膜原発血管肉腫	血管肉腫	胸壁淡明細胞肉腫
拘縮気味	筋拘縮症	心濁音界縮小
手関節圧痛	圧痛	手関節痛
浮腫残存	浮腫	浮腫
非てんかん性心因性発作	てんかん	非弁膜症性発作性心房細動
鼻口蓋管嚢胞	鼻口蓋管のう胞	口腔底癌
下腸間膜動脈閉塞	腸間膜動脈塞栓症	下腸間膜動脈瘤
右中大脳動脈領域梗塞	中大脳動脈閉塞症	中大脳動脈狭窄症
消化管腫瘤	腫瘤	消化管血腫
脛骨前面圧痕性浮腫	浮腫	脛骨近位端骨肉腫
多少眠気	非器質性過眠症	過多月経
高濃度腫瘤	腫瘤	多発性皮下腫瘤
ＤＧＥ症状	消化管術後後遺症	ＬＧＬ症候群
過形成性ポリープ	胃過形成ポリープ	胃過形成ポリープ
日光アレルギー	光線過敏症	食物アレルギー
両膝痛	膝関節痛	足背痛
こわばりあり	こわばり	こわばり
慢性炎症性腸疾患	腸炎	炎症性腸疾患
尺骨頭脱臼	脱臼	橈骨頭脱臼
けいれん症状	痙攣	睡眠喪失てんかん
重度三尖弁閉鎖不全症	三尖弁閉鎖不全症	三尖弁閉鎖不全症
肺炎併発	肺炎	肺炎合併肺膿瘍
右下肢感覚鈍麻	感覚異常症	片側感覚鈍麻
第二度房室ブロック	第２度房室ブロック	第１度房室ブロック
慢性進行性肺アスペルギルス症	肺アスペルギルス症	慢性壊死性肺アスペルギルス症
点状発赤	発赤	点状乾癬
白血病化	白血病	白血病
消退性発赤	発赤	萎縮性化生性胃炎
ヒステリー	ヒステリー反応	不安ヒステリー
手指皮疹	発疹	手指湿疹
残尿	残尿感	無尿
腫脹圧痛	圧痛	癌性疼痛
ループスアンチコアグラント陰性	ループスアンチコアグラント	ループスアンチコアグラント
両肺気胸	気胸	無気肺
右肺胸水貯留	胸水貯留	心膜液貯留
血性吐物	吐血	糞便性嘔吐
両側腓骨神経麻痺	腓骨神経麻痺	腓骨神経麻痺
廃用	廃用症候群	廃用性内斜視
浮動感	めまい	四肢脱力感
軽度右室肥大	右室肥大	左室肥大
右膝蜂窩織炎	膝部蜂巣炎	帯状疱疹後膝神経節炎
強制換気	人工呼吸器装着状態	過換気テタニー
２型＋ステロイド糖尿病	ステロイド糖尿病	ステロイド糖尿病
左下肢ガス壊疽	ガス壊疽	下肢壊疽
低血糖用	低血糖	低血糖
喚語障害	不全失語症	構語障害
右足底潰瘍	足底皮膚潰瘍	足底皮膚潰瘍
右網膜静脈分枝閉塞症	網膜静脈分枝閉塞症	網膜静脈分枝閉塞症
腹痛時	腹痛症	睡眠時頭痛
多動多弁	多動性障害	多呼吸
右手背浮腫	限局性浮腫	手背腫脹
足趾しびれ	下肢しびれ	四肢端しびれ
突然意識障害	意識障害	一過性意識障害
足底痺れ	しびれ感	足底部痛
角膜ヘルペス	ヘルペス角膜炎	鼻下部ヘルペス
食思不振症状	食欲不振	食欲不振
細菌性食道炎	食道炎	好酸球性食道炎
開大代謝性アシドーシス	代謝性アシドーシス	代償性代謝性アシドーシス
心因性過食症	心因性過食	心因性多飲症
術後肺転移	転移性肺腫瘍	術後肺合併症
転移性腫瘤	転移性腫瘍	転移性腫瘍
夜間尿意	夜間頻尿症	夜間咳
右下腿腫脹	下腿腫脹	下腿腫脹
背部皮脂欠乏性湿疹	皮脂欠乏性湿疹	皮脂欠乏性湿疹
足爪白鮮	足爪白癬	足爪白癬
神経性疼痛	神経痛	神経障害性疼痛
房室接合部調律	異所性調律	房室接合部期外収縮
末梢循環不全徴候	末梢循環不全	末梢循環不全
眼瞼下垂自覚	眼瞼下垂症	眼球突出性眼筋麻痺
右上顎洞乳頭腫	上顎洞乳頭腫	上顎洞乳頭腫
帯状疱疹拡大	帯状疱疹	帯状疱疹
左尾状核ラクナ硬塞	ラクナ梗塞	無症候性ラクナ梗塞
ＳＭＡ閉塞	急性上腸間膜動脈閉塞症	尿道閉鎖
めまいの発作	めまい	めまい発作
呼吸切迫	急性呼吸窮迫症候群	呼吸促迫
劇症型連鎖球菌感染症	連鎖球菌感染症	劇症型Ａ群連鎖球菌感染症
腹部疝痛	仙痛	腹部圧痛
胆嚢多発ポリープ	胆のうポリープ	胆管ポリープ
柑皮症	カロチン血症	老人性乾皮症
浮腫状	浮腫	浮腫
陰部掻痒	外陰部そう痒症	陰部間擦疹
十二指腸多発びらん	十二指腸びらん	胃十二指腸瘻
前立性肥大症	前立腺肥大症	前立腺肥大症
嘔気状況	嘔気	興奮状態
両側眼球外転障害	眼球運動障害	先天性眼球運動障害
元々浮腫	浮腫	浮腫
左小脳出血	小脳出血	小脳出血
躁うつ	躁うつ病	躁うつ病
夜間失禁	尿失禁症	夜間呼吸困難
ベージェット病	ベーチェット病	ベーチェット病
元来頭痛	頭痛	前腕痛
褥瘡発生リスク低い	褥瘡	卵膜残留・出血を伴わない
下部直腸癌	直腸癌	直腸上皮内癌
両側総腸骨動脈狭窄	総腸骨動脈狭窄	総腸骨動脈狭窄
牽引痛	牽引性頭痛	身体痛
Ⅱ度熱傷	熱傷	第２度熱傷
重度感覚障害	体感異常	軽度認知障害
両側肺尖部進行性胸膜肥厚	胸膜肥厚	先天性胸鎖乳突筋腫瘤
婦人入院脳梗塞	脳梗塞	分娩後急性腎不全
炎症性ポリープ多発	ポリープ	腺腫性ポリープ
右坐骨結節転移再発	転移性腫瘍	胸骨傍リンパ節転移
ダンピング症候群併発	ダンピング症候群	後期ダンピング症候群
右上肢痺れ	しびれ感	上肢不全麻痺
ＭＣＴＤ	混合性結合組織病	褥瘡・ＤＴＩ
ループスアンチコアグラント陽性	ループスアンチコアグラント	髄液クリプトコッカス陽性
昨日水様便	下痢症	黒水熱
気分不快増強	悪心	不潔恐怖症
拡張期高血圧	高血圧症	収縮期高血圧症
右気管支肺炎	気管支肺炎	気管支肺炎
左頸部リンパ節腫大	薬剤性自己免疫性溶血性貧血	頚部リンパ節腫
右低音部感音難聴	感音難聴	両側性高音障害漸傾型感音難聴
ＰＨＴ	肺高血圧症	ＰＣＷＨ
夜間失見当	見当識障害	前期破水・分娩開始が破水後２４時間以降
劇症型髄膜炎菌感染症	髄膜炎菌感染症	髄膜炎菌感染症
物忘れ気	健忘症	自然気胸
両難聴	難聴	難聴
左腎細胞癌	腎細胞癌	腎細胞癌
多発膵転移	転移性膵腫瘍	骨粗鬆症・多発病的骨折あり
両眼白内障手	白内障	白内障術後
右手関節滑膜炎	滑膜炎	膝関節滑膜炎
膠原病由来	膠原病	先天性魚鱗癬様紅皮症
声門上喉頭癌	喉頭癌	上咽頭上壁癌
右膝メルケル細胞癌	メルケル細胞癌	下腿メルケル細胞癌
右椎骨動脈起始部狭窄	椎骨動脈狭窄症	右冠動脈肺動脈起始症
加害妄想	妄想反応	被害妄想
嚢胞性胸腺腫	胸腺腫	浸潤型胸腺腫
急性乳突洞炎	急性中耳炎	急性乳様突起炎
舌内リンパ節転移	リンパ節転移	胃周囲リンパ節転移
悪性リンパ腫既往	悪性リンパ腫	悪性リンパ腫骨髄浸潤
左肺下葉腫瘤影	肺腫瘤	腹壁皮下腫瘤
Ｌ３圧迫骨折	圧迫骨折	腰椎圧迫骨折
左感音性難聴	感音難聴	両側性感音難聴
腎臓疾患	腎疾患	腎疾患
ＣＯＰＤＩ期	慢性閉塞性肺疾患	ＣＡＤ／ＣＡＭ冠低位
転倒歴多数	よろめき歩行	特殊書読遅滞
ＤＩＨＳ	薬疹	ＨＤＬＳ
夜勤帯下血	下血	夜間頻尿症
インスリン依存性糖尿病	１型糖尿病	インスリン抵抗性糖尿病
頸部椎間板ヘルニア	頚椎椎間板ヘルニア	頚椎椎間板ヘルニア
右眼網膜裂孔	網膜裂孔	眼球結膜裂傷
拍動性疼痛	疼痛	心因性疼痛
下血増悪	下血	下行結腸憩室出血
ＤＭ性腎不全	糖尿病性腎不全	急性腎前性腎不全
膝関節軽度屈曲拘縮	屈曲拘縮	膝関節屈曲拘縮
ＡＴＬ	成人Ｔ細胞白血病リンパ腫	ＡＩＤＳ
肺動脈弁閉鎖不全	肺動脈弁閉鎖	肺動脈弁閉鎖不全症
熱感軽度	ほてり	温度感覚過敏
重度不眠	不眠症	不眠症
咀嚼困難感	咀嚼障害	咀嚼障害
食道圧迫	食道圧迫症	食道圧迫症
両足関節痛	足関節痛	足関節痛
術後肝転移	転移性肝癌	術後癒着
朝低血糖	低血糖	夜間低血糖症
喘息疑い	咳喘息	混合型喘息
顔皮疹	発疹	斑状皮疹
子宮筋腫有	子宮筋腫	子宮筋腫
淡明細胞型腎細胞癌	腎細胞癌	卵巣明細胞腺癌
浮腫生	浮腫	浮腫
再出血徴候	出血	再発性多発軟骨炎
アシネトバクター敗血症	敗血症	多剤耐性アシネトバクター感染症
左自然気胸再発	自然気胸	自然骨盤位分娩
高度肥満２型糖尿病	２型糖尿病	２型糖尿病性骨症
右大腿骨骨肉腫	大腿骨骨肉腫	大腿骨骨肉腫
左腎盂腎炎治癒後	腎盂腎炎	術後腎盂腎炎
二次性水頭症	外傷後水頭症	二次性尿崩症
ダグラス窩播種	腹膜播種	カプスラーツム播種性ヒストプラスマ症
左室拡張能低下	左室不全	喉頭機能低下
ウィルス感染症	ウイルス感染症	ウイルス感染症
左手尺骨神経麻痺	尺骨神経麻痺	尺骨神経麻痺
周期性呼吸時折	周期性呼吸	周期性呼吸
異常帯下	帯下	異常喀痰
多発性大腸ポリープ	大腸ポリープ	小腸ポリープ
糖尿病用	糖尿病	糖尿病
術前心電図異常	心電図異常	心電図異常
中耳炎症状	中耳炎	猩紅熱性中耳炎
脱力症状	脱力感	卵巣欠落症状
上半身掻痒感	そう痒	下肢脱力感
動揺性めまい	めまい	回転性めまい
褥瘡発生歴	褥瘡	褥瘡感染
水分摂取困難	嚥下障害	経口摂取困難
趾爪囲炎	爪囲炎	趾関節炎
右下葉原発低分化腺癌	癌	松果体未分化胚細胞腫
挙上期誤嚥	異物誤嚥	習慣性膝蓋骨亜脱臼
腹部膨満増強	腹部膨満	腹部膨満
右副腎腫瘍摘出術	副腎腫瘍	腎摘出術後
右鎖骨痛	鎖骨痛	鎖骨痛
細菌性扁桃炎	扁桃炎	連鎖球菌性扁桃炎
左歯性上顎洞炎	歯性上顎洞炎	歯性上顎洞炎
重度歯周病	歯周症	歯周症
正常圧緑内障	緑内障	正常眼圧緑内障
梗塞後出血	出血性脳梗塞	閉経後出血
骨髄異型性症候群	骨髄異形成症候群	骨髄異形成症候群
光線過敏	光線過敏症	光線過敏症
副睾丸炎	精巣炎	上鼓室炎
虚脱病変	虚脱	熱性虚脱
慢性アレルギー性鼻炎	季節性アレルギー性鼻炎	アレルギー性鼻炎
肘痛	肘関節痛	足痛
夕食前低血糖	低血糖	夜間低血糖症
先天性代謝異常症	代謝障害	先天性色素異常症
単頸双角子宮	双角子宮	単頚双角子宮
原発性肺高血圧症	肺高血圧症	特発性肺動脈性肺高血圧症
左眼加齢性黄斑変性症	加齢黄斑変性	滲出型加齢黄斑変性
左鎖骨リンパ節転移	リンパ節転移	鎖骨上リンパ節転移
殿部色素沈着	色素異常症	ひ素色素沈着
舌浮腫	浮腫	喉頭浮腫
ストレス性潰瘍	ストレス潰瘍	ストレス性胃潰瘍
舌損傷	損傷	肩損傷
発熱下	発熱	発熱
失見当識発言	見当識障害	強直間代発作
右眼内悪性リンパ腫	眼窩悪性リンパ腫	眼窩悪性リンパ腫
腹部大動脈狭窄	大動脈狭窄症	腹部大動脈拡張
右季肋部自発痛	季肋部痛	胸椎部痛
軽度痺れ	しびれ感	膝部腫脹
星芒状血管腫	血管腫	頭頂葉海綿状血管腫
右房内腫瘤	腫瘤	左心房粘液腫
Ｓ状結腸転移	転移性消化器腫瘍	Ｓ状結腸潰瘍
全身掻痒感	そう痒	全身倦怠感
右手舟状骨骨折	手舟状骨骨折	手舟状骨骨折
肉芽腫性腸疾患	腸疾患	肉芽腫性肝炎
両足圧痕性浮腫	浮腫	血管性多形皮膚萎縮症
発作後精神病	精神病	心因性妄想精神病
虫垂粘液嚢胞腺腫	虫垂粘液のう胞	膵管内乳頭粘液性腺癌
四肢水疱	水疱症	四肢乾癬
右足趾骨髄炎	趾骨髄炎	足部骨髄炎
若年性リウマチ	関節リウマチ	若年性関節リウマチ
体陽性脳炎	脳炎	亜急性硬化性全脳炎
境界域ＤＭ	糖尿病	ＣＡＤ／ＣＡＭ冠不適合
結節性不整脈	不整脈	呼吸性不整脈
劇症敗血症	敗血症	敗血症
慢性血腫	血腫	多発性血腫
骨破壊病変	関節リウマチ	潜函病性骨壊死
眼窩部痛	眼痛	心窩部痛
昨日不眠	不眠症	過眠
頚椎脊柱管狭窄症	頚部脊柱管狭窄症	頚部脊柱管狭窄症
発赤域	発赤	発赤
膵頭部転移	転移性膵腫瘍	胸部内臓転位
高度肝障害	肝障害	肝障害
右肺下葉腫瘍	肺腫瘍	肝右葉腫瘍
口腔内発赤腫脹	発赤	口腔外傷性腫脹
中咽頭再発腫瘍	咽頭腫瘍	中咽頭良性腫瘍
左下肢冷感	下肢冷感	下肢冷感
大腫瘍	腫瘍	脳腫瘍
胸骨肋骨転移	肋骨転移	肋骨転移
重症心身障害児	重症心身障害	重症心身障害
腹部軽度膨隆	腹部膨満	腹部膨満
リンパ管症	癌性リンパ管症	リンパ節症
遷延性抑うつ状態	うつ状態	拘禁性抑うつ状態
結核性強膜炎	結核性胸膜炎	結核性硬膜炎
下腿筋萎縮	筋萎縮症	下肢筋萎縮
膵頭癌	癌	膵頭部癌
ＶＡＨＳ	ウイルス関連血球貪食症候群	ＣＡＤＡＳＩＬ
圧痛自発痛	圧痛	圧痛
痰中等量引ける	喀痰	肝内血腫・腹腔に達する開放創合併あり
放射線障害	放射線宿酔	放射線白内障
浅眠	不眠症	過眠
反射異常	異常反射	異常反射
慢性間質性腎炎	慢性尿細管間質性腎炎	急性間質性肺炎
脳溢血	脳卒中	脳出血
右下肢深部静脈血栓症	下肢静脈血栓症	下肢静脈血栓症
カテーテル感染	カテーテル感染症	カテーテル感染症
腫瘍多発	腫瘍	多発乳癌
背部筋緊張高い	筋強直	背部筋肉痛
全身紅斑	紅斑症	全身湿疹
しびれてる感	しびれ感	しびれ感
少量尿失禁	尿失禁症	腹圧性尿失禁
脳腫瘍切除	脳腫瘍	出血性胃潰瘍穿孔
右側下顎骨体部骨折	下顎骨骨折	上腕骨通顆骨折
高血糖是正	高血糖症	高血圧切迫症
腫瘤拡大	腫瘤	腫瘤
病原性大腸菌	病原性大腸菌感染症	病原性大腸菌感染症
耳小骨奇形	耳小骨の先天奇形	中足骨奇形
全身性紫斑	全身性紫斑病	全身性紫斑病
微小多発脳梗塞	多発性脳梗塞	多発性小脳梗塞
右股関節亜脱臼	股関節亜脱臼	股関節亜脱臼
糸球体血尿	血尿	糸球体性血尿
左橈骨神経麻痺	橈骨神経麻痺	橈骨神経麻痺
全身性間代性痙攣	間代性痙攣	間代強直性痙攣
右肋間痛	肋間痛	肋軟骨部痛
右続発性緑内障	続発性緑内障	続発性緑内障
軟骨腫	骨軟骨腫	骨軟骨腫
開大性代謝性アシドーシス	代謝性アシドーシス	代償性代謝性アシドーシス
パニック様症状	全般性不安障害	パニック障害
胆嚢充満結石	胆のう結石症	膿瘍性結腸憩室
左上葉肺転移	転移性肺腫瘍	胸骨傍リンパ節転移
軽度しびれ感	しびれ感	全身のしびれ感
意識レベル低	意識障害	睡眠時無呼吸症候群用口腔内装置不適合
爪囲紅斑	爪囲炎	手掌紅斑
子宮頸癌Ｉｂ１期	子宮頚癌	子宮体癌再発
感覚性運動失調	運動失調	脊髄性運動失調
両側鎖骨上窩リンパ節腫大	リンパ節腫大	鎖骨上リンパ節腫脹
中枢性めまい	中枢性めまい症	中枢性めまい症
関節滑膜炎	滑膜炎	肘関節滑膜炎
続発性膜性腎症	膜性腎症	膜性腎症
立位保持困難	四肢筋力低下	屈伸困難
先天性風疹症侯群	先天性風疹症候群	先天性風疹症候群
左足痺れ	しびれ感	四肢痙攣
Ｒｉｅｄｅｌ甲状腺炎	線維性甲状腺腫	Ｅｕｔｈｙｒｏｉｄ　Ｓｉｃｋ症候群
椎骨動脈狭窄	椎骨動脈狭窄症	総腸骨動脈狭窄
活動性肺結核症	活動性肺結核	活動性肺結核
鼻腔化膿性肉芽腫	細菌性肉芽腫症	化膿性口腔粘膜肉芽腫
痙攣発作再発	痙攣発作	痙攣重積発作
右脛骨内果骨折	足関節内果骨折	脛骨腓骨遠位端骨折
左胸膜転移	胸膜播種	横隔膜転移
卵巣腫瘍再発	卵巣腫瘍	卵巣腫瘍
右肺中葉転移	転移性肺癌	胸部内臓転位
下腿筋痛	下肢筋肉痛	腓腹筋痛
右大腰筋血腫	血腫	腸腰筋膿瘍
十二指腸潰瘍再発	慢性十二指腸潰瘍	再発性十二指腸潰瘍
Ａｆ不変	心室細動	気虚
左下腿部帯状疱疹	帯状疱疹	後頭部帯状疱疹
顔面麻痺１	顔面神経麻痺	顔面神経麻痺
巨大腫瘤	腫瘤	骨腫瘤
右足関節腫脹	足関節腫脹	足関節腫脹
外陰部湿疹	湿疹	外陰部帯状疱疹
両肺副雑音	胸部音異常	梅毒性肺動脈弁逆流症
腎機能異常	腎機能検査異常	膵機能異常
姿勢障害	姿勢異常	味覚障害
左肘頭開放骨折	開放骨折	腓骨頭開放骨折
イレウス発生	イレウス	糞便性イレウス
若干硬結	硬結	硬結
左骨盤内リンパ嚢胞	骨盤部感染性リンパのう胞	肘関節部のう胞性リンパ管腫
発作性３度房室ブロック	第３度房室ブロック	術後房室ブロック
身体損傷	損傷	体幹損傷
右大腿骨骨腫瘍	大腿骨腫瘍	大腿骨骨幹部骨腫瘍
慢性胆嚢炎	慢性胆のう炎	慢性胆管炎
偽性高Ｋ血症	高カリウム血症	悪性高血圧症
反応性胸水	胸水貯留	漏出性胸水
元々痛み	疼痛	身体痛
骨盤内膜症	骨盤子宮内膜症	骨盤子宮内膜症
右耳下腺腫瘤	耳下腺腫瘤	耳下腺腫瘤
肝形質細胞腫	形質細胞腫	形質細胞腫
躁病相	躁状態	躁病性昏迷
易出血傾向	出血傾向	出血傾向
ジューリング疱疹状皮膚炎	ジューリング病	黒色丘疹性皮膚症
末梢発赤	発赤	末梢性動静脈奇形
部分性脂肪萎縮症	部分的脂肪萎縮症	部分的脂肪萎縮症
亜急性脊髄連合変性症	亜急性連合性脊髄変性症	亜急性連合性脊髄変性症
副腎偶発腫	良性副腎皮質腫瘍	転移性副腎腫瘍
右下腿紅斑	紅斑症	下腿扁平母斑
腸管通過障害	消化管狭窄	尿管通過障害
努力様呼吸	起坐呼吸	努力性呼吸
膿疱形成	膿疱	膿疱性ざ瘡
左卵巣膿瘍	卵巣膿瘍	卵管卵巣膿瘍
発赤皮疹	発疹	湿疹続発性紅皮症
赤痢アメーバ大腸炎	アメーバ赤痢	アメーバ性非赤痢性大腸炎
サイトメガロウイルス感染	サイトメガロウイルス感染症	サイトメガロウイルス感染症
Ｇｒａｄｅ　３肝障害	肝障害	ＧＡＬＥ欠損症
低ＡＬＢ血症	低アルブミン血症	高ＬＤＨ血症
Ⅱ型糖尿病	２型糖尿病	２型糖尿病
両顎関節痛	顎関節痛	顎関節痛
逆流性胆管炎	逆行性胆管炎	逆行性胆管炎
関節痛症状	関節痛	関節弛緩症
空気塞栓	空気塞栓症	空気塞栓症
肝膿瘍破裂	肝膿瘍	肝細胞癌破裂
総肺静脈還流異常症	肺静脈還流異常症	肺静脈還流異常症
両下腿痛	下腿痛	下腿痛
左橈骨頭脱臼骨折	脱臼骨折	橈骨頭脱臼
正中創感染	創傷感染症	ＭＲＳＡ術後創部感染
左網膜分枝動脈閉塞症	動脈閉塞症	網膜動脈分枝閉塞症
頸部浮腫	浮腫	頚部肉腫
肺扁平上皮癌、病期不明	肺扁平上皮癌	肺扁平上皮癌
低血圧自覚症状	低血圧症	低血糖発作
常時痛み	疼痛	睡眠時頭痛
倦怠感増	倦怠感	倦怠感
脾臓腫瘍	脾腫瘍	脾腫瘍
多発肝転移増大	転移性肝癌	多発性癌転移
頸部食道狭窄	食道狭窄	食道狭窄
陰茎アポクリン癌	陰茎アポクリン腺癌	陰茎アポクリン腺癌
元来月経痛	月経痛	月経前片頭痛
胆嚢十二指腸瘻	胆のう十二指腸瘻	胃十二指腸瘻
特発性肺胞出血	肺胞出血	特発性腎出血
左鼠径部疼痛	鼡径部痛	陰茎部疼痛
左側頬粘膜癌	頬粘膜癌	頬粘膜癌
円盤状皮疹	円板状エリテマトーデス	円板状乾癬
左手首疼痛	手部痛	腓腹部痛
アレルギー反応	アレルギー	アレルギー性中耳炎
夜間痙攣	痙攣	局所性痙攣
膵体部小嚢胞	腫瘍性膵のう胞	殿部血管脂肪腫
耳介脂漏性湿疹少	脂漏性皮膚炎	皮脂欠乏性湿疹
両側急性硬膜下出血	急性硬膜下血腫	外傷性帽状腱膜下出血
毎回尿失禁	尿失禁症	溢流性尿失禁
喉頭蓋腫脹	喉頭蓋炎	喉頭蓋腫瘍
愁訴	不定愁訴症	宿酔
血腫不変	血腫	不応性血小板減少症
各種膠原病	膠原病	膠原病
肺気胸	気胸	漏斗胸
深部感覚鈍麻	感覚異常症	片側感覚鈍麻
脊柱圧痛	圧痛	胸鎖関節痛
亜脱臼傾向	亜脱臼	多発性関節脱臼
自傷痕	自傷	熱傷瘢痕
嘔吐持続	嘔吐症	睡眠時無呼吸症候群
痙攣重積後脳症	痙攣重積型二相性急性脳症	痙攣重積型急性脳症
小腸大腸型	小腸大腸クローン病	大腸癌
薬剤肝障害	薬物性肝障害	薬剤性腎障害
転移性膵体部癌	膵体部癌	膵体部癌
左前頭葉神経膠腫	前頭葉神経膠腫	前頭葉神経膠腫
精神運動興奮	精神運動興奮状態	精神運動発作
インフルエンザＡ型感染症	インフルエンザＡ型	インフルエンザ菌ｂ型感染症
紅斑反応	紅斑症	輸血反応
右尿管結石症	尿管結石症	尿管結石症
瞳孔不同	瞳孔不同症	瞳孔不同症
多発肝転移巣	転移性肝腫瘍	多発性癌転移
顕微鏡的大腸炎	大腸炎	顕微鏡的多発血管炎
直腸Ｒａ癌	直腸癌	直腸Ｓ状部上皮内癌
原発性アルドステロン	原発性アルドステロン症	続発性アルドステロン症
苔癬局面	苔癬	類苔癬
足趾爪混濁肥厚	ころもじらみ寄生症	足底部皮膚欠損創
ＣＭＶ肺炎	サイトメガロウイルス肺炎	ＭＲＳＡ肺化膿症
右ＩＣＡ狭窄	内頚動脈狭窄症	右室流出路狭窄
痰貯留	喀痰	乳び心のう液貯留
足趾蜂窩織炎	足蜂巣炎	足関節部蜂巣炎
僧帽弁狭窄兼逆流症	僧帽弁狭窄症	僧帽弁逆流症
中背部悪性黒色腫	背部悪性黒色腫	背部悪性黒色腫
歯槽膿漏	歯周炎	歯槽膿瘍
左肘関節破壊	関節リウマチ・肘関節	肘関節拘縮
副甲状腺亢進症	副甲状腺機能亢進症	副甲状腺機能亢進症
右声帯不全麻痺	声帯不全麻痺	声帯不全麻痺
心合併症	心臓合併症	心臓合併症
皮下石灰化	皮膚石灰沈着症	胸膜石灰化
薬剤性発熱	発熱	薬剤性便秘症
労作時前胸部痛	前胸部痛	前胸部痛
肺炎等	肺炎	肺炎
軽度ＡＤＨＤ	注意欠陥多動障害	周期性ＡＣＴＨ・ＡＤＨ放出症候群
新生児一過性多呼	新生児一過性多呼吸	新生児一過性多呼吸
両心房拡大	心肥大	脳室拡大
上転障害	眼球運動障害	眼球運動障害
不眠状態	不眠症	不安緊張状態
プレクリニカルクッシング症候群	クッシング症候群	薬物誘発性クッシング症候群
左胸鎖乳突筋炎	胸鎖乳突筋炎	胸鎖乳突筋炎
腫瘍性	腫瘍	卵巣漿液性境界悪性腫瘍
時々関節痛	関節痛	足関節痛
嫌悪感	悪寒	不潔恐怖症
二次性僧帽弁閉鎖不全症	僧帽弁閉鎖不全症	先天性僧帽弁閉鎖不全症
急性大動脈弁閉鎖不全	大動脈弁閉鎖不全症	大動脈弁閉鎖不全症
左心肥大	心肥大	心肥大
腹痛嘔気	嘔気	腹痛症
前頭部打撲	頭部打撲	頭部腹部打撲
左大腿部骨外性粘液型軟骨肉腫	軟骨肉腫	腓骨骨幹部良性骨腫瘍
高度異形成相当	子宮頚部高度異形成	腟上皮異形成・異型度１
腹緊なし	腹部膨満	緊張性気胸
右頚部ＬＮ腫大	リンパ節腫大	子宮頚部細胞診・軽度扁平上皮内病変
側卵巣嚢腫	卵巣のう腫	卵巣肉腫
哺乳後嘔吐	嘔吐症	妊娠後期嘔吐
右結石性腎盂腎炎	結石性腎盂腎炎	結石性腎盂腎炎
Ｃｒｏｎｋｈｉｔｅ−Ｃａｎａｄａ症候群	クロンカイト・カナダ症候群	Ｅｕｔｈｙｒｏｉｄ　Ｓｉｃｋ症候群
心嚢液貯留	心膜液貯留	心膜液貯留
臓器限局性前立腺癌	限局性前立腺癌	限局性前立腺癌
貧血傾向	貧血	出血傾向
右中大脳動脈梗塞	内頚動脈塞栓症	脳外主幹動脈閉塞脳梗塞
日中傾眠	傾眠症	過眠
脾臓結核	結核	肝結核
食後高血糖	高血糖症	新生児一過性高血糖症
高浸透圧血症	高血糖高浸透圧症候群	低浸透圧血症
両下肢軽度浮腫	下肢浮腫	下肢浮腫
右間歇性跛行	間欠性跛行	間欠性跛行
陰嚢ヘルニア	陰のうヘルニア	陰唇ヘルニア
多形紅斑型薬疹	薬疹	紫斑型薬疹
右腋窩リンパ節腫脹	腋窩リンパ節腫脹	腋窩リンパ節腫脹
静脈内腫瘍栓	腫瘍	静脈性血管腫
爪甲剥離症	爪剥離症	爪剥離症
再度急性腎不全	急性腎不全	分娩後急性腎不全
進行再発大腸癌	大腸癌	胃進行癌
胃接合部癌	胃癌	食道胃接合部癌
耳閉塞感	耳閉感	耳閉感
手足しびれ	しびれ感	手指先しびれ
内膜損傷	損傷	硬膜損傷
胃小彎側ＬＮ転移	胃周囲リンパ節転移	先天性眼裂縮小
軽度発達遅滞	発達遅滞	発達遅滞
非浸潤性膀胱癌	膀胱癌	非浸潤性乳管癌
右先天性耳瘻孔	先天性耳瘻孔	先天性耳瘻孔
脂肪腫摘出	脂肪腫	眼球摘出
椎間板ヘルニア有	椎間板ヘルニア	椎間板ヘルニア
扁平ポリープ	ポリープ	大腸ポリープ
咽頭知覚障害	咽頭異常感症	皮膚知覚障害
腸液貯留	体液貯留	体液貯留
両変形性膝関節症	変形性膝関節症	変形性膝関節症
急性胆嚢胆管炎	胆管炎	急性胆細管炎
扁平上皮癌	癌	卵巣扁平上皮癌
内痔核脱出	内痔核	脱出性内痔核
びまん性脳浮腫	脳浮腫	びまん性脳損傷
呼気困難	呼吸困難	呼吸困難
重症鬱血性心不全	うっ血性心不全	高血圧性心不全
大腸早期癌	大腸癌	大腸粘液癌
喘鳴聴取	喘鳴	睡眠時無呼吸症候群
左乳癌特	乳癌	特発性頚椎硬膜外血腫
Ａ型溶連菌感染症	溶連菌感染症	Ｂ群溶連菌感染症
悪性副腎外褐色細胞腫	褐色細胞腫	悪性褐色細胞腫
傍隔壁型肺気腫	肺気腫	一側性肺気腫
角膜糜爛	角膜びらん	角膜瘢痕
骨盤内播種新生	骨盤転移	新生児播種性血管内凝固
急性非代償性心不全	心不全	急性心不全
最近便秘	便秘症	希釈尿
右頬部痛	頬部痛	頬部痛
右肺動静脈瘻	肺動静脈瘻	肺動静脈瘻
１型高ウイルスＣ型慢性肝炎	Ｃ型慢性肝炎	Ｃ型肝炎ウイルス性関節炎
問題なし膀胱直腸障害	膀胱直腸障害	膀胱直腸障害
Ｌｉｓｔｅｒｉａ腸炎	細菌性腸炎	ＴｒｉｐｌｅＡ症候群
右膿胸	膿胸	右胸心
ヒリヒリ感	疼痛	ヒトデ毒
時折胸痛	胸痛	胸痛
大動脈弁下心室中隔欠損	心室中隔欠損症	室上稜下部心室中隔欠損
右傍矢状静脈洞髄膜腫	髄膜腫	傍矢状洞髄膜腫
無自覚性低血糖	低血糖	無症候性高尿酸血症
両側卵管留血腫	卵管留血腫	卵管留血腫
脱水注意	脱水症	睡眠時無呼吸症候群用口腔内装置破損
心尖部型肥大型心筋症	肥大型心筋症	心尖部肥大型心筋症
右飛蚊症	飛蚊症	胃軸捻症
腎不全保存期	腎不全	末期腎不全
口腔内炎	口内炎	口腔粘膜炎
びまん性大細胞	びまん性大細胞型Ｂ細胞性リンパ腫	びまん性星細胞腫
大うつ病	単極性うつ病	うつ病
肝門部悪性リンパ腫	肝門部リンパ節転移	心臓悪性リンパ腫
精神病性うつ病	うつ病	反復性精神病性うつ病
水疱性類天疱	水疱症	水疱性類天疱瘡
中枢性低換気	換気量減少	中枢性難聴
右膝ＡＣＬ損傷	前十字靱帯損傷	膝部第２度熱傷
全身倦怠感軽度	全身倦怠感	全身倦怠感
混合難聴	難聴	混合性難聴
毛孔一致性丘疹	丘疹	膝色素性絨毛結節性滑膜炎
先天性巨大色素性母斑	巨大母斑細胞母斑	常染色体劣性先天性魚鱗癬
不安大	不安障害	不潔恐怖症
胸骨下液体貯留	体液貯留	心膜液貯留
新出肺転移	転移性肺腫瘍	ＭＲＳＡ術後創部感染
左聴器癌	癌	足母趾腫瘤
多発脳神経障害	多発性脳神経障害	多発性脳神経障害
上腹部リンパ節転移	リンパ節転移	腹腔リンパ節転移
被殻梗塞	被殻出血	橋梗塞
直腸Ｒａｂ癌	直腸癌	直腸癌
軽度高血糖	高血糖症	低血糖
本日硬便少量	便異常	膝蓋骨一次中枢若年性骨軟骨症
２型腫瘤	腫瘤	眼窩腫瘤
右腎無形成	腎無形成	腎無形成
リンパ節圧痛	圧痛	リンパ節腫大
全身性細菌感染症	細菌感染症	細菌感染症
脳髄膜瘤	髄膜脳瘤	髄膜脳瘤
水頭症症状	水頭症	水頭症
小血栓	血液凝固異常	小動脈出血
右耳失聴	聴覚消失	右眼失明
統合失調症合併	統合失調症	小児期型統合失調症
胃痛症状	胃痛	卵巣欠落症状
急性期ＨＩＶ感染症	ＨＩＶ感染症	急性ＨＩＶ感染症候群
右下肢運動障害	四肢運動障害	四肢運動障害
炎症性脱髄性多発根神経炎	慢性炎症性脱髄性多発神経炎	慢性炎症性脱髄性多発神経炎
上行結腸腫瘤	腫瘤	上行結腸腫瘍
過食症状	過食症	過食症
疾病不安	不安障害	不安障害
肺癌手術	肺癌	胃幽門部癌
色素脱失	炎症後色素脱失	炎症後色素脱失
膿貯留	膿瘍	膿胸
片側副腎腫瘍	副腎腫瘍	転移性副腎腫瘍
リンパ節腫脹	リンパ節腫大	リンパ節腫大
右椎骨動脈巨大血栓化動脈瘤	椎骨動脈瘤	椎骨脳底動脈狭窄症
カテ感染	カテーテル感染症	日和見感染
安心感	心気症	腹部不快感
左鼡径ヘルニア再発	鼡径ヘルニア	鼡径ヘルニア
胃食道静脈瘤破裂	食道静脈瘤破裂	食道静脈瘤破裂
左足背蜂窩織炎	足背蜂巣炎	足関節部蜂巣炎
右胸水貯留	胸水貯留	胸水貯留
暗青色斑	青色母斑	黄斑部白斑
ＨＣＶ陽性	Ｃ型肝炎ウイルス感染	ＨＣＶ抗体検査陽性
疲労感生	疲労感	疲労感
感染性静脈血栓症	静脈血栓症	急性静脈血栓症
両側腎腫大	腎腫大	両側肺門リンパ節腫脹
過敏性膀胱炎	膀胱炎	潰瘍性膀胱炎
包交時出血	出血	閉経後出血
右坐骨骨折	坐骨骨折	坐骨骨折
右耳下腺腫脹	耳下腺腫脹	耳下腺腫脹
進行肺癌	肺癌	進行乳癌
肋骨起始部骨転移	肋骨転移	腓骨遠位骨端線損傷
外傷性変化	外傷	外傷性骨化性筋炎
中等度精神遅滞	中等度知的障害	自閉性精神発達遅滞
先天性左股関節脱臼	先天性股関節脱臼	先天性股関節脱臼
リポフスチン沈着	神経セロイドリポフスチン症	コフィン・シリス症候群
鮮血痰	血痰	血痰
壊死性変化	壊死	壊死性炎症
溶連菌感染	溶連菌感染症	溶連菌感染症
局所発赤	発赤	弾発肘
不整脈チーム	不整脈	不整脈
中等度ＣＯＰＤ	慢性閉塞性肺疾患	中等度難聴
胸部圧痛	圧痛	腹部圧痛
両上肢痛	上肢痛	上肢痛
気分不快症状	悪心	気分異常
右上腕骨近位端粉砕骨折	上腕骨近位端粉砕骨折	上腕骨近位端粉砕骨折
乳突蜂巣	乳様突起炎	喉頭蜂巣炎
褥創形成	褥瘡	殿部咬創
ガマ腫	がま腫	ゴム腫
膀胱腫瘍再発	膀胱腫瘍	多発性膀胱腫瘍
夜間せん妄状態	せん妄	老年期妄想状態
神経系腫瘍	腫瘍	神経細胞腫瘍
クッシング徴候	クッシング症候群	クッシング潰瘍
先天性側弯	肋骨異常を伴う先天性側弯症	先天性聾
非定型抗酸菌肺炎	肺炎	非結核性抗酸菌性腱鞘炎
軽度甲状腺腫大	甲状腺腫	中毒性甲状腺腫
手足痺れ	四肢しびれ	手指圧挫傷
節外性濾胞辺縁帯リンパ腫	脾辺縁帯リンパ腫	小児節性辺縁帯リンパ腫
左下葉肺癌	下葉肺癌	下葉肺癌
Ｋｌｅｂｓｉｅｌｌａ　ｐｎｅｕｍｏｎｉａｅ敗血症	新生児クレブシエラ敗血症	Ｅｕｔｈｙｒｏｉｄ　Ｓｉｃｋ症候群
若年性認知症	認知症	老年期認知症
外腸骨域リンパ節腫大	リンパ節腫大	鎖骨上リンパ節腫脹
貧血高度	貧血	体質性低身長
腰部腫瘍	腰椎部腫瘍	腰椎部腫瘍
鼠径ヘルニア	鼡径ヘルニア	鼡径ヘルニア
分化型管状腺癌	癌	単純性結節性甲状腺腫
侵襲性肺アスペルギウス症	侵襲性肺アスペルギルス症	侵襲性肺アスペルギルス症
孤発性ＣＪＤ	孤発性クロイツフェルト・ヤコブ病	特発性無菌性壊死
右下葉結節影	胸部異常陰影	坐骨結節部滑液包炎
軽度左軸偏位	心電図左軸偏位	心電図左軸偏位
左頚部結核性リンパ節炎	結核性リンパ節炎	頚部化膿性リンパ節炎
食道がん	食道癌	自律神経てんかん
肛門部発赤	発赤	咽頭発赤
脳室拡大進行	脳室拡大	脳室拡大
下腿潰瘍	下腿皮膚潰瘍	下腿膿瘍
小脳転移	転移性脳腫瘍	小脳出血
腎盂軽度拡張	腎盂拡張	先天性肥厚性幽門狭窄症
腫瘍指摘	腫瘍	指尖難治性皮膚潰瘍
心臓原発性悪性リンパ腫	心臓悪性リンパ腫	心臓悪性リンパ腫
準夜帯嘔気	嘔気	湿性脚気
成人Ｓｔｉｌｌ病	成人スチル病	ＳＬＥ眼底
脳血管疾患	脳血管障害	毛細血管疾患
左膝窩部痛	膝窩部痛	膝窩部痛
非浸潤性尿路上皮癌	尿管尿路上皮癌	非浸潤性乳管癌
下咽頭がん	下咽頭癌	下咽頭癌
両上肢痺れ	上肢しびれ	上肢不全麻痺
混合性肝癌	肝癌	混合型肝癌
甲状腺痛	甲状腺炎	甲状腺眼症
少量血便	血便	排便後出血
脳梗塞有	脳梗塞	無症候性脳梗塞
痕発赤	発赤	発赤
不消化便	消化不良性下痢	不完全尿閉
末梢性めまい	めまい症	末梢性めまい症
左上腕骨肉腫	上腕骨骨肉腫	上腕骨骨肉腫
四肢型運動失調	運動失調	脊髄性運動失調
産生胃癌	胃癌	産科的脂肪塞栓症
下肢冷感軽度	下肢冷感	下肢冷感
左室内同期不全	左室不全	左室不全
左脛腓骨骨折	腓骨骨折	脛骨腓骨骨折
漿液性腺腫	卵巣漿液性腺腫	卵巣漿液性腺腫
日本海裂頭条虫	日本海裂頭条虫症	日本海裂頭条虫症
先天性脳血管異常	脳動静脈奇形	先天性尿管異常
臀部皮疹	発疹	頭部湿疹
歩行時軽度跛行	跛行	内転歩行
心室中隔扁平化	心室中隔欠損症	室上稜下部心室中隔欠損
フルニエ壊疽	外陰部壊死性筋膜炎	フューム肺炎
肝芽腫再発	肝芽腫	肝芽腫
状血管腫	血管腫	血管腫
卵巣癌破裂	卵巣癌	卵巣腫瘍破裂
右下腿疼痛	下腿痛	腓腹部痛
軽度眼球突出	眼球突出症	眼球突出症
前頭葉障害	前頭葉症候群	前頭葉症候群
歯牙損傷	切歯破折	頭皮損傷
両側乳糜胸水	胸水貯留	仙骨部褥瘡
肺門部リンパ節腫大	肺門リンパ節腫脹	肺門リンパ節腫脹
麻疹罹患歴	麻疹	腰部尋常性乾癬
尿漏れ	尿失禁症	尿溢出
心膜播種	腹膜播種	胸膜播種
髄液播種	腹膜播種	脊髄播種
左腎動脈狭窄症	腎動脈狭窄症	腎動脈狭窄症
体動時創部痛	術創部痛	転子貫通開放骨折
後頭部皮下血腫	頭部皮下血腫	側頭部皮下血腫
ＭＲＳＡ菌血症	ＭＲＳＡ感染症	ＭＲＳＡ感染症
篩骨蜂巣	篩骨洞炎	鼡径部蜂巣炎
左退形成性星細胞腫	退形成性星細胞腫	退形成性星細胞腫
仮性動脈瘤切除	偽性動脈瘤	腹部大動脈瘤切迫破裂
鼻中隔血腫	血腫	鼻中隔腫瘍
左嗅裂ポリープ	ポリープ	篩骨洞ポリープ
労作時疲労	疲労感	戦闘疲労
不定愁訴多	不定愁訴症	不定愁訴症
軽度失調性構音障害	構音障害	固縮性構音障害
びらんからの出血	出血	鼻腔内びらん
動揺性精神神経症状	神経症	器質性精神症状群
過呼吸気味	過換気症	口呼吸
真菌性感染性心内膜炎	細菌性心内膜炎	亜急性感染性心内膜炎
気道狭窄音	気道狭窄	気道狭窄
未分類関節炎	関節炎	単純性関節炎
左視床出血	視床出血	視床出血
骨突出部発赤	発赤	拍動性眼球突出症
神経症性うつ病	抑うつ神経症	反復性精神病性うつ病
右浸潤影	胸部異常陰影	心臓異常陰影
四肢近位筋筋力低下	筋力低下	四肢筋力低下
左耳後部腫瘤	耳後部腫瘤	耳後部腫瘤
右乳腺良性腫瘍	乳腺腫瘍	乳腺悪性腫瘍
左尿管結石性腎盂腎炎	結石性腎盂腎炎	結石性腎盂腎炎
イレウス気味	偽性イレウス	偽性イレウス
筋力低下可能性	筋力低下	筋力低下
咽喉頭違和感	咽喉頭異常感症	肛門部違和感
前立腺癌死	前立腺癌	前立腺癌術後
再度皮疹	発疹	痂皮性膿痂疹
左肩腱板損傷	肩腱板損傷	肩腱板損傷
低形成	骨髄低形成	舌低形成
再脱臼	脱臼	反復性脱臼
左肺動脈狭窄症	肺動脈狭窄症	肺動脈狭窄症
肺動脈弁上狭窄	肺動脈弁上狭窄症	肺動脈弁上狭窄症
後頸部発赤	発赤	下腿発赤
血管原性浮腫	浮腫	血管神経性浮腫
偽粘液腫	粘液腫	粘液腫
毛包向性菌状息肉症	菌状息肉症	菌状息肉症
Ｂｌｕｅ　ｔｏｅ　ｓｙｎｄｒｏｍｅ	末梢動脈疾患	Ｅｕｔｈｙｒｏｉｄ　Ｓｉｃｋ症候群
嚢胞様腫瘤像	腫瘤	後腹膜胚細胞腫瘍
右足不随意運動	不随意運動症	不随意運動症
婦人科癌	癌	子宮峡部癌
両側眼振	眼振	一側上肢振戦
爪水虫	爪白癬	昆虫毒
子宮体癌Ｉａ期	子宮体癌	急性子宮傍結合織炎
過活動型せん妄	せん妄	老人性夜間せん妄
左下肢鬱滞性皮膚炎	うっ滞性皮膚炎	下肢難治性皮膚潰瘍
ＢＰＳＤ	認知症に重なったせん妄	ＨＤＬＳ
進行性核上麻痺	進行性核上性麻痺	進行性核上性麻痺
汎発性水痘感染症	水痘	感染性白癬症
えん下障害	嚥下障害	乳幼児胃腸障害
左上腕悪性黒色腫	上腕部悪性黒色腫	上腕部悪性黒色腫
左側頭葉挫傷	脳挫傷	前頭部挫傷
虚血性肝炎	肝炎	虚血性腸炎
重症敗血症	敗血症	敗血症
幽門前部狭窄	幽門狭窄症	後部尿道狭窄
圧迫移植部ネクローシス	壊死	老人性ＴＴＲアミロイドーシス
子宮頸癌子宮頚癌	子宮頚癌	子宮頚癌
舌乾燥	口腔乾燥症	口唇乾燥
足痛い	足痛	足痛
円形紅斑	紅斑症	多形紅斑
左眼後発性白内障	白内障	先天性中心性白内障
徐脈気味	徐脈	徐脈発作
境界性パーソナリティ障害	境界型パーソナリティ障害	境界型パーソナリティ障害
鼻骨折	鼻骨骨折	鼻骨骨折
膵尾部腫瘤性病変	膵腫瘤	膵体尾部腫瘍
重症腸炎	腸炎	重症潰瘍性大腸炎
左大腿骨転子下骨折	転子下骨折	大腿骨転子部骨折
左低形成腎	低形成腎	低形成腎
肺野すりガラス状陰影	肺野異常陰影	土肥氏鱗状毛のう角皮症
アテローム性血栓性脳梗塞	血栓性脳梗塞	アテローム血栓性脳梗塞
結腸癌肝転移	転移性肝癌	直腸癌骨転移
診察時皮疹	発疹	術後感染症
切開関連性心房粗動	心房粗動	一過性心房粗動
硬性白斑	白斑	老人性白斑
術後不整脈	不整脈	術中不整脈
広範囲脊柱管狭窄症	広範脊柱管狭窄症	広範脊柱管狭窄症
中～低分化肝細胞癌	肝細胞癌	松果体未分化胚細胞腫
起床時咳嗽	咳	遷延性咳嗽
腰骨骨折	腰椎骨折	踵骨骨折
血性腹水貯留	腹水症	心膜液貯留
心理的不安	不安障害	情緒不安定状態
カンジダ肺炎	肺カンジダ症	カンジダ性亀頭炎
右小細胞癌	小細胞肺癌	小細胞肺癌
頬部悪性腫瘍	頬部腫瘍	頚部悪性腫瘍
多源性ＰＶＣ散発	心室期外収縮	強直間代発作
原発性甲状腺機能低下	甲状腺機能低下症	原発性甲状腺機能低下症
ヨードアレルギー	ヨード過敏症	ダニアレルギー
右ＩＣ動脈瘤	内頚動脈脳動脈瘤	後交通動脈瘤
顔面形成	顔面形成異常	顔面形成異常
活動性肝炎	肝炎	活動性慢性肝炎
インフルエンザ陽性	インフルエンザ	インフルエンザ性急性上気道感染
眼球結膜浮腫	結膜浮腫	結膜浮腫
排便なし	便秘症	排便後出血
全身性Ｃａｎｄｉｄａ感染症	カンジダ症	ＭＲＣＮＳ感染症
顔面神経痛	三叉神経痛	頭部神経痛
多発肺膿瘍	肺膿瘍	多発胃潰瘍
疣贅様構造物	疣贅	胃瘻造設状態
アルコ−ル性肝硬変	肝硬変症	アルコール性肝硬変
皮質層状壊死	壊死	動脈硬化性壊疽
発熱随伴症状	発熱	発熱発疹
急性肺動脈血栓塞栓症	肺動脈血栓塞栓症	肺動脈血栓塞栓症
両下肢深部静脈血栓症	下肢静脈血栓症	下肢静脈血栓症
右上腕骨近位端骨折	上腕骨近位端骨折	上腕骨近位端粉砕骨折
脳炎脳症	脳症	脳症
辺縁性脳炎	脳炎	辺縁系脳炎
易疲労性強い	易疲労感	易疲労感
せん妄生	せん妄	疲憊せん妄
右第３趾爪囲炎	爪囲炎	第３趾末節骨骨折
多発縦隔リンパ節転移	縦隔リンパ節転移	縦隔リンパ節転移
家族性ＣＪＤ	家族性クロイツフェルト・ヤコブ病	ＣＡＤ／ＣＡＭ冠低位
圧迫時疼痛	疼痛	神経障害性疼痛
症型Ａ群溶連菌感染症	溶連菌感染症	Ｂ群溶連菌感染症
末梢肺動脈塞栓症	動脈塞栓症	末梢動脈塞栓症
歩容困難	歩行障害	歩行困難
脳室出血	出血	脳室内出血
顔面痺れ	しびれ感	顔面痙攣
尿失禁状態	尿失禁症	腹圧性尿失禁
重度失調性構音障害	構音障害	器質性構音障害
卵巣癌Ⅲｃ期	卵巣癌	充実性卵巣腫瘍
低血糖鞘状	低血糖	低血糖
発赤潰瘍	発赤	感染性角膜潰瘍
左下肺浸潤影	肺部異常陰影	左上大静脈遺残
右大脳動脈未破裂動脈瘤	脳動脈瘤	内頚動脈後交通動脈分岐部動脈瘤
失語正常	失語症	超皮質健忘性失語症
先週頭痛	頭痛	頭痛
ｃｅｌｌ　ｌｅｕｋｅｍｉａ	白血病	Ｅｕｔｈｙｒｏｉｄ　Ｓｉｃｋ症候群
失語持続	失語症	失語症
ＧＣＡ	巨細胞動脈炎	ＭＲＳＡ膿胸
大動脈弁硬化症	大動脈弁狭窄症	大動脈硬化症
多発筋炎	多発性筋炎	多発性筋炎
呼吸促迫症状	呼吸促迫	呼吸促迫
大腿骨骨頭壊死	大腿骨頭壊死	大腿骨頭壊死
呼気喘鳴	喘鳴	呼吸困難
サイトメガロ網膜炎	サイトメガロウイルス網膜炎	サイトメガロウイルス網膜炎
ＡＣＴＨ非依存性Ｃｕｓｈｉｎｇ症候群	クッシング症候群	周期性ＡＣＴＨ・ＡＤＨ放出症候群
次週左気胸	気胸	巨大動静脈奇形（四肢病変）
内分泌機能不全	内分泌機能異常	膵外分泌機能不全
熱	発熱	Ｑ熱
Ｍａｌｌｏｒｙ−Ｗｅｉｓｓ症候群	マロリ・ワイス症候群	Ｅｕｔｈｙｒｏｉｄ　Ｓｉｃｋ症候群
軽度音声障害	音声障害	音声障害
緑膿菌腸炎	緑膿菌性腸炎	緑膿菌肺炎
ドレーン出血	出血	エボラ出血熱
副鼻腔転移	副鼻腔癌	副鼻腔結核
原発不明癌頸部転移	原発不明癌	神経内分泌腫瘍・原発部位不明
発熱中	発熱	発熱
再発腫瘤	腫瘤	多発性皮下腫瘤
右錐体路障害	錐体路障害	錐体路障害
犬吠様咳嗽	咳	道化師様魚鱗癬
両下肢筋痛	下肢筋肉痛	下肢筋肉痛
左室ブロック波形	心電図異常	完全左脚ブロック
有痛性腫瘤	腫瘤	多発性皮下腫瘤
難治性冠攣縮性狭心症	冠攣縮性狭心症	冠攣縮性狭心症
起床時頭痛	頭痛	睡眠時頭痛
Ⅱ型房室ブロック	房室ブロック	高度房室ブロック
眼白内障	白内障	後極白内障
慢性下気道感染	急性気管支炎	慢性上気道炎
乳頭様腎盂腫瘍	腎盂乳頭状癌	胆管内乳頭状腫瘍
喀痰付着	喀痰	異常喀痰
両側下腿潰瘍	下腿皮膚潰瘍	下腿皮膚潰瘍
心肺停止後蘇生	心肺停止	来院時心肺停止
ＳＣＤ	脊髄小脳変性症	ＡＩＤＳ
無症候性腸アメーバ症	腸アメーバ症	慢性腸アメーバ症
手首痛	手部痛	手指痛
頸部食道癌	頚部食道癌	頚部食道癌
症候性てんかん発症	症候性てんかん	症候性てんかん
左腎血管腫	腎血管腫	腎血管腫
地誌的失認	失認	言語失認
命令性幻聴	幻聴	連続性雑音
子宮体癌Ⅱ期	子宮体癌	脊髄性筋萎縮症ＩＩＩ型
両側副腎腫瘍	副腎腫瘍	転移性副腎腫瘍
左顔面神経麻痺症状	顔面神経麻痺	中枢性顔面神経麻痺
左顔面痛覚障害	片側痛覚鈍麻	皮膚知覚障害
顎部痛	顎痛	胸骨部痛
元々疼痛	疼痛	腰痛症
粘膿性鼻汁	鼻汁	粘液性鼻漏
膣原発横紋筋肉腫	横紋筋肉腫	横紋筋肉腫
卵巣嚢腫ＯＰ	卵巣のう腫	卵巣腫瘍
遅発性ペースメーカー感染症	ペースメーカ植え込み後感染症	ペースメーカ植え込み後感染症
子宮筋肉腫	子宮肉腫	子宮癌肉腫
肺血管陰影増強	肺血管疾患	肺血管狭窄症
頭頸部放線菌症	放線菌症	皮膚放線菌症
腎機能障害	腎機能低下	腸機能障害
Ｈｏｄｇｋｉｎ　Ｌｙｍｐｈｏｍａ	ホジキンリンパ腫	Ｅｕｔｈｙｒｏｉｄ　Ｓｉｃｋ症候群
冠動脈−肺動脈瘻	肺動脈瘻	肺動脈瘻
嚥下時疼痛	嚥下痛	嚥下痛
術後創感染	術後膿瘍	術後創部感染
大腸ポリープ後	大腸ポリープ	大腸ポリープ
右下葉扁平上皮癌	下葉肺扁平上皮癌	下葉肺扁平上皮癌
咳嗽法	咳	喀痰
高リスク前立腺癌	前立腺癌	進行性前立腺癌
門脈圧亢進	門脈圧亢進症	門脈圧亢進症
認知面低下	軽度認知障害	視力低下
ノカルジア	ノカルジア症	ノカルジア症
右人工膝関節感染	人工膝関節感染	人工膝関節感染
膿梗塞	脳梗塞	腎梗塞
下大静脈狭窄	大静脈狭窄症	下大静脈拡張
十二指腸穿通性潰瘍	穿通性十二指腸潰瘍	穿通性十二指腸潰瘍
左横隔膜弛緩症	横隔膜弛緩症	横隔膜弛緩症
火傷	熱傷	膝損傷
入眠困難感	不眠症	夜間呼吸困難
非定型カルチノイド腫瘍	カルチノイド	卵巣甲状腺腫性カルチノイド
軽度食欲低下	食欲不振	上肢筋力低下
尿管結石有	尿管結石症	下部尿路結石
両下腿壊疽性膿皮症様潰瘍	膿皮症	下腿難治性皮膚潰瘍
冠攣縮型狭心症	冠攣縮性狭心症	冠攣縮性狭心症
恥骨骨髄炎	骨髄炎	恥骨骨膜炎
かすみ目	視力低下	爪かみ
眩暈消失	めまい	味覚消失
手指関節腫脹	関節炎	手指関節脱臼
ＳＰＮ	充実性偽乳頭状腫瘍	ＰＣＷＨ
夜間嘔気	嘔気	夜間性喘息
左足背発赤	下腿発赤	足背膿瘍
女性器クラミジア感染症	クラミジア感染症	新生児クラミジア感染症
血液凝固障害	血液凝固異常	血液凝固異常
慢性的な呼吸困難	呼吸困難	慢性呼吸不全
右肺下葉肺炎	肺炎	乳嚥下性肺炎
低酸素虚血性脳症	低酸素性脳症	低酸素性脳症
左大葉性肺炎	大葉性肺炎	大葉性肺炎
膵臓癌術後再発	膵癌	直腸癌術後再発
足底湿疹	足湿疹	足湿疹
歩行ふらつき	めまい	そとわ歩行
結腸縫合不全	縫合不全	結腸回転不全
多発肝血管腫	多発性肝血管腫	多発性肝血管腫
紅色腫瘤	腫瘤	眼瞼良性腫瘤
気管支閉鎖症	気管支閉鎖	気管閉鎖症
神経アミロイドーシス	アミロイドーシス	原発性アミロイドーシス
夜疼痛	疼痛	疼痛
咽頭粘膜発赤	発赤	咽頭発赤
時々不整脈	不整脈	閉経後骨粗鬆症・大腿部病的骨折あり
多発性リンパ節転移	多部位リンパ節転移	多部位リンパ節転移
新生児死亡	原因不明の死亡	新生児仮死
最近花粉症	花粉症	遺伝性掌蹠角化症
食道空腸吻合部狭窄	吻合部狭窄	回腸導管出口部狭窄
クリオグロブリン性血管炎	クリオグロブリン血症性血管炎	クリオグロブリン血症性血管炎
右頬部擦過傷	頬部擦過創	頬部擦過創
右肺下葉癌	下葉肺癌	下葉肺癌
腎結石多発	腎結石症	多発性腎結石
ＥＢウイルス初感染	ＥＢウイルス感染症	ＥＢウイルス感染症
外表奇形	奇形	舌奇形
急性膵臓炎	急性膵炎	急性膵炎
Ｉｓｐポリープ	大腸ポリープ	舌ポリープ
咽頭部発赤	発赤	咽頭発赤
頭部腫瘍	頭部皮下腫瘍	頭部腫瘤
遅発性発疹	発疹	突発性発疹症
肺炎悪化	肺炎	肺炎結核
朝痰	喀痰	夜間咳
子宮体癌Ⅳ期	子宮体癌	慢性子宮傍結合織炎
骨外腫瘤形成	腫瘤	骨盤内腫瘤
低悪性度Ｂ細胞性リンパ腫	びまん性大細胞型Ｂ細胞性リンパ腫	ＡＬＫ陽性大細胞型Ｂ細胞性リンパ腫
視神経脊髄炎（ＮＭＯ）	視神経脊髄炎	視神経脊髄炎
左下副甲状腺腺腫	副甲状腺腺腫	副甲状腺腺腫
単形性ＶＴ	非持続性心室頻拍	無菌性骨壊死
特発性心室細動	心室細動	一過性心室細動
高脂血症高脂血症	高脂血症	高脂血症
白色調腫瘍	腫瘍	黄色腫症
左頬部有棘細胞癌	頬部有棘細胞癌	頬部有棘細胞癌
Ｇｏｔｔｒｏｎ徴候	ゴットロン丘疹	ゴットロン丘疹
脊柱起立筋膿瘍	筋膿瘍	肛門括約筋内膿瘍
左踵骨骨折	踵骨骨折	踵骨骨折
胃癌幽門狭窄	幽門狭窄症	膵管狭窄
拡張能障害	心不全	強迫性障害
小腸静脈瘤破裂	食道静脈瘤破裂	胃静脈瘤破裂
右上肢振戦	一側上肢振戦	一側上肢振戦
中枢性甲状腺機能低下症	甲状腺機能低下症	一過性甲状腺機能低下症
左肺動脈閉塞	肺動脈狭窄症	肺動脈弁閉鎖
単純性網膜症	網膜症	単純性角膜潰瘍
両眼性複視	複視	両眼隔離
Ｈｅｎｏｃｈ−Ｓｃｈｏｎｌｅｉｎ紫斑病	ＩｇＡ血管炎	Ｅｕｔｈｙｒｏｉｄ　Ｓｉｃｋ症候群
右胸腔内腫瘍	腫瘍	胸腔内腫瘤
尿もれ	尿失禁症	胆のう癒着
下肢筋力低下自覚	筋力低下	上肢筋力低下
右足静脈瘤	静脈瘤	左胃動脈瘤
上気道浮腫	咽頭浮腫	上気道出血
複雑型熱性痙攣	熱性痙攣	無熱性痙攣
吻合部浮腫	浮腫	吻合部潰瘍
右膀胱側壁部膀胱癌	膀胱側壁部膀胱癌	膀胱側壁部膀胱癌
Ｃａｐｎｏｃｙｔｏｐｈａｇａ　ｃａｎｉｍｏｒｓｕｓ感染症	グラム陰性菌感染症	ＭＲＣＮＳ感染症
子宮頸部頸管狭窄	子宮頚管狭窄症	子宮頚部萎縮
呼吸喘鳴	喘鳴	呼吸麻痺
口腔内乾燥	口腔乾燥症	口内乾燥
脊椎管狭窄症	脊柱管狭窄症	脊柱管狭窄症
ヘルペス髄膜炎	髄膜炎	ヘルペス角膜炎
左股関節破壊	股関節症	股関節損傷
左前庭障害	前庭障害	末梢前庭障害
膠原繊維性腸炎	腸炎	膠原病性心膜炎
食道期軽度障害	嚥下障害	食道通過障害
右外腸骨静脈狭窄	静脈狭窄	外腸骨動脈狭窄
妊娠発覚	妊娠	妊娠中出血
両膝関節症	膝関節症	肘関節症
類もやもや病	もやもや病	もやもや病
呼内疾患ベース肺炎	肺炎	呼吸細気管支炎関連性間質性肺疾患
左足関節開放性脱臼骨折	足関節開放性脱臼骨折	手関節開放性脱臼骨折
白色粘性痰	喀痰	深在性白癬
食道癌２病変	食道癌	食道癌骨転移
右卵巣奇形腫	卵巣奇形腫	卵巣奇形腫
感冒罹患	感冒	褥瘡感染
血腫像	血腫	血腫
ｌｙｍｐｈｏｍａ	悪性リンパ腫	ＴｒｉｐｌｅＡ症候群
左足首骨折	足関節骨折	足背骨折
慢性血栓性肺高血圧症	慢性血栓塞栓性肺高血圧症	慢性血栓塞栓性肺高血圧症
眼振誘発	眼振	眼筋麻痺性眼振
急性ウイルス性脳炎	ウイルス性脳炎	急性ウイルス性肝炎
掻痒等	そう痒	排尿痛
労作時呼吸困難感軽度	労作時呼吸困難	労作時呼吸困難
逆流性食道炎症状	逆流性食道炎	胃食道逆流症
非代償性Ｃ型肝硬変	Ｃ型非代償性肝硬変	Ｃ型非代償性肝硬変
子宮筋腫大	子宮筋腫	子宮筋腫
ヘルペス感染症	ヘルペスウイルス感染症	ヘルペスウイルス感染症
抑うつあり	うつ状態	躁うつ病
出血腫脹	出血	精巣腫脹
急性感音性難聴	感音難聴	急性低音障害型感音難聴
肺塞栓既往	肺塞栓症	肺静脈血栓塞栓症
リンパ節多発転移	多部位リンパ節転移	リンパ節転移
ｉｎｖａｓｉｖｅ　ｔｈｙｍｏｍａ	悪性胸腺腫	急性大動脈解離ＤｅＢａｋｅｙＩ
イレウスリスク高い	イレウス	ＧＭ２ガングリオシドーシス２型
左肺下葉扁平上皮癌	下葉肺扁平上皮癌	下葉肺扁平上皮癌
分類不能型免疫不全	免疫不全	分類不能免疫不全症
高度拘束性換気障害	拘束性換気障害	拘束性換気障害
非典型的胸痛	胸痛	典型的前兆に頭痛を伴う片頭痛
ＭＲＳＡ感染	ＭＲＳＡ感染症	ＭＲＳＡ感染症
肝多発腫瘤	肝腫瘤	多発性肝血管腫
左大腿骨病的骨折	大腿骨病的骨折	大腿骨病的骨折
Ｓ状結腸癌術後肝転移	転移性肝癌	直腸癌骨転移
棘波	心電図異常	棘融解
黄色痰自己喀出	膿性痰	自己臭恐怖
心膜腔内播種	転移性心腫瘍	胸膜播種
耳痛	耳痛症	鼻痛
四肢末端しびれ	しびれ感	四肢端しびれ
内頸動脈狭窄	内頚動脈狭窄症	腕頭動脈狭窄
胃部分壊死	壊死	腎乳頭壊死
転倒受傷	外傷	外傷性両足切断
左急性感音難聴	感音難聴	両側性感音難聴
タール便少量	黒色便	特殊書読遅滞
切除不能胃癌	胃癌	大腸切除症候群
後頭葉脳出血	脳出血	後頭孔脳脱出症
隅角結節	虹彩結節	臼傍結節
落ち着かなさ	多動性障害	さめはだ
脊椎多発圧迫骨折	圧迫骨折	腰椎多発圧迫骨折
左傍脊柱筋膿瘍	筋膿瘍	先天性胸鎖乳突筋腫瘤
Ⅰ型ＤＭ	糖尿病	ニーマン・ピック病Ｃ型
多発ＬＮ転移	多部位リンパ節転移	多発性癌転移
右角膜ヘルペス	ヘルペス角膜炎	眼瞼単純ヘルペス
大腸粘膜癌	癌	大腸粘液癌
大動脈損傷	上大動脈損傷	動脈損傷
仙骨前腫瘤	腫瘤	仙骨軟骨肉腫
前頭葉脳出血	脳出血	前頭部脳膿瘍
社会不安症	不安神経症	社会不安障害
左頚部食道傍リンパ節転移	リンパ節転移	胸骨傍リンパ節転移
時折物忘れ	健忘症	分娩時ショック
左頬部未分化腺癌	癌	頚部転移性腺癌
ＩＩ型ＤＭ	２型糖尿病	ニーマン・ピック病Ｃ型
脊椎管狭窄	脊柱管狭窄症	脊柱管狭窄症
膨満　グル音正常	腹部膨満	異常発汗
顔面神経麻痺静的再建	顔面神経麻痺	術後顔面神経麻痺
低分化性扁平上皮癌	癌	転移性扁平上皮癌
左房内粘液腫	心臓粘液腫	左心房粘液腫
重症うつ病	うつ病	内因性うつ病
左肺下葉浸潤影	胸部異常陰影	中葉肺扁平上皮癌
中葉舌区症候群	中葉無気肺	中葉症候群
膵管炎	膵炎	卵管炎
軟部組織腫瘤	腫瘤	頚部軟部腫瘍
腫瘤構造	腫瘤	腫瘍
慢性誤嚥	嚥下障害	慢性裂肛
Ｇｍ敗血症	敗血症	ＧＢＳ敗血症
右大腿部蜂窩織炎	大腿部蜂巣炎	大腿横紋筋肉腫
病的腹水	腹水症	異常腹水
慢性疲労	疲労感	慢性疲労症候群
膿性喀痰	膿性痰	膿性痰
Ｃｈｏｌｅｄｏｃｈｏｃｅｌｅ	総胆管のう腫	Ｅｕｔｈｙｒｏｉｄ　Ｓｉｃｋ症候群
癌再発	癌	乳癌再発
胆汁うっ滞型	胆汁うっ滞	肝内胆汁うっ滞
肺門腫瘤	縦隔腫瘍	肺腫瘤
両膝関節疼痛	膝関節痛	下腿関節痛
右鎖骨転移	骨転移癌	胸椎転移
緑内症	緑内障	緑内障
夕方痛み	疼痛	顔面痛
左側副部痛	側腹部痛	胸骨後面痛
後腹膜腫瘍上行結腸浸潤	後腹膜腫瘍	上行結腸粘膜下腫瘍
心窩部自発痛	心窩部痛	心窩部痛
リンパ節腫大傾向	リンパ節腫大	リンパ節腫大
時々尿失禁	尿失禁症	夜間呼吸困難
左臀部悪性軟部腫瘍	殿部悪性軟部腫瘍	膝部悪性軟部腫瘍
低血糖遷延	低血糖	低血糖昏睡
右中大脳動脈閉塞症	中大脳動脈閉塞症	中大脳動脈閉塞症
重症ＣＭＶ腸炎	サイトメガロウイルス腸炎	非特異性直腸Ｓ状結腸炎
発熱コントロール	発熱	ホルンタイププロトラクター破損
右下腿蜂窩織炎	下腿蜂巣炎	胃蜂窩織炎
膿瘍形成	膿瘍	脊髄膿瘍
右尿管損傷	尿管損傷	尿管損傷
感染性心内膜症	感染性心内膜炎	感染性心内膜炎
ブドウ球菌検出	ぶどう球菌感染症	非定型奇形腫様／ラブドイド腫瘍
副腎皮質機能不全	副腎皮質機能低下症	副腎皮質形成不全
Ｅｓｃｈｅｒｉｃｈｉａ　ｃｏｌｉ	大腸菌感染症	Ｅｕｔｈｙｒｏｉｄ　Ｓｉｃｋ症候群
両側網膜剥離	網膜剥離	胞状網膜剥離
播種性血管内凝固症	播種性血管内凝固	播種性血管内凝固
肺野肺門部異常陰影	肺門部異常陰影	肺門部異常陰影
右房浸潤	乳房悪性腫瘍	左上大静脈遺残
屈筋腱鞘炎	腱鞘炎	趾伸筋腱腱鞘炎
肺結節陰影	胸部異常陰影	肺門部異常陰影
呼吸困難感等自覚症状	呼吸困難	外傷性呼吸困難症
原発性肺腫瘍	肺腫瘍	原発性脳腫瘍
右下腿コンパートメント症候群	下腿コンパートメント症候群	下腿コンパートメント症候群
右鎖骨上窩リンパ節腫大	鎖骨上リンパ節腫脹	鎖骨上リンパ節腫脹
右鼡径部腫脹	鼡径部腫脹	鼡径部腫脹
低悪性度リンパ腫	ホジキンリンパ腫	悪性リンパ腫
右側胸部皮下結節	皮下結節	小指ＭＰ関節尺側側副靱帯損傷
両側卵巣チョコレート嚢胞	チョコレートのう胞	背部血管脂肪腫
回盲部悪性リンパ腫	悪性リンパ腫	脳悪性リンパ腫
陰部腫脹	陰のう腫大	頭部腫脹
腹水浸出	腹水症	滲出性腹水
ＴＡＡ	胸部大動脈瘤	ＡＩＤＳ
腸管皮膚瘻	腸瘻	尿管皮膚瘻
ライン感染	カテーテル感染症	ドライブライン感染
多発擦過傷	擦過創	多発性挫滅傷
脂質異常	脂質異常症	脂質異常症
肺嚢胞感染	肺のう胞	肛門淋菌感染
Ｃｈｕｒｇ−Ｓｔｒａｕｓｓ　症候群	好酸球性多発血管炎性肉芽腫症	Ｅｕｔｈｙｒｏｉｄ　Ｓｉｃｋ症候群
脾結核	結核	腎結核
潰瘍性大腸炎急性増悪	潰瘍性大腸炎	慢性副鼻腔炎急性増悪
肺抗酸菌感染症	肺非結核性抗酸菌症	肺炎球菌感染症
２型大腸癌	大腸癌	直腸Ｓ状部結腸癌
両眼網膜症	網膜症	近視性網膜症
左眼結膜炎	結膜炎	眼瞼結膜炎
右肺原発腺癌	肺腺癌	肺粘表皮癌
ＣＲＥＳＴ症候群	クレスト症候群	ＰＯＥＭＳ症候群
感覚神経障害	知覚障害	視神経障害
物忘れ	健忘症	肉離れ
脳筋症	ミトコンドリア脳筋症	脳症
駆細胞型急性リンパ性白血病再発	急性リンパ性白血病	成人Ｔ細胞白血病リンパ腫・慢性型
左大腿骨骨腫瘍	大腿骨腫瘍	大腿骨骨幹部骨腫瘍
膿瘍縮小	膿瘍	頚部膿瘍
右後頭葉塞栓性脳梗塞	塞栓性脳梗塞	塞栓性脳梗塞
肝内転移	転移性肝腫瘍	肝癌骨転移
膵管内乳頭粘液腫瘍	膵管内乳頭粘液性腫瘍	膵管内乳頭粘液性腫瘍
胃癌多発骨転移	胃癌骨転移	胃癌骨転移
僧房弁疣贅	疣贅	顔面疣贅
左膝窩動脈瘤	膝窩動脈瘤	膝窩動脈瘤
腹部背部痛	背部痛	胸背部痛
アルコール性ニューロパチー	アルコール性多発ニューロパチー	アルコール性多発ニューロパチー
体幹部発赤	発赤	体幹開放創後遺症
慢性突発性血小板減少性紫斑病	血小板減少性紫斑病	慢性特発性血小板減少性紫斑病
下部消化管穿孔	腸穿孔	下部消化管出血
Ｔ字杖歩行可能	歩行障害	歩行困難
鎖骨上リンパ節腫大	鎖骨上リンパ節腫脹	鎖骨上リンパ節腫脹
右大腿ヘルニア嵌頓	大腿ヘルニア嵌頓	大腿ヘルニア嵌頓
大腫瘤影	腫瘤	肺腫瘤陰影
双極２型障害	２型双極性障害	２型双極性障害
感染性腹部動脈瘤	感染性腹部大動脈瘤	感染性腹部大動脈瘤
ヘルペス性脳炎	サル痘	ヘルペス脳炎
不安症様	不安神経症	不潔恐怖症
右前額部痛	前頭部痛	前額部挫傷
右胸膜播種	胸膜播種	胸膜播種
骨折病変	骨折	変形治癒骨折
半月体形成糸球体腎炎	半月体形成性糸球体腎炎	半月体形成性糸球体腎炎
筋力低下著明	筋力低下	緩徐進行１型糖尿病・糖尿病性合併症なし
下肢骨折	骨折	上肢骨折
付属器圧痛	圧痛	分娩後付属器炎
アスピリンアレルギー	アスピリン不耐症	卵アレルギー
固形腫瘍	腫瘍	蝶形骨腫瘍
嘔吐出現	嘔吐症	未熟児無呼吸発作
統合失調症残遺状態	統合失調症	残遺型統合失調症
右上肢不全片麻痺	不全片麻痺	上肢不全麻痺
低血糖生	低血糖	低血糖
劇症型肺炎球菌性敗血症	肺炎球菌性敗血症	肺炎球菌性敗血症
左大腿蜂窩織炎	蜂窩織炎	大腿横紋筋肉腫
発熱有	発熱	先天性無痛無汗症
頭位性回転性めま	体位性めまい	回転性めまい
不眠考	不眠症	不眠症
全失語	全失語症	全失語症
口唇紅潮	紅潮	口唇梅毒
開腹腫瘤	腫瘤	腹壁腫瘤
左尺骨神経障害	尺骨神経麻痺	手関節部絞扼性神経障害
外側部乳癌	乳癌	乳房上内側部乳癌
脳幹部神経膠腫	脳幹神経膠腫	脳幹神経膠腫
両足関節以遠しびれ感	しびれ感	閉経後骨粗鬆症・大腿部病的骨折あり
左再発性気胸	続発性気胸	特発性気胸
胃のむかつき	悪心	陰のうびらん
気管性喘息	気管支喘息	気管支喘息
痒疹結節散在	痒疹	結節性痒疹
日中下痢	下痢症	食事性下痢
骨粗鬆症有	骨粗鬆症	骨粗鬆症
先天性胆管欠損	胆管先天奇形	先天性膀胱欠損
左深部静脈血栓症	深部静脈血栓症	深部静脈血栓症
冠性Ｔ波	心電図異常	異常脳波
多発胸膜肥厚斑	胸膜肥厚	胸膜肥厚
カンジダ眼内炎	眼内炎	カンジダ性亀頭炎
副腎転移	転移性副腎腫瘍	腹膜転移
左緊張性気胸	緊張性気胸	緊張性気胸
度腟壁裂傷	腟裂傷	会陰腟壁裂傷
仙骨部腫瘤	腫瘤	前腕部腫瘤
帯状疱疹再燃	帯状疱疹	帯状疱疹性脳炎
左前胸部腫瘤	前胸部腫瘤	前胸部腫瘤
喘息症状	咳喘息	心因性喘息
ふらつく気	よろめき歩行	涙のう炎
拡張障害型心不全	心不全	高血圧性心不全
アカシジア症状	錐体路障害	クラミジア肺炎
間歇的腹痛	腹痛症	周期性腹痛
左肺舌区扁平上皮癌	肺扁平上皮癌	肺扁平上皮癌
星状細胞腫	星細胞腫	星状芽細胞腫
急性腎障害	腎障害	急性胃腸障害
左鎖骨上リンパ節腫脹	鎖骨上リンパ節腫脹	鎖骨上リンパ節腫脹
陳旧性脳出血	脳出血	陳旧性脳梗塞
良性下垂体腫瘍	下垂体腫瘍	悪性下垂体腫瘍
腸雑音聴取可	異常腸音	睡眠時無呼吸症候群用口腔内装置破損
左側頭部帯状疱疹	帯状疱疹	後頭部帯状疱疹
左肺原発性肺癌	原発性肺癌	原発性肺癌
頭蓋内出血性病変	非外傷性頭蓋内出血	頭蓋内占拠性病変
閉塞性睡眠呼吸障害	睡眠時無呼吸症候群	閉塞性睡眠時無呼吸
右披裂部腫瘍	腫瘍	眼瞼部腫瘍
両膝変形	変形性膝関節症	足部変形
表在性腫瘍	腫瘍	限局性表在性腫脹
左母指多指症	副母趾	母指三指節症
両側側脳室軽度拡大	脳室拡大	視床下部性卵巣機能低下
脈性右室心筋症	不整脈原性右室心筋症	不整脈原性右室心筋症
アルコール性末梢神経障害	アルコール性多発ニューロパチー	アルコール性神経筋障害
縦隔炎併発	縦隔炎	横隔膜痙攣症
暗紅色斑	紅斑症	黄斑部白斑
骨盤圧痛	骨盤痛	骨盤痛
骨巨細胞腫瘍	骨巨細胞腫	骨巨細胞腫
Ｌａｎｇｈａｎｓ巨細胞	ランゲルハンス細胞組織球症	ランゲルハンス細胞組織球症
気管支喘息発症	気管支喘息	気管支喘息発作
分葉状嚢胞性腫瘤	腫瘤	後腹膜胚細胞腫瘍
胆管拡張	胆管拡張症	膵管拡張
甲状腺肥大	甲状腺疾患	甲状腺過形成
患肢発赤	発赤	眼熱傷後遺症
好中球浸潤	好中球増加症	不応性好中球減少症
多房性腫瘤	腫瘤	多発性皮下腫瘤
夜間不安	不安障害	不穏状態
右上肢線状強皮症	線状強皮症	線状強皮症
左内耳障害	迷路障害	嗅覚障害
左耳介発赤	発赤	先天性鼻中隔弯曲症
朝方倦怠感	倦怠感	倦怠感
後頚部脂肪腫	頚部脂肪腫	頚部脂肪腫
副腎性クッシング症侯群	クッシング症候群	薬物誘発性クッシング症候群
混合性アルカローシス	アルカローシス	呼吸性アルカローシス
痛く	疼痛	股痛
皮疹再燃	発疹	潰瘍性大腸炎再燃
再発悪性リンパ腫	悪性リンパ腫	頚部悪性リンパ腫
子宮筋腫手術	子宮筋腫	子宮筋腫術後
時折心窩部痛	心窩部痛	心窩部痛
右足根骨骨折	足根骨骨折	中足骨亀裂骨折
腕頭静脈血栓症	静脈血栓症	前腕静脈血栓症
脊椎病変	脊椎異常	脊椎萎縮
歯状核	歯状核赤核淡蒼球ルイ体萎縮症	尾状核出血
右脛骨骨幹部骨折	脛骨骨幹部骨折	脛骨骨幹部骨折
両側腎盂軽度拡張	腎盂拡張	尿管回腸導管吻合部狭窄
軽度屈曲拘縮	屈曲拘縮	屈曲拘縮
左下肺野陰影	下肺野陰影	下肺野陰影
ＥＢＶ腸炎	細菌性腸炎	ＭＲＳＡ腸炎
左側舌癌	舌癌	舌下面癌
足しびれ	下肢しびれ	手指先しびれ
膵内分泌腫瘍肝転移	転移性肝癌	膵外分泌腫瘍