出現形	正解	予測
副腎原発神経芽腫	副腎神経芽腫	歩容異常
Ｗｅｎｃｋｅｂａｃｈ型房室ブロック	ウェンケバッハ型第２度房室ブロック	中指中節骨開放骨折
痰貯留多	喀痰	淋菌性結膜炎
皮膚リンパ腫	菌状息肉症	趾化膿創
個細胞壊死	壊死	心臓粘液腫
左大腿骨顆上骨折	大腿骨外顆骨折	頚椎化膿性脊椎炎
病原性大腸菌Ｏ−１５７感染性腸炎	病原性大腸菌感染症	発熱発疹
口腔粘膜浮腫	浮腫	妊娠高血圧網膜症
腟粘膜発赤	発赤	デュビン・ジョンソン症候群
レム睡眠行動異常症	レム睡眠行動障害	脳血管先天奇形
閉塞性膵炎	膵炎	騒音性難聴
脱髄性疾患	脱髄疾患	点状出血
多発性脾膿瘍	脾膿瘍	背部悪性末梢神経鞘腫
間質性肺水腫	肺水腫	聴覚消失
無動性無言	無動性無言症	エボラ出血熱
舌扁平上皮癌	舌癌	腟のう胞
両側肺門部浸潤影	胸部異常陰影	偽視神経炎
軽度悪心	悪心	髄液混濁
慢性活動性ＥＢウルス感染症	ＥＢウイルス感染症	心因性腹痛
蛋白尿減少	蛋白尿	環椎破裂骨折
脳障害	脳症	顔面神経損傷
中心性奬液性網脈絡膜症	中心性漿液性網脈絡膜症	グラスアイオノマーセメント破損
左一側性反回神経麻痺	一側性反回神経麻痺	間質性肺炎
イレウス様	イレウス	外耳道奇形
膵炎併発	膵炎	壊死性膵炎
ｈｅｍｏｐｈａｇｏｃｙｔｉｃ　ｓｙｎｄｒｏｍｅ	血球貪食症候群	血小板無力症
抗癌剤漏出	薬剤漏出性皮膚障害	気管支喘息発作
水痘帯状疱疹	帯状疱疹	神経母斑症
ｓｙｓｔｅｍｉｃ　ｍａｓｔｏｃｙｔｏｓｉｓ	肥満細胞腫症	サルモネラ敗血症
発汗多量	多汗症	顎関節偽痛風
早発黄疸	早発性黄疸	１型糖尿病性ケトアシドーシス
急性細菌性気管支炎	急性気管支炎	眼内レンズの機械的合併症
右上葉肺小細胞癌	上葉肺大細胞癌	頚部蜂巣炎
腟癌１期	腟癌	中心性脈絡膜炎
会陰部発赤	発赤	口蹄疫
嚥下時痛軽度	嚥下痛	フライ症候群
左顔面血管腫	顔面血管腫	スモーカーメラニン沈着症
鼻汁多く	鼻汁	急性呼吸器感染症
口腔内出血痕	口腔出血	外耳道閉塞性角化症
ＳＩＡＤ	抗利尿ホルモン不適合分泌症候群	サルモネラ敗血症
夜両足痛	足痛	角膜上皮剥離
左後頭葉梗塞	脳梗塞	大腿骨顆部骨折
左内眼角基底細胞癌	眼角基底細胞癌	麻痺側浮腫
難治性イレウス	イレウス	外耳道奇形
副鼻腔腫瘍	鼻副鼻腔腫瘍	アルカリホスファターゼ値異常
大腸菌菌血症	菌血症	線維肉腫
右前頭葉出血	脳出血	咽頭麻痺
左膝部痛	膝窩部痛	産褥敗血症
仙椎陳旧性骨折	陳旧性骨折	タナトフォリック骨異形成症
乳癌既往	乳癌	植込型除細動器電池消耗
軽度咽頭発赤	咽頭発赤	上腕動脈瘤
痙攣起	痙攣	ＨＤＬＳ
下肢浮腫圧痕	下肢浮腫	腹圧性尿失禁
左側頬部腫脹	頬部腫脹	充実性卵巣腫瘍
心室中隔穿孔	心室中隔欠損症	転移性蝶形骨洞癌
四肢浮腫軽度	四肢浮腫	先天性反張膝
大腸ポリープ　ポリペク後	大腸ポリープ	先天性魚鱗癬
腰椎椎体椎間板炎	腰椎椎間板炎	新生児大腸菌敗血症
左下葉肺炎悪化	大葉性肺炎	子宮頚部環状剥離
ぼんやり感持続	反応性低下	エッドウズ・スプールウェイ症候群
右鼠径部痛	鼡径部痛	ビタミンＣ欠乏症
皮疹不変	発疹	肺結核・鏡検確認あり
創部痛	術創部痛	大腿単独欠損
軽度右気胸	気胸	大動脈弁閉鎖不全症兼肺動脈弁狭窄症
腸閉塞歴	イレウス	網膜中心静脈閉塞症による黄斑浮腫
左大腿骨骨折	大腿骨骨折	大腿神経麻痺
紅斑局面多発	紅斑症	強皮症性ミオパチー
下部進行食道癌	食道癌	急性右室梗塞
無γグロブリン血症	無ガンマグロブリン血症	アッシャー症候群
子宮頸管ポリープ切除	子宮頚管ポリープ	角膜移植拒絶反応
手首疼痛	疼痛	角膜上皮剥離
ｓｐｌｅｎｉｃ　ｍａｒｇｉｎａｌ　ｚｏｎｅ　ｌｙｍｐｈｏｍａ	脾辺縁帯リンパ腫	シャガス病脊髄炎
体動時息ぎれ	労作時呼吸困難	後天性動静脈瘻
一部浮腫	浮腫	器質性の妄想状態および幻覚妄想状態
ふらつき注意	よろめき歩行	口部ジスキネジア
左中耳炎	中耳炎	陰茎萎縮
胃食道逆流症状	胃食道逆流症	顎関節雑音
両側卵巣子宮内膜症性嚢胞	卵巣子宮内膜症のう胞	総義歯義歯床下粘膜異常
新出肝転移	転移性肝癌	膀胱下垂
脊椎カリエス	脊椎結核	示指ガングリオン
行動障害	素行障害	腹壁ヘルニア
妊娠性糖尿病	妊娠糖尿病	先天性無ガンマグロブリン血症
小豆大紅斑	紅斑症	強皮症性ミオパチー
ＦＳＧＳ	巣状糸球体硬化症	血小板無力症
左寛骨臼骨折	寛骨臼骨折	Ｃ型肝炎合併妊娠
原発性両眼内悪性リンパ腫	眼窩悪性リンパ腫	癌
腹腔鏡補助下子宮筋腫核	子宮筋腫	心サルコイドーシス
両下肢静脈血栓	下肢静脈血栓症	手指骨骨肉腫
神経根障害	神経根炎	足部皮膚癌
クモ膜下出血	くも膜下出血	肛門第１度熱傷
後鼻汁症候群	後鼻漏	自閉症スペクトラム障害
糖尿病性腎症１期	腎性糖尿	神経過敏
左臀部慢性膿皮症	慢性膿皮症	高血圧性心不全
メサンギウム増殖性腎炎	メサンギウム増殖性糸球体腎炎	限局性虫垂炎
左前頭葉心原性脳梗塞	心原性脳塞栓症	糖尿病性腎不全
閉塞性尿路感染	尿路感染症	腸間膜神経叢損傷
顔面蝶形紅斑	ＬＥ蝶形皮疹	強皮症性ミオパチー
上行結腸癌肝転移	転移性肝癌	尿道膿瘍
仙骨部色素沈着	色素異常症	第５趾有棘細胞癌
肥満糖尿病	糖尿病	陰茎挫傷
左肩痛み	肩部筋痛	クリオグロブリン血症性血管炎
ＰＳＶＴ発作	発作性上室頻拍	血小板無力症
顎変形症術後顎変形症	顎変形症	腟痙
ＤＭＮ　２期	糖尿病	シャガス病脊髄炎
労作時胸部絞扼感	胸内苦悶	心因性消化不良症
右膝変形	変形性膝関節症	異所性胸腺
指趾潰瘍	趾皮膚潰瘍	非器質性遺尿症
２型食道癌	食道癌	副甲状腺過形成
骨性腫瘤	腫瘤	四肢痙攣
外傷性脊髄損傷	脊髄損傷	気管断裂
下肢結節性紅斑	結節性紅斑	胃切除後癒着
左動眼神経麻痺	動眼神経麻痺	サーファーズイヤー
家族性海綿状血管腫	海綿状血管腫	直腸膀胱瘻
術中直腸損傷	直腸損傷	肺胞微石症
下肢動脈瘤	下肢の動脈瘤	基底核部海綿状血管腫
精神病様症状	精神病	光線性花弁状色素斑
項頸部痛	頚部痛	細菌性膀胱炎
頸部白斑	白斑	糖尿病黄斑症
左大腿骨転子部粉砕骨折	転子下骨折	乳房癌検診
最近眠気	非器質性過眠症	起立性蛋白尿
ＶＨＤ	心臓弁膜症	血小板無力症
夜頻尿	夜間頻尿症	レジン前装金属冠不適合
回盲部炎	回盲部憩室炎	歯の形成異常
重症肺血栓塞栓症	肺塞栓症	老視
左歯痛	歯痛	顎堤異常吸収
腹膜播種切除	腹膜播種	肋軟骨離断
右乳突蜂巣	乳様突起炎	副腎皮質腫瘍
右肺尖部気胸	気胸	軸椎脊索腫
骨盤内子宮内膜症	子宮内膜症	狂信的パーソナリティ障害
左頬部痛	頬部痛	帝王切開創感染症
局麻薬アレルギー	薬物過敏症	口苦
肺クリプトコックス症	急性肺クリプトコッカス症	中枢性睡眠時無呼吸
右肩関節亜脱臼半横指	肩関節亜脱臼	類上皮肉腫
慢性蕁麻疹	慢性じんま疹	５ｑ−症候群
マラセチア毛嚢炎	マラセチア毛包炎	頭部神経痛
高分化型漿液性腺癌	癌	急性硬膜下血腫・頭蓋内に達する開放創合併なし
腫瘍床	腫瘍	小指中手骨遠位端骨折
左膀胱尿管逆流症	膀胱尿管逆流	動脈硬化性網膜症
外側疼痛	疼痛	足底多汗症
卵巣癌再発卵巣癌	卵巣癌	ヤング・シンプソン症候群
錐体路病変	錐体外路系疾患	不適合輸血反応
リンパ球性白血病	リンパ性白血病	ライ症候群
クラミジア感染	クラミジア感染症	手指伸筋腱断裂
奬液性嚢胞腺腫	膵漿液性のう胞腺腫	小児もやもや病
夜間倦怠感	倦怠感	殿部メルケル細胞癌
脳血栓塞栓症	脳血管閉塞性脳梗塞	食道悪性間葉系腫瘍
左リウマチ性肘関節症	関節リウマチ・膝関節	下顎下部腫瘤
右下腿潰瘍感染	下腿皮膚潰瘍	中毒
気分不快時	悪心	脳表ヘモジデリン沈着症
問題なし前立腺肥大	前立腺肥大症	舌骨骨折
急性パルボウイルスＢ１９感染症	パルボウイルス感染症	詐聴
脂肪性腫瘤	脂肪腫	結腸消化管間質腫瘍
ウィルス性肺炎	肺炎	乳頭表皮剥脱
類円形紅斑	紅斑症	強皮症性ミオパチー
書字不能	書痙	構語障害
肺動脈狭窄	肺動脈狭窄症	自傷
夜間不眠状態	不眠症	人工弁感染
熱型	発熱	膵臓癌骨転移
骨盤内充実性腫瘍	骨盤腫瘍	第１４番染色体父親性ダイソミー症候群
夢遊病	夢遊症	会陰部血腫
脊髄小脳変性症６型	脊髄小脳変性症	腰仙部神経根炎
左内頚動脈閉塞	内頚動脈閉塞症	頭部悪性黒色腫
両側角乾燥性結膜炎	結膜炎	マレー糸状虫症
脳虚血症状	脳虚血症	心因性難聴
微熱持続	微熱	眼の上皮内癌
夕方浮腫	浮腫	結腸脂肪肉腫
眼性疲労	眼精疲労	発音補整装置不適合
直腸肛門奇形	鎖肛	新生児口蓋のう胞
右大腿部腫瘍	大腿悪性軟部腫瘍	脳神経悪性腫瘍
頚椎症神経根症	頚椎症性神経根症	亜急性細菌性心膜炎
壊死性遊走性紅斑	遊走性紅斑	エルゴステロール欠乏症
睡眠障害招くリスク	睡眠障害	シリコーンオイル注入眼
上大静脈血栓	静脈血栓症	更年期出血
骨盤内ＬＮ転移	骨盤内リンパ節転移	側頭部扁平母斑
ＰＫＤ	多発性のう胞腎	血小板無力症
分水嶺脳梗塞	脳梗塞	意義不明の単クローン性免疫グロブリン血症
上皮性腫瘍	腫瘤	グルタル酸血症２型
大球性正色素貧血	大球性貧血	直腸切断術後後遺症
挙上空腸穿孔	腸穿孔	ビタミンＫ欠乏症
腸管アメーバ感染症	腸アメーバ症	骨軟骨腫
放射線性皮膚炎	放射線皮膚炎	背部熱傷
肛門周囲びらん	外痔びらん	新生児歯
髄膜炎徴候	髄膜炎	緊張性内斜視
胸部不快	胸内苦悶	閉鎖性胆のう損傷
下葉肺炎	肺炎	馬尾神経腫瘍
右足根部粉砕骨折	粉砕骨折	乳歯歯根吸収不全
蛋白漏出胃腸症	蛋白漏出性胃腸症	イタイイタイ病
左大脳陳旧性ラクナ梗塞	陳旧性ラクナ梗塞	亜急性涙のう炎
出血多量	急性大量出血	口腔上顎洞瘻
腹水多量	腹水症	転移性肺腫瘍
腸間膜リンパ管腫	リンパ管腫	１型糖尿病性腎症第５期
右卵巣悪性腫瘍	卵巣悪性腫瘍	結膜メラノーシス
糖尿病（２型）	２型糖尿病	項部打撲傷
化膿性胸鎖関節炎	化膿性関節炎・胸鎖関節	いびき
右乳腺線維腫症	線維腫	直腸クローン病
肺野鬱血像	肺野異常陰影	関節強直
児嘔気	嘔気	急性細菌性心膜炎
尿閉歴	尿閉	結膜瘢痕
陰嚢びらん	陰のうびらん	腓骨頭骨折
精神的ショック	ショック	肝外傷
右上腕骨外側上顆炎	外側上顆炎	上腕骨近位骨端線離開
子宮頚上皮内癌	子宮頚部上皮内癌	脊椎炎
難治性非定型性抗酸菌症	非結核性抗酸菌症	突出痛
軽度腹水	腹水症	転移性肺腫瘍
湿疹様	湿疹	珪肺結核
大後頭孔狭窄	軟骨形成不全症	転移性腟腫瘍
熱型変化	発熱	ウイルス関連血球貪食症候群
右無機能腎	無機能腎	腰椎損傷
月経痛コントロール不十分	月経痛	頭部多発打撲傷
左鎖骨下動脈閉塞	鎖骨下動脈閉塞症	興奮型痴愚
右ＤＶＴ	深部静脈血栓症	血小板無力症
非特異的胸痛	胸痛	単純ヘルペス
Ａｅｒｏｍｏｎａｓ　ｈｙｄｒｏｐｈｉｌａ敗血症	敗血症	サイトメガロウイルス性肝炎
重症細菌性敗血症	敗血症	難治性皮膚潰瘍
逆行性健忘	逆向性健忘	仙骨開放骨折
腹直筋膜下血腫	筋肉内血腫	脛骨腓骨骨幹部開放性粉砕骨折
関連腎臓病	腎疾患	永久歯萌出不全に起因した咬合異常
認知症様症状	認知症	新生児脳出血
顎骨骨折	下顎骨骨折	ＤＩＰ関節部ガングリオン
高度大動脈弁狭窄	大動脈弁狭窄症	副腎髄質の悪性腫瘍
右顔面骨骨折	顔面骨骨折	膝部異物
炎症性粉瘤	粉瘤	回腸膀胱瘻
左腰部疼痛	腰痛症	原発性肺ペスト
ＨＣＶ重複感染症	Ｃ型肝炎ウイルス感染	頬腔異物
脂質異常症（＋）	脂質異常症	一次性頭痛
上腹部圧痛	腹部圧痛	皮膚原発性未分化大細胞リンパ腫
両側椎骨動脈瘤	椎骨動脈瘤	職業性難聴
非ケトン性高血糖	高血糖高浸透圧症候群	全足位
Ｙｅｒｓｉｎｉａ腸炎	エルシニア腸炎	副眼瞼
声帯浮腫	声帯炎	口蓋垂炎
誤嚥性肺炎併発	誤嚥性肺炎	肩甲骨開放骨折
咳嗽持続	咳	母指有棘細胞癌
左側下顎骨嚢胞	顎骨のう胞	ひょう疽
右末梢前庭障害	末梢前庭障害	直腸狭窄
胆管閉鎖症	胆管閉塞症	顎下腺唾石症
閉塞性動脈硬化症　症状	閉塞性動脈硬化症	連鎖球菌感染症
洞不全	洞不全症候群	続発性血小板減少性紫斑病
特発性リンパ浮腫	リンパ浮腫	梅毒性痙性脊髄麻痺
シャント吻合部狭窄	透析シャント狭窄	しらみ媒介性回帰熱
無気力	無力症	裂溝性鼻
胸骨炎	胸骨周囲炎	無髄歯
ナッツアレルギー	ピーナッツアレルギー	大腿部第３度熱傷
甲状腺乳頭癌術後再発	甲状腺乳頭癌	口唇外傷性腫脹
上肢疼痛	疼痛	切歯破折
Ｔｕｒｎｅｒ症候群	ターナー症候群	精索欠損
肝臓機能障害用	肝機能障害	卵巣癌全身転移
左心不全徴候	心不全	閉鎖性矢状洞部硬膜外血腫
ＩＰＭＮ癌化	膵管内乳頭粘液性腺癌	縦隔膿瘍
後発頚部転移	頚部転移性腫瘍	小耳症
下痢治	下痢症	殿部胞巣状軟部肉腫
朝方疼痛	疼痛	閉経期障害
蜂窩肺形成	蜂窩織炎	耳下腺炎
右ＩＣＡ高度狭窄	内頚動脈狭窄症	胸骨傍ヘルニア
膵体部嚢胞	膵のう胞	ゴールドブラット腎
右気管支狭窄	気管支狭窄症	急性咽頭喉頭炎
非ヘルペス性辺縁系脳炎	辺縁系脳炎	手関節症
無症候性ＶＴ	心室頻拍	新生児ビタミンＫ欠乏症
好酸球増多	好酸球増加症	関節脱臼後遺症
口腔清掃	個人衛生の著しいレベル低下	胸椎横断麻痺
両下腿皮膚潰瘍	下腿皮膚潰瘍	サットン母斑
無石性胆嚢炎	胆のう炎	上下肢リンパ浮腫
ｓ型ポリープ	ポリープ	趾挫傷
時折頭痛	頭痛	炭坑夫塵肺症
関節リウマチ発症	関節リウマチ	先天性がま腫
残像腫瘍	腫瘍	トリソミー症候群
両顎下腺腫大	顎下腺肥大	腸骨悪性腫瘍
夜間中途覚醒時	睡眠障害	踵骨滑液包炎
今朝頭痛	頭痛	炭坑夫塵肺症
眼球偏移	眼球偏位	イズラン病
腹腔内癒着高度	腹膜癒着	頭頂部挫創
右母指多指症	多指症	断端神経痛
薬剤性骨髄抑制	骨髄機能低下	早期血栓閉鎖型大動脈解離
肥満	肥満症	放射線性顎骨壊死
網膜中心動脈閉塞	網膜中心動脈閉塞症	希発月経
中枢神経悪性リンパ腫再発	悪性リンパ腫	閉鎖性胸管損傷
旅行者下痢症	下痢症	雀卵斑
右声帯ポリープ	声帯ポリープ	低出産体重児
非Ｂ非Ｃ型肝硬変	肝硬変症	十二指腸乳頭癌
頭部皮下結節	皮下結節	被包型胸腺腫
足がむくみ	下肢浮腫	ハンチントン病
下肢潰瘍	下肢皮膚潰瘍	口腔粘膜結核
難治性胸腹水	難治性腹水	膵管拡張
幻覚症状	幻覚	咽頭内異物による窒息
異常腫瘤	腫瘤	鼻部皮膚良性腫瘍
未破裂脳動脈瘤コイル塞栓	未破裂脳動脈瘤	顎骨インプラント不適合
左下顎骨慢性骨髄炎	慢性顎骨骨髄炎	頚部肉芽腫
左側頭葉膠芽腫	側頭葉膠芽腫	亜急性皮膚エリテマトーデス
脳血管障害性パーキンソニズム	脳血管障害性パーキンソン症候群	アタッチメント脱離
右後角脳室内出血	脳室内出血	若年性特発性関節炎・膝関節
難治性浮腫	高度浮腫	壊疽性臍ヘルニア
Ｇｒａｎｕｌｏｍａｔｏｓｉｓ　ｗｉｔｈ　ｐｏｌｙａｎｇｉｉｔｉｓ	多発血管炎性肉芽腫症	サルモネラ敗血症
再発脊索腫	脊索腫	甲状腺機能低下症
Ｃ型肝硬変症	Ｃ型肝硬変	クレアチニンクリアランス低下
左踵部悪性黒色腫	踵部悪性黒色腫	胸水真菌陽性
未分化癌	癌	内視鏡検査中腸穿孔
両側副腎悪性リンパ腫	悪性リンパ腫	妄想性障害
帯状疱疹無	帯状疱疹	神経母斑症
左膝痛み	膝関節痛	産褥敗血症
右下腿痛	下腿痛	白内障術後結膜炎
気管支喘息症状	気管支喘息	足挫創
大腿骨内顆骨壊死	特発性大腿骨内顆骨壊死	巨細胞動脈炎
炎症性貧血	貧血	頚部ボーエン病
両下肢掻痒感	皮膚そう痒症	陳旧性手指捻挫
右後頭葉脳挫傷	脳挫傷	マグネシウム欠乏性テタニー
女性化乳房	女性化乳房症	低レニン血症
ｍａｓｓ　ｌｅｓｉｏｎ	腫瘤	サルモネラ敗血症
右大脳半球多発脳梗塞	多発性脳梗塞	神経因性膀胱
大動脈弁膜症	大動脈弁弁膜症	インフルエンザＢ型
鎮静困難	興奮状態	副腎髄質過形成
再発腫瘤近傍	腫瘤	前腕皮膚良性腫瘍
右下腿麻痺	下肢麻痺	先天性肺動脈異常
切除不能多発性肝転移	転移性肝腫瘍	副腎腫瘍
腹腔内膿瘍形成	膿瘍	細胞性免疫不全症
発作性上室性頻拍	発作性上室頻拍	自然頭位分娩
筋肉痛生	筋肉痛	アルポート症候群
腰椎滑り症	腰椎すべり症	軟口蓋多形腺腫
淡血性胸水	血性胸水	条虫症
腎被膜下出血	外傷性腎被膜下血腫	過敏性乳児
仙骨部褥瘡痕	仙骨部褥瘡	有糸分裂性不分離トリソミー１８
左肝腫瘍	肝腫瘍	胎向異常胎児
非Ｃｌｏｓｔｒｉｄｉｕｍ性ガス壊疽	ガス壊疽	職業喘息
リンパ腺腫脹	リンパ節腫大	趾化膿創
心室二段脈	心室性二段脈	若年性慢性硬膜下血腫
鼻腔腫瘍摘出	鼻腔腫瘍	陰のう結核
疼痛時頓用	疼痛	悪性腫瘍に伴う貧血
多房性膿瘍	膿瘍	足根骨萎縮
右耳介後部痛	耳痛症	非特異骨髄炎
左胸壁腫瘍切除	胸壁腫瘍	パリノー結膜炎
無呼吸症候群	無呼吸発作	Ｂ型肝炎
右尿管癌	尿管癌	母指球部痛
出血過多	出血	口腔上顎洞瘻
甲状腺嚢腫	甲状腺のう胞	鼻部外傷性腫脹
両側浸出性中耳炎	滲出性中耳炎	流産後乏尿
覚醒度	麻酔覚醒遅延	コルチ器異常
高血糖	高血糖症	胸椎部打撲挫傷
有意弁膜症	弁膜炎	眼瞼皮膚炎
胸痛無	胸痛	猫ひっかき病
右下肺野無気肺	無気肺	会陰血腫
小脳性失調	小脳性運動失調症	前腕血管脂肪腫
好酸球増多症	好酸球増加症	関節脱臼後遺症
右腎明細胞肉腫	腎明細胞肉腫	群発頭痛
甲状腺左葉濾胞腺腫	濾胞性甲状腺腺腫	原発性アメーバ性髄膜脳炎
下位運動ニューロン徴候	運動ニューロン疾患	前頭頂骨進入
主幹動脈狭窄	脳動脈狭窄症	環指末節骨亀裂骨折
創部皮下血腫	外傷性皮下血腫	軽度遠視
掻痒感軽減	そう痒	乾癬性関節炎・足関節
両肺小結節影	肺野異常陰影	関節強直
造影剤アレルギー歴	薬物過敏症	副腎髄質機能亢進症
左眼鼻涙管閉塞症	鼻涙管閉鎖症	胃底腺ポリープ
慢性的な抑うつ気分	うつ状態	仮性膵のう胞
鼻部異物肉芽腫	皮膚異物肉芽腫	眼角部眼瞼炎
遠隔ＬＮ転移	リンパ節転移	血小板無力症
子宮がん	子宮癌	反復性角膜潰瘍
Ｂｉｃｋｅｒｓｔａｆｆ型脳幹脳炎	ビッカースタッフ脳幹脳炎	網膜下出血
睾丸腫脹	精巣腫脹	手舟状骨骨折
右中皮腫	中皮腫	葉酸欠乏性貧血
ジベル薔薇色粃糠疹	ジベルばら色粃糠疹	水頭症性無脳症
脳実質外腫瘍	腫瘍	アカントアメーバ角膜炎
抑鬱感	気うつ	殿部メルケル細胞癌
扁桃腺腫大	扁桃肥大	網電図異常
口内出血	口腔出血	外耳道閉塞性角化症
右上方視野欠損	視野欠損	頚椎良性腫瘍
両側臼蓋形成不全症	臼蓋形成不全	両側下肢多発骨折
進行肝癌	肝癌	胸鎖関節痛
噴門部狭窄	胃狭窄	外傷性腎血腫・骨盤腔に達する開放創合併あり
突発性腎出血	腎出血	膝蓋骨軟骨肉腫
前股関節症	股関節症	肝周囲膿瘍
多発肝嚢胞	多発性肝のう胞	肝門部腫瘍
過換気状態	過換気症	卵巣胚細胞腫瘍
傍大動脈ＬＮ	大動脈周囲リンパ節転移	蚊媒介出血熱
左椎骨動脈低形成	骨髄低形成	慢性漿液性中耳炎
左房拡張	心拡大	ペリー症候群
サルモネラ菌感染症	サルモネラ感染症	ナジェ症候群
両側性多発性嚢胞腎	多発性のう胞腎	乳房異物
化学物質アレルギー	アレルギー	口苦
右手指腫脹	手指腫脹	肥大性扁桃炎
右足背発赤	発赤	少関節型若年性関節炎・手関節
脊柱管高度狭窄	脊柱管狭窄症	鉄沈着性白内障
右急性網膜壊死	急性網膜壊死	腫瘍崩壊症候群
皮膚硬化がまだかなり	新生児皮膚硬化症	うっ血性巨脾
口腔内乾燥軽度	口腔乾燥症	喘鳴
下肢筋痛	下肢筋肉痛	背部軟部腫瘍
蠕動不良	異常腸音	腹壁ヘルニア
四肢腱反射亢進	反射亢進	爪甲形成不全
黒色丘疹	丘疹	タングクリブ破損
胸部陰影	胸部異常陰影	陰のう炎
クモ膜下嚢胞	くも膜のう胞	胆道回虫症
２次性糖尿病	二次性糖尿病	溶剤刺激性接触皮膚炎
Ｈａｅｍｏｐｈｉｌｕｓ　ｉｎｆｌｕｅｎｚａｅ敗血症	敗血症	サイトメガロウイルス性肝炎
慢性期疼痛	慢性疼痛	悪性腫瘍に伴う貧血
右上葉原発肺小細胞癌	小細胞肺癌	頚部蜂巣炎
出血源不詳	出血	精神障害
一般細菌感染	細菌感染症	アルカプトン尿性関節症
急性小脳失調症	急性小脳性失調症	前腕血管脂肪腫
浸潤癌化所見	癌	縦隔膿瘍
痔核脱出	痔核	住血吸虫性皮膚炎
重症膵炎	膵炎	尿道瘻開口部に対する手当て
痛みアリ	疼痛	円蓋部髄膜腫
左心室内血栓症	心室内血栓症	口角口唇炎
右足疼痛	疼痛	角膜上皮剥離
増殖前網膜症	網膜症	正中頚部瘻
傍神経節腫瘍	傍神経節腫	大腿骨近位端骨肉腫
小腸膀胱瘻	膀胱皮膚瘻	慢性胸膜炎
左小細胞肺癌	小細胞肺癌	後鼻孔閉鎖症
少量左胸水	胸水貯留	条虫症
多発ＨＣＣ再発	肝細胞癌	焦点性知覚性発作
結核性嚢腫	結核	ＩｇＧサブクラス欠損症
右大腿骨外顆骨折	大腿骨外顆骨折	卵巣機能障害
巨大膵仮性嚢胞	仮性膵のう胞	下肢切断
大腿腫脹	下腿腫脹	高血圧性脳症
全身性ＣＭＶ感染症	サイトメガロウイルス感染症	金属歯冠修復不適合
多発肝内転移	転移性肝腫瘍	尿道膿瘍
右外耳道炎	外耳炎	高コレステロール血症性黄色腫
両下肢圧痕性浮腫	クインケ浮腫	腹圧性尿失禁
下部腸間膜動脈出血	動脈性出血	左脚ブロック
ＩｇＭ型Ｍ蛋白	単クローン性免疫グロブリン血症	非リウマチ性三尖弁狭窄症
喘息発作様症状	気管支喘息発作	穿通性十二指腸潰瘍
分食道癌	食道癌	副甲状腺過形成
多少便秘気味	便秘症	排尿障害
ポリープ状病変	ポリープ	趾挫傷
既往高血圧	高血圧症	侵襲性髄膜炎菌感染症
右リウマチ性膝関節症	関節リウマチ・膝関節	血中鉄異常
急性骨髄性白血病（ＡＭＬ）	急性骨髄性白血病	膀胱憩室結石
腹水大量	腹水症	転移性肺腫瘍
全身皮膚発赤	発赤	口蹄疫
多発肺嚢胞	肺のう胞	先天性中心性白内障
右小脳橋角部腫瘍	小脳橋角部腫瘍	特発性基底核石灰化症
右眼網膜静脈分枝閉塞症	網膜静脈分枝閉塞症	腸脛靱帯症候群
右脛骨腓骨開放骨折	脛骨腓骨開放骨折	神経節芽細胞腫
左側卵巣腫瘍	卵巣腫瘍	血管迷走神経性失神
口腔内びらん	口唇びらん	冠状動脈血栓塞栓症
紅斑熱群リケッチア症	リケッチア感染症	歯内歯
ＩＴＰ	特発性血小板減少性紫斑病	サルモネラ敗血症
気管支喘息小発作	気管支喘息発作	胸椎症性脊髄症
解離性動脈瘤破裂	解離性動脈瘤	股関節中心性脱臼骨折
左眼窩内腫瘍	眼窩腫瘍	慢性特発性血小板減少性紫斑病
肺外小細胞癌	小細胞肺癌	成人型大動脈縮窄症
高度大動脈弁狭窄症	大動脈弁狭窄症	胸部気管損傷・胸腔に達する開放創合併なし
ｂｒｅａｋｔｈｒｏｕｇｈ　ｈｅｐａｔｉｔｉｓ	肝炎	ペルオキシソーム病
左室圧排	右室肥大	血液ガス値異常
両側声帯外転障害	声帯外転筋麻痺	舌下腺萎縮
一部水疱形成	水疱症	上腕扁平母斑
糖尿病潰瘍	糖尿病性潰瘍	子宮頚延長
飲みこみにくさ	嚥下障害	腋窩アポクリン腺癌
左腎低形成	低形成腎	視床症候群
左母趾疼痛	母趾痛	胃神経内分泌腫瘍
副腎ヒストプラズマ感染症	真菌症	心臓転位症
右眼糖尿病網膜症	糖尿病網膜症	非還納性腹壁瘢痕ヘルニア
下肢浮腫左	下肢浮腫	眼部咬創
両松葉杖歩行	歩行障害	フェルティー症候群
冠動脈狭窄３枝病変	狭心症３枝病変	腰椎骨髄炎
遺伝性低尿酸血症	低尿酸血症	過長月経
低アルドステロン血症	低アルドステロン症	マンディブラリトラクター破損
小腸皮膚瘻	皮膚瘻	皮膚良性腫瘍
重度僧帽弁狭窄症	僧帽弁狭窄症	尿管損傷・骨盤腔に達する開放創合併なし
非細菌性血栓性疣贅	疣贅	多形紅斑
特発性腸間膜血腫	血腫	先天性肺動脈狭窄合併妊娠
脳原発性悪性リンパ腫	脳悪性リンパ腫	線虫症
抜管後両側反回神経麻痺	両側性反回神経麻痺	三叉神経痛第１枝領域
肝骨転移	骨転移癌	頭部筋肉痛
乳腺線維腫症	線維腫	直腸クローン病
術後左反回神経麻痺	反回神経麻痺	門脈圧亢進症性胃腸症
無症候性髄膜腫	髄膜腫	外頚静脈損傷
左肺下葉肺癌	下葉肺癌	虚血性心疾患
アルコール離脱症候群	アルコール離脱状態	肥満細胞性白血病
左腸骨骨肉腫	腸骨軟骨肉腫	趾中節骨良性腫瘍
脳梁低形成	脳梁形成不全	瀑状胃
表皮内水疱形成	先天性表皮水疱症	頬粘膜血管腫
後頚部圧痛	圧痛	胸部損傷
不定愁訴様	不定愁訴症	牛乳によるアナフィラキシーショック
良性胆道狭窄	胆管狭窄症	外傷性髄液鼻漏
左下葉非小細胞肺癌	下葉非小細胞肺癌	鼡径ヘルニア嵌頓
ＣＫＤ　腎硬化症	腎硬化症	腹膜転移
前頭葉出血	出血	咽頭麻痺
有茎性乳頭状腫瘍	腫瘍	母指ＭＰ関節不安定症
理解困難	言語理解障害	上腕良性軟部腫瘍
スメア異常	腟スメア細胞診陽性	股関節症
腹腔内敗血症	敗血症	４分の３冠破損
膵尾部腫大	膵腫大	筋膜結核
過呼吸状態	過換気症	水腎水尿管症
右肺門部原発肺小細胞癌	小細胞肺癌	成人型大動脈縮窄症
胃癌骨髄癌腫症	骨髄転移	先天性冠状動脈瘤
眼乾燥感	ドライアイ	腎血管性高血圧症
内側縦束症候群	核間性眼筋麻痺	口臭
両足関節炎	足関節炎	胃神経内分泌細胞癌
夜低血糖	低血糖	口唇石灰化上皮腫
左上下肢軽度麻痺	四肢麻痺	先天性肺動脈異常
下肢痙性	痙性対麻痺	乳歯萌出障害
皮疹状況	発疹	頭部損傷・頭蓋内に達する開放創合併なし
不適応	適応障害	両室肥大
陰茎部痛	陰茎部疼痛	腓骨骨折
髄外形質細胞腫	骨外性形質細胞腫	胸腺結核
ｍａｌｉｇｎａｎｔ　ｌｙｍｐｈｏｍａ	悪性リンパ腫	血中の向精神薬の検出
重症ＡＧＨＤ	重症成人成長ホルモン分泌不全	胃静脈瘤出血
両白内障	白内障	腸管破裂・腹腔に達する開放創合併あり
腎結石	腎結石症	脚気神経炎
湿疹性病変	湿疹	複合性局所疼痛症候群ＩＩ型
穿刺部発赤	発赤	少関節型若年性関節炎・手関節
時々背部痛	背部痛	下肢筋萎縮
手内筋萎縮	筋萎縮症	膵移植後
腎機能悪化	腎機能低下	中枢性嘔吐症
尾てい骨骨折	尾骨骨折	乳頭浮腫
高度視力障害	視力障害	腟壁下垂
周期性クッシング症候群	クッシング症候群	硝子体異物残留
昨夜微熱	微熱	新生児テタニー
腓腹筋痙攣	痙攣	眉毛部裂創
左肋骨打撲	肋骨部打撲	足損傷
破壊性脊椎症	脊椎症	新生児低酸素血症
胆嚢破裂	胆のう管破裂	手汗疱状白癬
独歩不可	歩行障害	先天性爪異常
骨破壊進行	関節リウマチ	直腸びらん
下肢白癬	白癬	趾基節骨良性腫瘍
左鼓膜発赤	発赤	車酔い
潜在結核	結核	眼瞼外傷性異物
熱苦症状	発熱	皮脂腺腫瘍
シャイドレジャー症候群	シャイ・ドレーガー症候群	閉鎖歯列弓
肺動脈弁閉鎖症	肺動脈弁閉鎖	上腕悪性線維性組織球腫
脾摘施行Ｃ型肝炎	Ｃ型肝炎	腸腰筋炎
胸水セルブロック	胸水貯留	先天性巨大動脈瘤
右肺上葉すりガラス影	胸部異常陰影	偽視神経炎
Ｆｏｌｌｉｃｕｌａｒ　ｌｙｍｐｈｏｍａ	濾胞性リンパ腫	血中の向精神薬の検出
腫瘍性ＤＩＣ	線溶亢進	陳旧性足関節外側靱帯損傷
右精巣上体炎	精巣上体炎	淋菌性心膜炎
左肘関節亜脱臼	亜脱臼	術後発熱
左聴神経腫瘍	聴神経腫瘍	必須脂肪酸欠乏症
左肺感染性嚢胞	肺のう胞	ウィリス動脈輪周囲炎
母体出血	出血	淋菌性精巣上体炎
右足趾壊疽	下肢壊疽	好酸球性口腔粘膜肉芽腫
胃腸障害	急性胃腸障害	腹部悪性軟部腫瘍
残遺癌	癌	黒皮症
不安大きく	不安障害	ラテックスアレルギー
ＭＳ再発	多発性硬化症	血小板無力症
強直間代性痙攣発作	間代性痙攣	骨粗鬆症・大腿部病的骨折あり
一過性意識消失発作	一過性脳虚血発作	ジューリング病
乳児白血病	白血病	陳旧性塞栓性脳梗塞
筋委縮	筋萎縮症	腸骨リンパ節転移
水腎再燃	水腎症	陰茎脂肪腫
しびれていない	しびれ感	肩甲部圧挫傷
時々血痰	血痰	妊娠性反復性黄疸
左鼠経ヘルニア	鼡径ヘルニア	母趾打撲傷
遺伝性腎性尿崩症	先天性腎性尿崩症	有痛性扁平足
尿管結石	尿管結石症	骨盤切断術後
体幹掻痒感	そう痒	乾癬性関節炎・足関節
右大腿部骨幹部骨折	大腿骨骨幹部骨折	肝腎症候群
糖尿病神経症	糖尿病性神経痛	陰茎挫傷
古典的肝細胞癌再発	肝細胞癌	慢性非細菌性前立腺炎
左室低形成	左心低形成症候群	胎便栓症候群
劇症肝炎亜急性型	劇症肝炎	脳幹部星細胞腫
分岐部動脈瘤	内頚動脈後交通動脈分岐部動脈瘤	母趾ガングリオン
腫瘍感染	腫瘍	精巣奇形癌
悪性腫瘍スクリーニング	悪性腫瘍	術中ショック
外陰部炎	外陰炎	頭蓋内占拠性病変
軽度骨髄抑制	骨髄機能低下	カプラン症候群
右踵骨折	骨折	迷路骨包耳硬化症
ＰＰＨ	肺高血圧症	動脈還流異常
頭痛時折	頭痛	炭坑夫塵肺症
血腫貯留	血腫	晩期先天梅毒
不整脈発作	不整脈	角膜異物
静脈炎症状	静脈炎	外傷性食道破裂・胸腔に達する開放創合併なし
子宮間質肉腫	肉腫	顔面多発皮下血腫
右主気管支膜様部壊死	壊死	成長ホルモン分泌不全
右下肺野スリガラス影	胸部異常陰影	偽視神経炎
時々頭痛	頭痛	炭坑夫塵肺症
胆嚢腺扁平上皮癌	癌	尿膜管の奇形
上行結腸早期癌	上行結腸癌	ゲオトリクム症
突発性血小板減少性紫斑病	血小板減少性紫斑病	中足骨痛症
意識変動	意識障害	ヘルペス角膜炎
左閉鎖リンパ節転移	リンパ節転移	慢性尿路感染症
両側小脳梗塞	小脳梗塞	神経因性膀胱
胃癌多発肝転移	転移性肝癌	尿道膿瘍
左前腕浮腫	浮腫	型分類困難な統合失調症
赤紫斑	紫斑病	輪状暗点
偽腔閉塞型大動脈解離	解離性大動脈瘤	陰茎海綿状血管腫
高度感音性難聴	感音難聴	滑液のう腫
左耳介欠損	耳介欠損	外傷性横隔膜ヘルニア
尿路感染	尿路感染症	肩甲骨痛
縦隔炎再発	縦隔炎	先天性プラスミノゲン欠損症
前立腺肥大有	前立腺肥大症	舌骨骨折
胆嚢腫瘍	胆のう腫瘍	趾骨痛症
胃がん	胃癌	子宮収縮不全
左中大脳動脈梗塞	中大脳動脈塞栓症	胃腸管損傷・腹腔に達する開放創合併あり
Ｓｏｔｏｓ症候群	ソトス症候群	若年型ＧＭ２ガングリオシドーシス
必要認知症	認知症	新生児脳出血
肝腫瘤性病変	肝腫瘤	副腎皮質ホルモン剤副作用
大動脈瘤解離	解離性大動脈瘤	上葉肺扁平上皮癌
挿入部出血	出血	外耳道閉塞性角化症
眠前発熱	発熱	発疹チフス
肺炎反復	肺炎	ＨＥＬＬＰ症候群
子宮内発育不全	子宮発育不全	前腕滑膜肉腫
左眼窩内腫瘤	眼窩腫瘤	無菌性髄膜炎
多発性腎梗塞	腎梗塞	非穿通性頭部外傷
多臓器不全状態	多臓器不全	頭位眼振
再度痙攣発作	痙攣発作	手掌白癬
変動一過性徐脈	徐脈	重複癌
四肢色素沈着	皮膚色素沈着	コレステロールエステル蓄積症
良性発作性頭位めまい	良性発作性頭位めまい症	靱帯捻挫
三角圧痛	肩部筋痛	急性放射線皮膚炎
両側声帯不全麻痺	声帯不全麻痺	睡眠時無呼吸症候群
舌痛	舌痛症	足舟状骨骨折
肺動脈弁下狭窄	肺動脈弁下狭窄症	卵管留血腫
乳癌局所再発	乳癌	異常白血球分化
頚椎症性神経根炎	頚椎症性神経根症	亜急性細菌性心膜炎
痛みきつい	疼痛	円蓋部髄膜腫
両側顎下腺腫大	顎下腺肥大	原発性痛風
中等度咽頭期嚥下障害	嚥下障害	卵巣損傷
ビタミンＤ不足	ビタミンＤ欠乏症	足部壊死性筋膜炎
日中下痢便	下痢症	上顎骨線維腫
胸郭低形成	胸郭異常	切断
肺スリガラス陰影	胸部異常陰影	腹部膿瘍
頻脈傾向変	頻脈症	腸間膜動脈硬化症
口蓋腫瘤	腫瘤	心房静止
パーキンソン病関連疾患	パーキンソン病	卵巣漿液性腺腫
グラム陰性桿菌菌血症	グラム陰性桿菌敗血症	夏期熱
右上肢腫脹	上肢腫脹	頭蓋内胚細胞腫瘍
左肩甲骨部痛	肩甲骨痛	上口唇母斑細胞母斑
開腹子宮筋腫核	子宮筋腫	魚咬創
白内障手術	白内障	眼瞼先天異常
腫瘤残存	腫瘤	鼻部皮膚良性腫瘍
直腸癌Ｒａ	直腸癌	下行結腸多発憩室
カルボプラチンアレルギー	薬物過敏症	ＬＰシャント機能不全
肺原発ホジキンリンパ腫	ホジキンリンパ腫	頻拍症
循環障害	末梢循環障害	大網ヘルニア
原発性空腸癌	空腸癌	腓側列欠損
右卵巣チョコレート嚢腫	チョコレートのう胞	蝸牛型メニエール病
重度精神運動発達遅滞	混合性特異的発達障害	二次性会陰裂傷
左腎梗塞	腎梗塞	肺ブラストミセス症
筋緊張高く	筋強直	神経性眼精疲労
母指潰瘍治癒遅延	皮膚潰瘍	慢性化膿性鼻咽頭炎
歩行時呼吸困難感	労作時呼吸困難	慢性複雑性膀胱炎
滑液貯留	体液貯留	日光網膜症
痰症状	喀痰	静脈内膜炎
腸管血流障害	末梢循環障害	卵巣周囲炎
発赤強い	発赤	少関節型若年性関節炎・手関節
全身性単純ヘルペスウイルス感染症	ヘルペスウイルス感染症	関節痛
冠動脈高度石灰化	冠動脈石灰化	大脳皮質基底核変性症
劇症型腸アメーバ症	腸アメーバ症	脳毛細血管拡張症
慢性痛	慢性疼痛	悪性腫瘍に伴う貧血
不適応行動	適応障害	脳挫創
心室内血栓	心室内血栓症	口角口唇炎
腹膜播種結節摘出	腹膜播種	肋軟骨離断
緑色痰	喀痰	多発開放骨折
冠動脈硬化	冠状動脈硬化症	１型糖尿病性末梢神経障害
右中葉肺癌	中葉肺癌	腟中隔
ポンプポケット内血腫	血腫	肺毛細血管腫症
血管免疫芽球型Ｔ細胞リンパ腫	血管免疫芽球性Ｔ細胞リンパ腫	半月板損傷
腹部緊満	腹部膨満	虹彩癒着
舌骨喉頭下垂	喉頭下垂症	網膜剥離術後
尿量低下	乏尿	腹腔内出血
脳梗塞症	脳梗塞	示指ＭＰ関節挫傷
左非浸潤性乳管癌	非浸潤性乳管癌	足関節外側靱帯断裂
むつかぶれ	おむつ皮膚炎	肩甲部圧挫傷
水平亜脱臼	亜脱臼	習慣性斜頚
右反復性膝蓋骨脱臼	反復性膝蓋骨脱臼	ピロプラスム症
早期癌	癌	腹部挫傷
吻合部出血	出血	十二指腸総胆管炎
子宮頸がん	子宮頚癌	胸腺炎
腺扁平上皮癌	癌	内反尖足
喉頭蓋サルコイドーシス	サルコイドーシス	脱水症
結核性	結核	眼瞼外傷性異物
声門部狭窄	喉頭狭窄症	体幹表皮母斑
両側急性硬膜外血腫	急性硬膜外血腫	腰腹痛
高レニン高血圧	高レニン性高血圧症	瘢痕性肛門狭窄
頭蓋底髄膜腫	髄膜腫	ダイレクトボンドマルチブラケット装置脱離
右前胸部痛	前胸部痛	大腿骨側頚部開放骨折
膵全体癌	膵癌	トリコモナス性精のう炎
両側血気胸	血気胸	ケロイド
穿刺部位出血	出血	遺伝性難聴
手掌黄色腫	黄色腫症	第５趾末節骨開放骨折
皮膚湿疹	湿疹	鉄欠乏症
唾石	唾石症	眼窩神経芽腫
非吻合部多発胆管狭窄	胆管狭窄症	外傷性髄液鼻漏
軽度肥満歴	肥満症	妊娠性エプーリス
左腎嚢胞不変	腎のう胞	再発性多発軟骨炎
軽度発赤腫脹	発赤	軟部悪性巨細胞腫
左手関節変形	変形性手関節症	潜伏眼球
蛋白尿（３＋）	蛋白尿	発熱
左手首痛	手部痛	子宮直腸瘻
びまん性肺胞出血	肺胞出血	腹部腫瘤
続発性赤芽球癆	赤芽球ろう	下顎歯槽骨炎
インフルエンザ菌	インフルエンザ	先天性熱帯熱マラリア
左舌区小細胞癌	小細胞肺癌	中耳腫瘍
左足背疼痛	足背痛	胃熱傷
成人発症Ｓｔｉｌｌ病（ＡＯＳＤ）	成人スチル病	血中の向精神薬の検出
大球性正色素性貧血	正色素性貧血	直腸切断術後後遺症
双極Ⅱ型障害	２型双極性障害	ヒルシュスプルング病
限局型全身性強皮症	全身性強皮症	眼瞼蜂巣炎
右水晶体脱臼	水晶体脱臼	胸部内臓転位
心サルコイト゛ーシス	心サルコイドーシス	心臓性浮腫
Ｓ状結腸高分化腺癌	Ｓ状結腸癌	セラミックブラケット脱離
右側頬部腫脹	頬部腫脹	充実性卵巣腫瘍
右上背部痛	背部痛	下肢筋萎縮
両下肢痛み	疼痛	乳管拡張症
多発海綿状血管腫	多発性海綿状血管腫	カポジ肉腫
結核歴	結核	眼瞼外傷性異物
ＳＭＡ浸潤	膵癌	下顎角部開放骨折
微小癌	癌	一側性混合性難聴
慢性疼痛性障害	慢性疼痛	胸骨骨髄炎
高Ｃｌ血症	高クロール血症	眼瞼外傷性色素沈着
乳頭状腺癌	癌	口唇外傷性腫脹
帯状疱疹ウイルス脊髄炎	ウイルス脊髄炎	睡眠時無呼吸症候群用口腔内装置不適合
内臓播種性ＶＺＶ感染症	汎発性帯状疱疹	上眼瞼蜂巣炎
様皮疹	発疹	頭部損傷・頭蓋内に達する開放創合併なし
左帯状疱疹	帯状疱疹	石灰化腱膜線維腫
骨形成不全症Ⅲ型	骨形成不全症	全身型若年性特発性関節炎・膝関節
高度肥満症	病的肥満症	放射線性顎骨壊死
右前頭葉脳内血腫	血腫	喉頭蓋前面癌
マルチミニコア病	マルチコア病	腹膜播種
四肢関節腫脹	関節炎	重度栄養失調
右腸骨静脈血栓症	腸骨静脈圧迫症候群	腎後性血尿
脳底動脈閉塞	脳底動脈閉塞症	先天性頭髪発育不全
胸背部圧迫感	背部圧迫感	非アルコール性コルサコフ精神病
眼瞼結膜軽度貧血	貧血	食後悪心
子宮頸癌Ⅲｂ期	子宮頚癌	爪甲軟化症
傍卵巣嚢胞	傍卵巣のう胞	慢性歯周膿瘍
肝内腫瘤性病変	腫瘤	副腎皮質ホルモン剤副作用
血管性紫斑病	症候性紫斑病	大耳症
時々右股関節痛	股関節痛	薬物性光毒性反応
ＡＳＤ	心房中隔欠損症	サルモネラ敗血症
緑膿菌肺感染症	緑膿菌肺炎	直腸障害
母子感染歴	母子感染	鼻耳管炎
ふらつきあり転倒リスク高い	めまい	ＡＢＯ因子不適合
頸腕症候群	頚肩腕症候群	軽度知的障害
食道癌術後リンパ節転移	リンパ節転移	悪性グルカゴノーマ
亜急性期小脳梗塞	小脳梗塞	神経因性膀胱
喘息コントロール	咳喘息	医原性新生児低血糖
右膝違和感	全身違和感	精神運動興奮状態
腓骨神経麻痺徴候	腓骨神経麻痺	鈍痛
中高分化型腺癌	癌	転移性胸壁腫瘍
軽度脳梗塞	脳梗塞	アメーバ性虫垂炎
身体外傷	外傷	Ｄ群連鎖球菌敗血症
心源性塞栓症	心原性脳塞栓症	続発性骨髄線維症
左上腕骨近位端骨折	上腕骨近位端骨折	触覚鈍麻
神経根性痛	疼痛	歯の脱落
白色壊死組織付着	壊死	恥骨骨膜炎
夜間中途覚醒	睡眠障害	全身中毒症
軽度肺動脈弁狭窄	肺動脈弁狭窄症	卵管留血腫
転移性肝癌術後再発	転移性肝癌	尿道膿瘍
無涙症	涙液分泌不全	小腸腟瘻
劇症Ａ型肝炎	Ａ型劇症肝炎	外傷性精神病
ｃｒｉｔｉｃａｌ　ｉｌｌｎｅｓｓ　ｐｏｌｙｎｅｕｒｏｐａｔｈｙ	多発ニューロパチー	血中の向精神薬の検出
右眼増殖性糖尿病網膜症	増殖性糖尿病性網膜症	人工関節のゆるみ
右上腕腫脹	上腕部腫脹	血中亜鉛異常
右側胸水貯留	胸水貯留	先天性巨大動脈瘤
水疱瘡	水疱症	多発性下肢挫滅創
軽度高Ｋ血症	高カリウム血症	頭部打撲傷
肝性脳症再発	肝性脳症	低炭酸ガス血症
水様便流出	下痢症	ポータータイプ拡大装置不適合
二絨毛膜二羊膜性双胎第	二絨毛膜二羊膜性双胎	網膜網状変性
浮腫傾向	浮腫	壊疽性臍ヘルニア
骨Ｐａｇｅｔ病	骨パジェット病	ベネズエラ出血熱
Ｅｎｔａｍｏｅｂａ　ｈｉｓｔｏｌｙｔｉｃａ	アメーバ赤痢	血中の向精神薬の検出
左頚部内頸動脈狭窄	内頚動脈狭窄症	胸部昆虫螫
大腿筋横紋筋肉腫	横紋筋肉腫	限局性皮下腫脹
腸炎性関節炎	関節炎	高ＨＤＬ血症
ＰＭＳ	月経前症候群	血小板無力症
腓腹部圧痛	腹部圧痛	下腿表在損傷
非チフス性Ｓａｌｍｏｎｅｌｌａ菌血症	菌血症	気管開放骨折
微小多発肝膿瘍	肝膿瘍	背部悪性末梢神経鞘腫
卵管狭窄	卵管狭窄症	四肢開放創後遺症
胸部大動脈解離	急性大動脈解離	軽症腺ペスト
蜂窩織炎発症	蜂窩織炎	十二指腸ポリポーシス
輪状披裂関節炎	関節炎	横隔膜炎
左下肢蜂窩織炎	下肢蜂巣炎	気管挫滅損傷
肺塞栓	肺塞栓症	乳腺腫大
咽頭残留	嚥下障害	亜急性虹彩炎
低髄圧症状	低髄液圧症	腰部椎間板症性神経根症
左腓骨開放骨折	腓骨開放骨折	上腕骨骨折
大量水様下痢	下痢症	上顎骨線維腫
処方右乳癌	乳癌	植込型除細動器電池消耗
症候性けいれん	症候性てんかん	歯髄出血
低血糖回避	低血糖	風疹様発疹
左慢性閉塞隅角緑内障	慢性閉塞隅角緑内障	陰のう静脈瘤
弧発性古典的ＣＪＤ	孤発性クロイツフェルト・ヤコブ病	サルモネラ敗血症
呼吸機能低下	呼吸機能検査異常	脳底部挫傷・頭蓋内に達する開放創合併あり
右大腿リンパ節転移	リンパ節転移	上腕挫滅傷
左第３趾潰瘍	趾皮膚潰瘍	第１手根中手関節脱臼骨折・手根骨
足変形	足部変形	異所性胸腺
膝関節水腫	膝関節水症	胃破裂・腹腔に達する開放創合併なし
腹部瘢痕ヘルニア	腹壁瘢痕ヘルニア	腰椎圧迫骨折
月経困難	月経困難症	双胎妊娠新生児
左局所進行乳癌	進行乳癌	植込型除細動器電池消耗
好酸球性胆嚢炎	胆のう炎	胸部母斑細胞母斑
左下腿骨幹部骨折	骨折	肝腎症候群
即時型アレルギー	アレルギー	縦隔結核
ふらつき有	めまい	乳び胸
ループス腎炎Ｖ型	ループス腎炎	腹部良性軟部腫瘍
閉塞性睡眠時無呼吸症侯群	睡眠時無呼吸症候群	母趾皮膚潰瘍
右下肢しびれ	下肢しびれ	クラミジア子宮頚管炎
頭部脂漏性皮膚炎	脂漏性皮膚炎	一酸化炭素中毒
結核性ブドウ膜炎	結核性ぶどう膜炎	後頭蓋窩硬膜外血腫・頭蓋内に達する開放創合併なし
左真珠腫性中耳炎再発	真珠腫性中耳炎	仙腸関節弛緩
傍大動脈ＬＮ転移	大動脈周囲リンパ節転移	シャルコー・マリー・トゥース病
痙直型四肢麻痺	四肢麻痺	稽留性肢端皮膚炎汎発型
角化性紅斑散在	紅斑症	単純性尿路感染症
労作時呼吸苦自覚	労作時呼吸困難	汗孔角化症
慢性腎炎	慢性腎炎症候群	胃前庭部毛細血管拡張症
間質性肺炎像	間質性肺炎	漏出性胸水
嘔気様	嘔気	急性細菌性心膜炎
左側頭葉皮質化出血	出血	限局性浮腫
左上腕骨開放骨折	上腕骨開放骨折	クラミジア性前立腺炎
腹部膨満継続	腹部膨満	虹彩癒着
右足底腱膜炎	足底筋膜炎	ウイルス性心膜炎
両側顎関節症	顎関節症	２型糖尿病性多発ニューロパチー
出血性黄体	出血性黄体のう胞	母指皮膚欠損創
右鼡径部疼痛	鼡径部痛	増殖性外毛根鞘性のう腫
高～中分化型管状腺癌	癌	転移性胸壁腫瘍
Ｌａｍｉｖｕｄｉｎｅ耐性Ｂ型肝硬変	Ｂ型肝硬変	頬部貫通創
遺伝性腎炎	家族性腎炎	開放性脳損傷髄膜炎
湿疹化	湿疹	複合性局所疼痛症候群ＩＩ型
左大腿部蜂窩織炎	大腿部蜂巣炎	人工肘関節周囲骨折
下肢対麻痺	対麻痺	先天性肺動脈異常
成長発達遅滞	発達遅滞	うつ病
下腿点状出血	点状出血	遺伝性難聴
脈管奇形	奇形	２型糖尿病合併妊娠
手指欠損	手指欠損症	再発性尿道炎
咽頭粘膜軽度発赤	咽頭発赤	上腕動脈瘤
可動時痛	疼痛	若年性ポリープ
下垂手	垂れ手	気管支喘息
左陰嚢内容腫大	陰のう腫大	直腸ＭＡＬＴリンパ腫
痰がからみ	喀痰	淋菌性結膜炎
朝出血	出血	脊髄挫傷
右鼠経ヘルニア修復術	鼡径ヘルニア	潜在性脊椎披裂
ステロイド骨粗鬆症	ステロイド性骨粗鬆症	大腿骨骨折後遺症
足趾冷感	下肢冷感	非医学的人工妊娠中絶
不整腫瘤	腫瘤	鼻部皮膚良性腫瘍
腎前性脱水	脱水症	鎖骨下動脈瘤
左肩部痛	肩部痛	クリオグロブリン血症性血管炎
頸部皮下膿瘍	皮膚膿瘍	新生児緑膿菌敗血症
ウイルス性感冒	感冒	糖尿病性神経障害性疼痛
多発腫大リンパ節	リンパ節腫大	足炎
腹部自発痛	腹痛症	肛囲カンジダ症
中分化型前立腺癌	前立腺癌	転移性胸壁腫瘍
左一側性形成不全性股関節症	一側性形成不全性股関節症	結核性肺膿瘍
好酸球性気道炎症	好酸球性気管支炎	対鉤歯
腸管蠕動障害	腸管運動障害	卵巣周囲炎
褥瘡形成リスク高い	褥瘡	異所性膵
腰椎変性辷り症	腰椎変性すべり症	脳挫創・頭蓋内に達する開放創合併あり
手術高血圧	高血圧症	習慣性脊柱側弯症
嚥下下困難	嚥下障害	子宮損傷・骨盤腔に達する開放創合併あり
てんかん脳波	異常脳波	腰椎不安定症
巨大血腫	血腫	脊髄神経根症
十二指腸原発神経内分泌腫瘍	十二指腸神経内分泌腫瘍	軸性近視
腹水多量貯留	腹水症	先天性巨大動脈瘤
内腸骨リンパ節転移	腸骨リンパ節転移	体位性失神
ＣＭＶ胃腸炎	サイトメガロウイルス腸炎	副眼瞼
瘢痕痙性	瘢痕	インフルエンザ性胃腸炎
両Ｔ字杖歩行	歩行障害	前立腺無形成
便性状変化	便異常	術後消化管出血性ショック
右血栓閉塞	血栓塞栓症	性感異常
出血付着程度	出血	遺伝性難聴
右海綿静脈洞髄膜腫	髄膜腫	卵巣腫瘤
虚血性心疾患合併	虚血性心疾患	晩発閉経
壊死性筋炎	筋炎	外傷性てんかん
全肺腫瘍	肺腫瘍	尿管閉塞
軽度構音障害	構音障害	薬物乱用
両下腿紅斑	紅斑症	五胎分娩
低Ｃａ血症	低カルシウム血症	胃静脈瘤出血
二次性副腎不全	副腎クリーゼ	咽頭炎
一週間程度眠気	非器質性過眠症	起立性蛋白尿
子宮内腔癒着	子宮内膜症	低マグネシウム血症
項部硬直軽度	項部硬直	胸部難治性皮膚潰瘍
下熱	発熱	発疹チフス
右母指陳旧性尺側側副靱帯損傷	靱帯損傷	ヒストプラスマ症
左気管支狭窄	気管支狭窄症	急性咽頭喉頭炎
皮膚型ＰＮ	結節性多発動脈炎	シャガス病脊髄炎
肺線維化	肺線維症	多発性血管脂肪腫
副鼻腔軽度粘膜肥厚	副鼻腔炎	下顎部第１度熱傷
味覚異常Ｇｒ１	味覚異常	総義歯過高
中心視野欠損	視野欠損	頚椎良性腫瘍
昨晩低血糖	低血糖	口唇石灰化上皮腫
両水腎症	両側水腎症	徐脈性不整脈
前回貧血	貧血	眼球裂傷
骨粗鬆症性圧迫骨折	骨粗鬆症・病的骨折あり	下血
右肺原発肺腺癌	肺腺癌	ハラーマン・ストライフ症候群
脊髄原発悪性リンパ腫	悪性リンパ腫	進行流産
手指浮腫	浮腫	器質性の妄想状態および幻覚妄想状態
口内炎再発	口内炎	新生児天疱瘡
皮質性認知症	皮質下認知症	筋サルコイドーシス
足背発赤	発赤	少関節型若年性関節炎・手関節
後縦隔腫瘤	縦隔腫瘍	流行性角結膜炎
頚椎症性脊椎症	脊椎症	非アルコール性コルサコフ症候群
中部延髄右外側脳梗塞	脳梗塞	脛骨軟骨肉腫
仙骨部瘻孔	難治性瘻孔	舌下型がま腫
軽鎖沈着症	単クローン性軽鎖重鎖沈着症	収縮性心膜炎
右傍気管リンパ節転移	リンパ節転移	出血性膀胱炎
ｓｍａｌｌ　ｃｅｌｌ　ｃａｒｃｉｎｏｍａ	癌	血中の向精神薬の検出
遺伝性出血性毛細血管拡張症	オスラー病	腰仙部脂肪腫
胸椎後縦靭帯骨化症	胸椎後縦靱帯骨化症	産科的創傷の血腫
重症敗血症性ショック	敗血症性ショック	先天性尿管閉塞症
間質性肺炎評価	間質性肺炎	肺乳頭腫
右腎損傷	腎損傷	特殊学習困難
右肺門部原発	原発性肺癌	腹部膿瘍
再発食道癌	食道癌	副甲状腺過形成
不定愁訴多い	不定愁訴症	牛乳によるアナフィラキシーショック
発熱再燃	発熱	発疹チフス
左肩関節痛	肩関節痛症	低心拍出量症候群
瘢痕様変化	瘢痕	脳膜腫
元々頻尿	頻尿症	道化師様魚鱗癬
浮腫対策	浮腫	壊疽性臍ヘルニア
核下性顔面神経麻痺	顔面神経麻痺	膀胱損傷・骨盤腔に達する開放創合併なし
皮膚原発悪性リンパ腫	悪性リンパ腫	中足骨軟骨肉腫
市中感染型ＭＲＳＡ	ＭＲＳＡ感染症	直腸神経内分泌細胞癌
左尿管結石	尿管結石症	骨盤切断術後
乾性咳嗽頻回	乾性咳	母指有棘細胞癌
首痛	頚部痛	角膜上皮剥離
右側頭部紫斑	紫斑病	熱帯性ざ瘡
薬剤過敏性症候群	薬物過敏症	急性骨髄炎
延長症候群	ＱＴ延長症候群	若年性特発性関節炎・足関節
紫斑形成軽度	紫斑病	輪状暗点
両側肺動脈狭窄症	肺動脈狭窄症	自傷
子宮筋腫核出後妊娠	妊娠	口蓋弓癌
ＡＲＤＳ合併	急性呼吸窮迫症候群	サルモネラ敗血症
胆道系閉塞	胆道閉塞	子宮頚部上皮内癌
軟骨損傷	肋軟骨損傷	小脳卒中症候群
右副腎原発	副腎腫瘍	十二指腸虫症
ｋｌｅｂｓｉｅｌｌａ　ｐｎｅｕｍｏｎｉａｅ感染症	クレブシェラ属感染	足底筋腱付着部炎
パ−キンソン症候群	パーキンソン症候群	肩甲間部第３度熱傷
右原発性肺癌	原発性肺癌	慢性心因反応
敗血症性ショック状態	敗血症性ショック	先天性尿管閉塞症
時々発疹	発疹	炎症性開口障害
めまい軽度	めまい	ミオグロビン尿
右横隔膜筋欠損	筋欠損	術後胆管炎
脳症後遺症	脳症	糖尿病性肝障害
胸膜悪性中皮腫	悪性胸膜中皮腫	中枢性特発性早熟
漿膜損傷	損傷	ワンサン気管支炎
頸椎症性	頚椎症	パーキンソン病Ｙａｈｒ５
多発外傷	多発性外傷	非外傷性低脳圧症
皮膚損傷起	皮膚損傷	腰椎椎間板性椎間孔狭窄症
ふらつき目立	めまい	肩軟部腫瘍
近位筋痛	筋肉痛	心臓挫傷
採血上脱水	脱水症	植込型カテーテルポート破損
脳血管芽腫	小脳血管芽腫	僧帽弁閉鎖不全症兼三尖弁狭窄症
右慢性中耳炎	慢性中耳炎	左心房粘液腫
アレルギー様	アレルギー	縦隔結核
ノカルジア脳膿瘍	ノカルジア症	ハシトキシコーシス
大腸ポリープ有	大腸ポリープ	先天性魚鱗癬
右後頭部帯状疱疹	後頭部帯状疱疹	交感性ぶどう膜炎
右頚部結核性リンパ節炎	結核性リンパ節炎	インフルエンザ菌肺炎
陳旧性多発アテローム血栓性脳梗塞	陳旧性アテローム血栓性脳梗塞	急性胃腸障害
誤嚥徴候	異物誤嚥	Ｓ状結腸憩室穿孔
右前腕皮疹	発疹	鼻部挫傷
多発肺腫瘤	肺腫瘤	間脳症
後腹膜浸潤	後腹膜悪性腫瘍	急性心不全
網状紫斑	紫斑病	下垂体機能低下症
胚細胞腫瘍	腫瘍	ヨード過敏症
ゲノタイプ１ｂ型Ｃ型肝硬変	Ｃ型肝硬変	クレアチニンクリアランス低下
類円形腫大	リンパ節腫大	尾骨開放骨折
中枢性気管支拡張像	気管支拡張症	アフタ性咽頭炎
小股歩行	歩行異常	骨髄機能低下
脳血管傷害	脳血管障害	低鼻声
糖尿病末梢神経障害	糖尿病性単ニューロパチー	後頚部腫瘤
ルンバール後頭痛	腰椎穿刺後頭痛	二次性ネフローゼ症候群
急性重症Ｂ型肝炎	Ｂ型肝炎	小脳性構音障害
下垂時疼痛	疼痛	悪性腫瘍に伴う貧血
頚部蜂窩織炎	頚部蜂巣炎	十二指腸ポリポーシス
腹満不変	腹部膨満	感染性膵壊死
一過性心筋虚血	心筋虚血	腟口狭小
日勤帯発熱	発熱	下口唇血管腫
結核性喉頭狭窄	喉頭狭窄症	しらみ媒介性回帰熱
両側鼻内ポリープ	鼻茸	放射線性甲状腺炎
手掌潮紅	紅潮	五胎分娩
低血糖歴何年	低血糖	過敏性腸症候群
離床時眩暈	めまい	出血性十二指腸潰瘍
高齢者Ｃ型慢性肝炎	Ｃ型慢性肝炎	眼窩骨折
ＳＬＥ発症	全身性エリテマトーデス	血小板無力症
軽度咽頭違和感	咽頭異常感症	顔面いちご状血管腫
体熱感	不明熱	膵臓癌骨転移
悪性腫瘍評価	悪性腫瘍	橈骨近位端骨折
発赤領域	発赤	少関節型若年性関節炎・手関節
閉塞性大腸癌	大腸癌	足底筋肉内異物残留
子宮頚部ポリープ	子宮頚管ポリープ	角膜移植拒絶反応
両側大腰筋血腫	血腫	頭部粃糠疹
ＰＳＬＮ転移	大動脈周囲リンパ節転移	血小板無力症
咽頭部疼痛	咽頭痛	十二指腸脂肪腫
肺腫瘍塞栓症	肺腫瘍	乳腺腫大
羊水過多	羊水過多症	開放性脳底部挫傷
筋肉痛症状	筋肉痛	外歯瘻
心外膜石灰化	心膜石灰化	破裂性胸部大動脈瘤
右下肢急性動脈閉塞症	下肢急性動脈閉塞症	旧義歯破損
４型進行胃癌	胃進行癌	弁下型左室右房交通症
圧迫性脊髄症	脊髄症	下腿筋断裂
出血源不明	出血	精神障害
貧血性網膜症	貧血網膜症	ミトコンドリア糖尿病・昏睡合併あり
椎間板突出	椎間板症	関節リウマチ・脊椎
カルチノイド腫瘍	カルチノイド	頚髄症
心臓内腫瘤	腫瘤	出血傾向
日中気分不快	悪心	脳表ヘモジデリン沈着症
多発性嚢胞肝	多発性肝のう胞	肝門部腫瘍
仙骨奇形	仙骨部奇形	骨膜骨髄炎
けいれん再発	痙攣	動眼神経萎縮
遊走性静脈炎	遊走性血栓性静脈炎	耳頭症
左胸膜炎	胸膜炎	後腹膜血管筋脂肪腫
直腸癌術後異時性肝転移	転移性肝癌	尿道膿瘍
手指痺れ	しびれ感	後大脳動脈症候群
左卵管水腫	卵管留水症	ウイルソン病
歩行時呼吸困難	労作時呼吸困難	慢性複雑性膀胱炎
ガーゼ出血	出血	拡張期雑音
老人性紅皮症	紅皮症	気管支腺腫
右被殻脳梗塞	被殻出血	アメーバ性虫垂炎
自律神経ニューロパチー	自律神経性ニューロパチー	早発型発達緑内障
子宮頚部嚢胞	子宮頚部腫瘍	腓腹筋肉離れ
右原発閉塞隅角緑内障	原発閉塞隅角緑内障	皮膚結節
腺腫内癌	癌	スピルマイヤー・フォークト病
両下肢浮腫軽度	下肢浮腫	眼部咬創
右化膿性肩関節炎	化膿性関節炎・肩関節	出血
膣転移	腟癌	急性心不全
体力低下著明	体力低下	胸椎腫瘍
左小脳陳旧性梗塞	陳旧性脳梗塞	神経線維腫症
淡黄色粘稠痰	喀痰	多発開放骨折
外傷所見	外傷	Ｄ群連鎖球菌敗血症
発赤局面	発赤	少関節型若年性関節炎・手関節
膀胱癌既往	膀胱癌	典型的前兆に頭痛を伴う片頭痛
左末梢性肺動脈狭窄	肺動脈狭窄症	皮下フェオミコーシス性膿瘍
骨代謝異常	代謝障害	歯突起骨折
心陰影拡大	胸部異常陰影	関節強直
腎動脈下腹部大動脈瘤	腹部大動脈瘤	間欠性振戦
腸管壁内気腫	皮下気腫	一部子宮内反症
慢性活動性ＥＢＶ感染症	ＥＢウイルス感染症	頬腔異物
足関節圧痛	関節痛	顔面皮膚腫瘍
夕方発熱	発熱	発疹チフス
顔面紅班	紅斑症	機械的イレウス
排便痛	排便障害	フライ症候群
左水腎	水腎症	陰茎脂肪腫
代謝異常	代謝障害	慢性表在性舌炎
両下肢リンハ゜浮腫	下肢リンパ浮腫	食物によるアナフィラキシーショック
左頸部ＬＮ腫脹	肘リンパ節腫脹	急性デンスデポジット病
肺門部リンパ節腫脹	リンパ節腫大	播種性スポロトリコーシス
呼吸困難感軽度	呼吸麻痺	慢性複雑性膀胱炎
左膝窩動脈血栓症	動脈血栓症	心膜結核
左股関節脱臼	股関節脱臼	気管支閉鎖
ルーフ゜ス腎炎	ループス腎炎	腹部良性軟部腫瘍
鼠径部腫脹	鼡径部腫脹	手舟状骨骨折
内鼠径ヘルニア	内鼡径ヘルニア	筋疲労
左頬部血管腫	頬部血管腫	アッサム熱
開口制限	開口不全	角質増殖症
変形性関節炎	変形性関節症	後下小脳動脈解離
初回歩行時ふらつき	よろめき歩行	胃十二指腸クローン病
洞性頻脈	洞頻脈	腱性マレット指
腹膜播種巣	腹膜播種	肋軟骨離断
アレルギ—性結膜炎	アレルギー性結膜炎	産科的外陰血腫
鼠径部血腫	血腫	鼻中隔弯曲症
暗赤色嘔吐	嘔吐症	脊髄くも膜のう胞
直腸癌ＯＰ	直腸癌	足底有棘細胞癌
左増殖性糖尿病網膜症	糖尿病網膜症	人工関節のゆるみ
レム睡眠行動異常	異常行動	脳血管先天奇形
左大腿有棘細胞癌	大腿有棘細胞癌	習慣性アンギナ
声帯癌	声門癌	急性中耳炎
左大腿部疼痛	大腿痛	頚椎腫瘍
右顎関節症	顎関節症	２型糖尿病性多発ニューロパチー
骨頭壊死	骨壊死	直腸びらん
中枢神経浸潤	中枢神経系損傷	部分てんかん
直腸皮下瘻孔	難治性瘻孔	急性シャガス病性心筋炎
胆嚢腫大	胆のう肥大	筋膜結核
Ｈｅｅｒｆｏｒｄｔ症候群	ぶどう膜耳下腺熱	精索欠損
前立腺癌既往	前立腺癌	老化
ダグラス窩腹水	腹水症	前胸部腫脹
失見当障害	見当識障害	急性心内膜炎
ツツガムシ感染症	つつが虫病	子宮癌肉腫
特発性血小板減少症紫斑病	特発性血小板減少性紫斑病	根尖性歯周炎
前立腺浮腫	浮腫	腹圧性尿失禁
胞性腫瘤	腫瘤	前腕皮膚良性腫瘍
右鼠径リンパ節腫脹	鼡径部リンパ節腫脹	暫間固定装置破損
ＡＡＡ破裂	腹部大動脈瘤	趾切断
夜間覚醒	不眠症	腸骨稜棘
初発癌	癌	運動ニューロン疾患
右迷走神経鞘腫	神経鞘腫	短頭症
痙攣様	痙攣	ＨＤＬＳ
機会誤嚥	嚥下障害	Ｓ状結腸憩室穿孔
大腿静脈血栓	静脈血栓症	心膜結核
股関節部骨折	股関節骨折	焼身自殺
吸収不全症侯群	吸収不良症候群	全身性エリテマトーデス性心膜炎
新生血管緑内障	緑内障	臼歯部開咬
甲状腺低下症	甲状腺機能低下症	舌異物
アメーバ肝膿瘍	肝アメーバ症	先天性脊柱前弯
先天性真珠腫	真珠腫	聾唖
頭部皮膚欠損	頭部皮膚欠損創	ＡＣＴＨ分泌低下症
右肺門部浸潤影	胸部異常陰影	偽視神経炎
食道悪性腫瘍	食道癌	子宮類内膜腺癌
傍大動脈リンパ節転移	大動脈周囲リンパ節転移	シャルコー・マリー・トゥース病
ビタミンＤ欠乏	ビタミンＤ欠乏症	足部壊死性筋膜炎
レントゲン異常	胸部異常陰影	先天性点状白内障
器質的心疾患	心疾患	後天性溶血性貧血
温痛覚	温痛覚過敏	肘部挫創
両側内反足	内反足	腸間膜悪性腫瘍
低酸素症状	低酸素性脳症	膝関節異所性骨化
粘稠痰少量	喀痰	淋菌性結膜炎
ダンベル型腫瘍	腫瘍	慢性腸アメーバ症
催不整脈作用	不整脈	中指ＤＩＰ関節側副靱帯損傷
左腋窩汗腺癌	汗腺癌	ＶＡシャント機能不全
感染性仮性嚢胞	仮性膵のう胞	手部悪性線維性組織球腫
乳房熱感	ほてり	頬部開放創
大腸穿孔	腸穿孔	人工心臓弁の機械的合併症
腎瘢痕	瘢痕	腹部ボーエン病
孤立性左室緻密化障害	孤立性心筋緻密化障害	大動脈結腸瘻
進行性顔面片側萎縮症	顔面痙攣症	上肢外傷後遺症
左手関節痛	手関節痛	子宮直腸瘻
右鼠径部腫脹	鼡径部腫脹	急性デンスデポジット病
びりびりしたしびれ	しびれ感	肩甲部圧挫傷
発赤軽減	発赤	少関節型若年性関節炎・手関節
悪寒等	悪寒	頚部転移性腫瘍
非逆流性食道炎	食道炎	頭蓋骨異常
甲状腺萎縮	後天性甲状腺萎縮	肛門痙攣
呼吸苦自覚症状	呼吸困難	小指関節捻挫
多発単神経障害	多発性単ニューロパチー	ハンター舌炎
中毒性	中毒	上腕骨解剖頚骨折
右肺上葉結節影	胸部異常陰影	偽視神経炎
骨膜肥厚	肥厚性皮膚骨膜症	前額部虫刺傷
リステリア感染症	リステリア症	脊髄神経鞘腫
アルコール性脂肪性肝炎	アルコール性脂肪肝	顎骨のう胞
脳室穿破	脳出血	妊娠満３７週以前の偽陣痛
鼠径部リンパ節腫大	鼡径部リンパ節腫脹	足炎
吐気治	嘔気	早産に関連する新生児黄疸
右鼡径部リンパ節腫脹	鼡径部リンパ節腫脹	慢性動脈閉塞症
多発肺塞栓	肺塞栓症	乳腺腫大
右腋窩リンパ節転位	腋窩リンパ節転移	先天性肺線維症
重度右片麻痺	片麻痺	耳前部石灰化上皮腫
両側乳房腫瘤	乳房腫瘤	上顎骨良性腫瘍
原発不明癌頸部リンパ節転移	頚部リンパ節転移	変形性胸鎖関節症
後腹膜脂胞肉腫	後腹膜脂肪肉腫	肩関節脱臼骨折
胆管閉塞機転	胆管閉塞症	結核性卵管炎
右下葉原発扁平上皮癌	下葉肺扁平上皮癌	下背部ストレイン
腰椎圧迫骨折既往	腰椎圧迫骨折	多発性拘縮
便秘悪化	便秘症	排尿障害
潜血３	顕微鏡的血尿	ポータータイプ拡大装置不適合
アレルギー性血管浮腫	浮腫	加重型妊娠高血圧腎症
肺動脈分岐部狭窄	肺動脈分岐部狭窄症	類上皮血管筋脂肪腫
顕微的血尿	血尿	高齢者ＥＢＶ陽性びまん性大細胞型Ｂ細胞性リンパ腫
右鼡径リンパ節腫脹	鼡径部リンパ節腫脹	慢性動脈閉塞症
左足多趾症	多趾症	腎出血
日中痛み	疼痛	中大脳動脈塞栓症
不安感	不安障害	直腸癌穿孔
眼球運動痛	疼痛	若年性ポリープ
腰椎変性側弯症	腰椎側弯症	射精障害
右腎低形成	低形成腎	視床症候群
Ｙｅｒｓｉｎｉａ　ｅｎｔｅｒｏｃｏｌｉｔｉｃａ感染症	エルシニア菌食中毒	金属歯冠修復不適合
膿胸合併肺放線菌症	肺放線菌症	心因性発熱
チクチク痛む	チクチク感	前額部裂創
左水尿管症	水尿管症	中指皮膚欠損創
多発肺内転移	転移性肺癌	腹壁冷膿瘍
左下葉肺癌断端再発	下葉肺癌	気管切開後気管食道瘻
右大腿部発赤	下腿発赤	口蹄疫
右顔面打撲	顔面打撲傷	腸アトニー
糖尿病性自律神経障害	糖尿病性自律神経ニューロパチー	後頚部腫瘤
分破水	破水	放火癖
重症マイコプラズマ肺炎	マイコプラズマ肺炎	咽喉出血
卵巣嚢腫破裂	卵巣のう腫破裂	子宮体部悪性腫瘍
抗原血症	サイトメガロウイルス感染症	下腿切創
褥瘡発症	褥瘡	複雑性合指症
甲状軟骨浸潤	甲状軟骨の悪性腫瘍	腰部神経根炎
潜在性副腎皮質機能低下症	副腎皮質機能低下症	外反中足
眼球陷凹	眼球陥没	続発性赤血球増加症
両足趾潰瘍	趾皮膚潰瘍	クラスプ破損
過換気症状	過換気症	卵巣胚細胞腫瘍
左鎖骨下リンパ節転移	リンパ節転移	慢性尿路感染症
上右卵管留血腫	卵管留血腫	傍十二指腸ヘルニア
濾胞性リンパ腫再発	濾胞性リンパ腫	頚部白癬
両眼糖尿病性網膜症	糖尿病網膜症	外転神経不全麻痺
左外傷性大腿骨頭壊死	外傷性大腿骨頭壊死	リジン尿性蛋白不耐症
肝臓病変	肝疾患	連鎖球菌性アンギナ
右第１趾潰瘍	趾皮膚潰瘍	非器質性遺尿症
腋窩痛	腋窩部痛	ＧＡＬＥ欠損症
踵部発赤	発赤	口蹄疫
両側ぶどう膜炎	ぶどう膜炎	腓腹筋損傷
右アスペルギルス肺炎	肺アスペルギルス症	温度感覚過敏
痔疾患	痔核	混合型先天性ヨード欠乏症候群
無疱疹帯状疱疹	帯状疱疹	神経母斑症
吐き気軽度	嘔気	脊髄くも膜のう胞
非結核性抗酸菌性人工関節感染症	非結核性抗酸菌症	剥離性食道炎
両下肢不随意運動	不随意運動症	外傷性嗅神経損傷
前胸痛	胸痛	猫ひっかき病
洞結節不全症候群	洞不全症候群	続発性血小板減少性紫斑病
結腸皮膚瘻	皮膚瘻	皮膚良性腫瘍
患肢熱感	ほてり	非医学的人工妊娠中絶
両側腎膿瘍	腎膿瘍	頭頂骨良性腫瘍
右喉頭腫瘍	喉頭腫瘍	眼窩線維腫
潜血	顕微鏡的血尿	ポータータイプ拡大装置不適合
細菌性脳動脈瘤破裂	脳動脈瘤破裂	食道上皮内癌
右鼡径部皮下出血	皮下出血	頚部石灰化上皮腫
右下腿筋肉内出血	筋肉内血腫	腹腔内デスモイド
痒感	そう痒	乾癬性関節炎・足関節
大動脈リンパ節転移	大動脈周囲リンパ節転移	シャルコー・マリー・トゥース病
心内血栓	心内血栓症	胃運動亢進症
術後出血	後出血	甲状腺機能低下に伴う貧血
気分悪	悪心	髄液混濁
腰部脊椎管狭窄症	腰部脊柱管狭窄症	鼻部皮下腫瘤
遠位弓部嚢状動脈瘤	動脈瘤	性嗜好の障害
左総腸骨動脈狭窄	総腸骨動脈狭窄	続発性虹彩炎
尿潜血遷延	顕微鏡的血尿	老年精神病
夜間悪寒	悪寒	頚部転移性腫瘍
造骨性骨転移	骨転移癌	出血性外痔核
腫瘍制御	腫瘍	小指中手骨遠位端骨折
失調性構音障害	構音障害	腰部筋肉内異物残留
右上腕骨頸部骨折	上腕骨頚部骨折	脛骨天蓋骨折
リンハ゜節腫大	リンパ節腫大	足炎
皮疹拡大傾向	発疹	肺結核・鏡検確認あり
依然浮腫	浮腫	壊疽性臍ヘルニア
右足底部蜂窩織炎	足蜂巣炎	十二指腸ポリポーシス
血栓閉塞型大動脈解離	早期血栓閉鎖型大動脈解離	喉頭白斑症
急性期脳血管障害	脳血管障害	距骨壊死
朝方痰	喀痰	神経線維腫症１型
進行性直腸癌	直腸癌	足底有棘細胞癌
小腸型クローン病	小腸クローン病	舌下腺膿瘍
軽度すりガラス影	胸部異常陰影	体重減少
二次性血小板増多症	血小板増加症	眼リンパ節リステリア症
胃膵嚢胞	膵のう胞	傍食道ヘルニア
最近浮腫	浮腫	食道軟化症
右顔面疼痛	顔面痛	消化管アニサキス症
便失禁多量	便失禁	産褥白股症
労作時頻脈	頻脈症	母斑症
両下肢結節性紅斑	結節性紅斑	胃切除後癒着
重症胆管炎	胆管炎	眼瞼割創
右側胸部痛	胸痛	足底多汗症
右小指基節骨骨折	小指基節骨骨折	胆のう水腫
右足背腫脹	足背腫脹	腹部皮膚線維肉腫
右上肢発赤	発赤	口蹄疫
呂律のまわりにくさ	構音障害	術後消化管出血性ショック
アミオダロン誘発性甲状腺中毒症	薬剤性甲状腺機能障害	腟上皮異形成・異型度１
左胸部痛	胸痛	大腿骨側頚部開放骨折
右大腿痛	大腿痛	慢性膿胸
左下腿ＤＶＴ	下腿静脈血栓症	腸管運動障害
動悸等症状	動悸	橈尺骨癒合症
紫斑	紫斑病	輪状暗点
致死性不整脈出現	不整脈	耳介低位
顆粒膜細胞腫	卵巣顆粒膜細胞腫	膵損傷・腹腔に達する開放創合併なし
一瞬痛み	疼痛	円蓋部髄膜腫
意識障害患者	意識障害	ヒステリー性側弯症
切迫早産腹緊	切迫早産	穿通胎盤・出血を伴わない
難治性皮膚非定型抗酸菌症	非結核性抗酸菌症	リンパ性白血病骨髄浸潤
頚部鈍痛	鈍痛	意識障害
発赤範囲	発赤	少関節型若年性関節炎・手関節
左腕腫脹	前腕腫脹	脊椎骨粗鬆症
右肺上葉陰影	胸部異常陰影	偽視神経炎
右上葉肺結節	結節性肺結核	口腔底癌
空腹時高血糖	高血糖症	口唇石灰化上皮腫
右麻痺	片麻痺	白血球の遺伝性異常
味覚変化	味覚障害	コーツ病
器質化肺炎	特発性器質化肺炎	尿路カンジダ症
浮腫悪化	浮腫	未萌出歯
凝固異常症	血液凝固異常	爪変色
右側頭葉脳梗塞	脳梗塞	アメーバ性虫垂炎
両側下顎骨折	下顎骨骨折	胸骨軟骨肉腫
左頭頂葉神経膠腫	頭頂葉神経膠腫	腰椎病的骨折
骨盤内多発リンパ節転移	骨盤内リンパ節転移	眼板異物
直腸閉塞	直腸閉鎖	子宮頚管無力症のための母体管理
運動ニューロン病	運動ニューロン疾患	前頭頂骨進入
肺犬糸状虫症	犬糸状虫症	ナットクラッカー現象
軽度骨棘	骨棘	ＤＩＰ関節脱臼
疲労感少	疲労感	孤発性クロイツフェルト・ヤコブ病
多発性肝腫瘤	肝腫瘍	副腎皮質ホルモン剤副作用
意味性錯語	文意失語症	色素性網膜ジストロフィー
ｃｏａｒｓｅ　ｃｒａｃｋｌｅｓ	湿性ラ音	十二指腸静脈瘤
緑色下痢便	下痢症	上顎骨線維腫
皮膚損傷リスク	皮膚損傷	腰椎椎間板性椎間孔狭窄症
左母指痛	母指痛	分娩損傷による骨格
ＡＶブロック	房室ブロック	下顎角部開放骨折
前縦隔ＬＮ転移	縦隔リンパ節転移	男外性器奇形
間質性肺炎発症	間質性肺炎	漏出性胸水
外側脱臼	脱臼	モラレ髄膜炎
右環指基節骨骨折	環指基節骨骨折	多発性挫傷
左殿部疼痛	殿部痛	一側性感音難聴
両側錐体路障害	錐体路障害	不適合輸血反応
両足しびれ	下肢しびれ	口腔腐蝕
膜性増殖性	膜性増殖性糸球体腎炎	尾骨腫瘍
頻脈性心房粗動	心房粗動	尺骨動脈損傷
下肢血流障害	下肢血行障害	関係念慮
左肺上葉大細胞癌	上葉肺大細胞癌	頚部蜂巣炎
結核性肋膜炎	結核性胸膜炎	腎盂癌
疼痛有	疼痛	閉経期障害
実質外腫瘤	腫瘤	巨頭症
骨盤部リンパ節転移	骨盤内リンパ節転移	眼板異物
左三叉神経帯状疱疹	三叉神経帯状疱疹	神経切断
間質性肺炎悪化	間質性肺炎	漏出性胸水
仙骨部骨折	仙骨骨折	タナトフォリック骨異形成症
重症低体温症	低体温	大腿骨頚部外側骨折
関節炎悪化	関節炎	リウマチ性冠状動脈炎
右尖足	尖足	耳輪埋没症
両手指浮腫	浮腫	器質性の妄想状態および幻覚妄想状態
左主気管支狭窄	気管支狭窄症	急性咽頭喉頭炎
浸潤癌化	癌	小児ＥＢＶ陽性Ｔ細胞リンパ増殖性疾患
就寝後呼吸困難	呼吸困難	肥厚性瘢痕
仮性膵嚢胞	仮性膵のう胞	下肢切断
右肺上葉癌	上葉肺癌	１型糖尿病性動脈閉塞症
訪室時疼痛	疼痛	悪性腫瘍に伴う貧血
膠原病様症状	膠原病	肋骨多発開放骨折
軽度黄染	黄疸	妊娠満３７週以後の偽陣痛
転移性膵癌	膵癌	尿道膿瘍
除皮質硬直様	除皮質硬直	ジル・ドゥ・ラ・トゥーレット症候群
間歇跛行	間欠性跛行	食道表在癌
動脈瘤コイル塞栓術	動脈瘤	妊娠中の性器感染症
紅斑散在	紅斑症	単純性尿路感染症
右膝疼痛	膝関節痛	産褥敗血症
食思不振傾向	食欲不振	ジスキネジア
皮内腫瘍	腫瘍	グルタル酸血症２型
左前床突起部髄膜腫	髄膜腫	胃幽門部癌
右脳梗塞	脳梗塞	示指ＭＰ関節挫傷
軽度腹部痛	腹痛症	高齢妊娠
多発毛細血管拡張	オスラー病	腰仙部脂肪腫
不整脈誘発	不整脈	耳介低位
左肺動脈ＰＥ	肺動脈血栓塞栓症	胃液分泌過多
胃潰瘍再発	胃潰瘍瘢痕	連鎖球菌肺炎
境界域精神発達遅滞	知的障害	肩扁平母斑
胆石膵炎	胆石性膵炎	尺骨遠位端開放骨折
右腕頭動脈瘤	腕頭動脈瘤	口腔外傷性腫脹
外陰部ｐａｇｅｔ癌	外陰部パジェット病	症候性肥満
リウマチ様症状	関節リウマチ	家族性脊髄性筋萎縮症
肺癌性リンパ管症	癌性リンパ管症	頻拍症
左上腕骨顆部骨折	上腕骨顆部骨折	薬物誘発性緑内障
骨盤位妊娠	骨盤位	コンポジットレジン過高
大腿骨骨折後	大腿骨骨折	大腿神経麻痺
左椎間孔狭窄	結合組織性椎間孔狭窄症	新生児末梢神経損傷
前立腺軽度腫大	前立腺肥大症	指中節骨腫瘍
下顎腫脹	下顎部腫脹	輪状軟骨後部裂
鼻中隔弯曲	鼻中隔弯曲症	指骨骨折
大腸憩室症	多発性大腸憩室症	腸骨ユーイング肉腫
逆流性食道炎無	逆流性食道炎	頭蓋骨異常
致死性偽膜性腸炎	偽膜性腸炎	腸出血
眼窩蜂窩織炎	眼窩蜂巣炎	多発性大腸憩室症
排尿後痛	排尿痛	僧帽弁腱索断裂
右腹痛	腹痛症	先天性耳管異常
嚥下耳痛	耳痛症	フライ症候群
茶色出血	出血	遺伝性難聴
左下葉扁平上皮癌	下葉肺扁平上皮癌	下背部ストレイン
右腎梗塞	腎梗塞	肺ブラストミセス症
原発性ヘモクロマトーシス	ヘモクロマトーシス	クレブシェラ腸炎
右前頭葉膠芽腫	前頭葉膠芽腫	幼児痙攣
急性水頭症	水頭症	拒絶反応
活動性肺結核所見	活動性肺結核	趾骨悪性腫瘍
右眼白内障	白内障	腸管破裂・腹腔に達する開放創合併あり
本日胸痛	胸痛	猫ひっかき病
直腸膀膀胱窩	直腸膀胱瘻	関節リウマチ・胸椎
頚部結核性リンパ節炎	結核性リンパ節炎	インフルエンザ菌肺炎
左橈骨遠位骨折	橈骨遠位端骨折	足関節離断術後
逆行性Ｐ波	心電図異常	直腸脱
しびれない	しびれ感	肩甲部圧挫傷
臀部圧痛	圧痛	皮膚原発性未分化大細胞リンパ腫
咽頭血腫	咽頭部血腫	慢性脳炎
膀胱癌再発	膀胱癌	典型的前兆に頭痛を伴う片頭痛
多発皮下転移	皮下腫瘍	急性心不全
両側肺動脈血栓塞栓症	肺動脈血栓塞栓症	外陰上皮異形成・異型度１
副鼻腔病変	副鼻	ウェルニッケ・ポサダ病
安静時呼吸苦	呼吸困難	肥厚性瘢痕
左胸膜播種	胸膜播種	下顎頭骨折
陰嚢疼痛	陰のう痛	腓骨骨折
上眼瞼腫脹	眼瞼浮腫	脊髄係留症候群
右下肢複雑骨折	開放骨折	濾胞樹状細胞腫瘍
可動性良好腫瘤	腫瘤	前腕皮膚良性腫瘍
両頬部発赤	発赤	口蹄疫
感染性肝嚢胞	肝のう胞	殿部脂肪腫
左鼡径部腫脹	鼡径部腫脹	手舟状骨骨折
突然呼吸困難	呼吸困難	慢性複雑性膀胱炎
皮下出血斑	皮下出血	気管支結石症
右下腿骨髄炎	大腿骨骨髄炎	前頭部切創
平行機能障害	平衡異常	臼後歯
元々杖歩行	歩行障害	前立腺無形成
両下肢腫脹	下肢腫脹	胃腫瘤
左傍矢状洞髄膜腫	傍矢状洞髄膜腫	リチウム中毒
限局性皮膚硬化型全身性強皮症	全身性強皮症	先天性声門下狭窄症
毎回失禁	尿失禁症	産褥白股症
右小脳腫瘍	小脳腫瘍	足根骨軟骨肉腫
続発性サルコペニア	サルコペニア	結核腫
非医原性左尿管狭窄	尿管狭窄	難治性逆流性食道炎
下腿血腫	血腫	母指骨折
逆流性膀胱炎	膀胱尿管逆流	ブラジル出血熱
覚醒時疼痛	疼痛	前頚頭頂部挫創
左大転子部発赤	発赤	口蹄疫
卵巣原発腫瘍	卵巣腫瘍	血管迷走神経性失神
リンパ腫再発	悪性リンパ腫	四肢小児湿疹
重度運動障害性構音障害	構音障害	口唇外傷性異物
右肩周囲炎	肩周囲炎	無熱性肺炎
軽度動悸	動悸	橈尺骨癒合症
左ポスナーシュロスマン症候群	ポスナーシュロスマン症候群	膀胱石灰化
液体貯留	体液貯留	日光網膜症
低張性低ナトリウム血症	低ナトリウム血症	授乳困難
癌性胸腹膜炎	癌性腹膜炎	先天性子宮欠損
心臓内腫瘍	心臓腫瘍	子宮内膜腺様のう胞性増殖症
左坐骨神経麻痺	坐骨神経麻痺	小腹急結
リステリア髄膜脳炎	リステリア性髄膜脳炎	アレルギー性鼻炎
点圧痛	圧痛	急性放射線皮膚炎
帯状疱疹ウイルス脳炎	帯状疱疹性脳炎	第４脳室腫瘍
齲蝕	う蝕	肋骨弓部打撲
腎性急性腎障害	腎障害	下腹部浮腫
喉頭嚢胞	喉頭のう胞	脳クロモミコーシス
甲状腺乳頭腺癌	甲状腺乳頭癌	口唇外傷性腫脹
左上下肢しびれ	半身しびれ	クラミジア子宮頚管炎
心筋傷害	心筋疾患	中等度知的障害
圧迫性骨折	圧迫骨折	陰のう湿疹
胆嚢胆石	胆泥	出血性十二指腸潰瘍穿孔
縱隔リンパ節転移	縦隔リンパ節転移	新生児直腸出血
悪性細胞	癌	尿細管性アシドーシス
Ｌｉｓｔｅｒｉａ　ｍｏｎｏｃｙｔｏｇｅｎｅｓ敗血症	敗血症	大腿母斑細胞母斑
パニック症侯群	パニック障害	黄色腫症
アレルギー性肺アスペルギルス症	アレルギー性気管支肺アスペルギルス症	先天性白内障
左下肢原発性リンパ浮腫	リンパ浮腫	口蓋上皮内癌
呼気時喘鳴	喘鳴	多のう胞性卵巣症候群
落ち着かない	多動性障害	開放性胃腸管損傷
苦悶症状	胸内苦悶	胆のうカルチノイド
トルーソー症候群	トルソー症候群	手指偽関節
全身浮腫不変	全身性浮腫	肢運動失行症
左側頭円蓋部髄膜腫	円蓋部髄膜腫	熱傷後瘢痕ケロイド拘縮
周術期喘息発作	気管支喘息発作	胸椎症性脊髄症
薬剤性副腎不全	副腎皮質機能低下症	咽頭炎
乳がん	乳癌	複合レジン冠粗造
巣状分節状糸球体硬化症	巣状糸球体硬化症	ＲＳウイルス脳症
口腔乾燥感	口腔乾燥症	胸椎横断麻痺
右手関節尺側部痛	手関節痛	閉鎖性胸部気管損傷
右上顎洞真菌症	上顎洞炎	成熟白内障
鮮血便	血便	大腿内側部痛
心配症	心配	先天性ミオトニア
アシドーシス進行	アシドーシス	インスリン自己免疫症候群
右足滑液包炎	滑液包炎	女子色情症
第５胸椎転移	胸椎転移	気管熱傷
表出性言語発達遅滞	言語発達遅滞	バーネット症候群
発作性心房細動既往	発作性心房細動	淋菌性虹彩毛様体炎
左リウマチ性膝関節症	関節リウマチ・膝関節	血中鉄異常
左大腿部痛	大腿痛	頚椎腫瘍
隆起性病変	胃ポリープ症	子宮内胎児死亡のための母体管理
腫瘤状構造	腫瘤	鼻部皮膚良性腫瘍
細菌性赤痢感染症	赤痢	肺癌による閉塞性肺炎
多数骨折	骨折	鼓膜湿疹
門脈右枝血栓	門脈血栓症	耳介軟骨膜炎
３型進行癌	癌	広範脊柱管狭窄症
倦怠感等	倦怠感	殿部メルケル細胞癌
全頭脱毛症	脱毛症	ラリング
筋攣縮	筋痙縮	背部せつ
元々徐脈	徐脈	大腿骨顆上骨折後偽関節
特発性側彎症	特発性側弯症	前立腺萎縮
回盲部放線菌症	放線菌症	下腿静脈瘤
ｆａｎ症候群	マルファン症候群	眼部皮下血腫
脊椎椎間板炎	椎間板炎	下顎後退症
起始異常	冠動脈起始異常	脳挫創
右眼球破裂	眼球破裂	趾切断
介助　疼痛	疼痛	胸骨骨髄炎
前失神	失神	反射性痙攣
ふらつき感自覚	よろめき歩行	口部ジスキネジア
低分化型肝細胞癌	肝細胞癌	きのこ作業者肺
右葉間胸水	葉間胸水	踵骨炎
子宮内膜症性卵巣嚢胞	卵巣子宮内膜症のう胞	総義歯義歯床下粘膜異常
腎嚢胞出血	傍腎盂のう胞	上顎骨開放骨折
無症候性キャリア	ＨＴＬＶ−１キャリア	鼻部皮膚癌
中等度腹水	腹水症	喉頭蓋脂肪腫
受容体脳炎	抗ＮＭＤＡ受容体脳炎	第１色盲
肛門部軽度発赤	肛門部周囲炎	上腕動脈瘤
側方リンパ節転移	リンパ節転移	嗅覚障害
左硝子体混濁	硝子体混濁	癌性ニューロパチー
統合失調症既往	統合失調症	直腸Ｓ状部悪性腫瘍
平衡機能障害	平衡障害	下眼瞼蜂巣炎
肺腫瘤影	胸部異常陰影	視床下部機能障害
複雑型異型子宮内膜増殖症	腺腫性子宮内膜増殖症	尾骨腫瘍
皮膚潰瘍形成	皮膚潰瘍	家族性良性赤血球増加症
肝肥大	肝型糖原病	肩部悪性末梢神経鞘腫
紅斑腫脹	紅斑症	チクングニヤ出血熱
腰部圧痛	腰痛症	原発性肺ペスト
元々不眠症	不眠症	人工弁感染
左肩甲骨軟骨肉腫	肩甲骨軟骨肉腫	透析困難症
肺血症性ショック	敗血症性ショック	気管支奇形
凝固線溶系異常	血液凝固異常	頬骨変形治癒骨折
異所性静脈瘤	静脈瘤	口唇癌
腫瘍崩壊	腫瘍	中足趾節関節脱臼
破壊性甲状腺炎	甲状腺炎	反回神経麻痺
右腸骨ＬＮ転移	腸骨リンパ節転移	網膜出血
右腎被膜下血腫	血腫	過敏性乳児
全身性サルコイドーシス	サルコイドーシス	坐骨恥骨軟骨結合若年性骨軟骨症
脱分化型脂肪肉腫	脂肪肉腫	ペースメーカ不全
非機能性下垂体腫瘍	下垂体腫瘍	圧迫性潰瘍
ＡＣＴＨ分泌不全	ＡＣＴＨ分泌低下症	糖原病６型
時々残尿感	残尿感	化膿性膵炎
小人症	低身長症	水痘・帯状疱疹ウイルス感染母体より出生した児
右臼蓋転移	骨盤転移	急性心不全
右頭頂葉脳梗塞	脳梗塞	アメーバ性虫垂炎
マルファン症候群合併	マルファン症候群	母指球筋麻痺
右眼網膜症	網膜症	手指中節骨骨折
咽喉頭炎	咽頭喉頭炎	下腿多発骨折
右下葉肺扁平上皮癌	下葉肺扁平上皮癌	脊髄硬膜内髄外神経鞘腫
足趾壊疽	趾壊死	好酸球性口腔粘膜肉芽腫
左肺尖部腺癌	肺腺癌	末梢神経損傷
潰瘍型間質性膀胱炎	間質性膀胱炎	痙性イレウス
紅色皮疹	発疹	潰瘍性大腸炎再燃
遺尿	遺尿症	易感染性
頚管狭窄	子宮頚管狭窄症	多臓器不全
右腎門部腹側脂肪肉腫	腎周囲脂肪肉腫	腹腔内腫瘤
左中頭蓋窩髄膜腫	中頭蓋窩髄膜腫	ダイレクトボンドマルチブラケット装置脱離
脳梗塞後後遺症	脳梗塞	筋断裂
含歯性嚢胞	含歯性のう胞	慢性肝炎
紅斑熱	日本紅斑熱	コクサッキーウイルス気管支炎
多発頭蓋骨転移	骨転移癌	大腿骨転子部開放骨折
Ｄａｎｌｏｓ症候群	エーラス・ダンロス症候群	小児肺炎
運動低下性構音障害	構音障害	口唇外傷性異物
右重症下肢虚血	重症虚血肢	サルコチスティス症
両側腸腰筋血腫	血腫	恥骨結合炎
亀頭部発赤	発赤	少関節型若年性関節炎・手関節
肝嚢胞感染	肝のう胞	空腸クローン病
重症強迫性障害	強迫性障害	アルコール性心筋症
顔面骨圧痛	圧痛	子宮口開大不全
左椎間板ヘルニア	椎間板ヘルニア	化膿性椎間板炎
会陰部疼痛	外陰部痛	腓骨骨折
咀嚼時痛	咀嚼筋痛障害	手関節部滑膜肉腫
左膝関節偽痛風	膝関節偽痛風	多発性脳腫瘍
２次性副甲状腺機能亢進症	副甲状腺機能亢進症	複合性局所疼痛症候群
右上腕蜂窩織炎	上腕蜂巣炎	暫間被覆冠脱離
右前大脳動脈未破裂動脈瘤	前大脳動脈瘤	顎骨インプラント不適合
リウマチ性胸水	リウマチ性肺疾患	先天性巨大動脈瘤
右眼白内障手術	白内障	眼瞼先天異常
悪性リンハ゜腫	悪性リンパ腫	二次性糖尿病・糖尿病性合併症あり
胆管腫瘍栓	胆管腫瘍	趾骨痛症
右基底核梗塞	脳梗塞	母指示指間切創
境界型耐糖能障害	耐糖能異常	圧痛
リウマチ疾患	関節リウマチ	ツースポジショナー不適合
白内障Ｏ	白内障	腸管破裂・腹腔に達する開放創合併あり
心房細動停止	心房細動	ホールディングアーチ不適合
帯状疱疹既往	帯状疱疹	神経母斑症
腫瘤所見	腫瘤	鼻部皮膚良性腫瘍
ＶＨＬ病	フォンヒッペル・リンダウ病	血小板無力症
時折血痰	血痰	妊娠性反復性黄疸
陰嚢部腫脹	陰のう腫大	続発性月経困難症
帰室時疲労感	疲労感	孤発性クロイツフェルト・ヤコブ病
高分化型腺癌	癌	転移性胸壁腫瘍
糖尿病等	糖尿病	陰茎挫傷
Ｍｙｃｏｂａｃｔｅｒｉｕｍ　ｓｈｉｇａｅｎｓｅ感染症	非結核性抗酸菌症	金属歯冠修復不適合
後腹膜腫瘍切除術	後腹膜腫瘍	ポリオウイルス感染症
肺転移発覚	転移性肺腫瘍	腹壁冷膿瘍
右中咽頭癌	中咽頭癌	離断症候群
両側肺動脈血栓塞栓	動脈血栓症	外陰上皮異形成・異型度１
臀部炎症性粉瘤	粉瘤	回腸膀胱瘻
左耳耳鳴	耳鳴症	膠原病に伴う貧血
鼠経ヘルニア	鼡径ヘルニア	冠状動脈狭窄症
鼻閉塞	鼻閉	腕の表在性凍傷
疲労感等	疲労感	孤発性クロイツフェルト・ヤコブ病
日中掻痒感	そう痒	乾癬性関節炎・足関節
前交通動脈未破裂脳動脈瘤	未破裂脳動脈瘤	顎骨インプラント不適合
夜間低酸素血症	低酸素血症	膝関節異所性骨化
薬剤性腎不全	薬剤性腎障害	咽頭炎
気管支狭窄	気管支狭窄症	急性咽頭喉頭炎
腫瘍増悪	腫瘍	橈骨近位端骨折
急性軸索障害	びまん性軸索損傷	多発性肝のう胞
完全型ベーチェット病	ベーチェット病	平滑筋肉腫
筋肉痙攣	痙攣	眉毛部裂創
癌性髄膜腫症	悪性髄膜腫	過労
化膿性脊椎椎間板炎	化膿性椎間板炎	白輪毛
呼吸性雑音	胸部音異常	先天性赤血球形成異常性貧血
真菌塊	真菌症	脳室静脈性血管腫
両肩関節圧痛	圧痛	低心拍出量症候群
多発肝細胞癌	肝腫瘍	きのこ作業者肺
右腎小嚢胞	傍腎盂のう胞	子宮広間膜内血腫
左横隔膜神経麻痺	横隔神経麻痺	腟留血症
右高度水腎症	水腎症	陰茎脂肪腫
創傷治癒遅延	創傷	人工歯脱離
上腫瘍	腫瘍	乳頭腫
進行性食道癌	食道癌	副甲状腺過形成
複雑性熱性痙攣	熱性痙攣	肩皮膚良性腫瘍
先天性鼻咽腔閉鎖不全症	先天性鼻咽腔閉鎖不全	急性基部側壁心筋梗塞
右眼鼻涙管閉塞症	鼻涙管閉鎖症	胃底腺ポリープ
縦隔原発Ｂ細胞大細胞型リンパ腫	縦隔原発大細胞型Ｂ細胞性リンパ腫	術後肝障害
左半視野障害	視野障害	小指屈筋腱断裂
大腿骨近位部骨折	大腿骨骨折	大腿神経麻痺
左踵部痛	踵痛	産褥敗血症
ポリープ様隆起	ポリープ	陰茎疾患
刺激性皮膚炎	皮膚炎	潜在性糖尿病
慢性緑膿菌感染	緑膿菌感染症	上腕骨人工骨頭置換術後
回腸閉塞	回腸狭窄	趾損傷
尾部嚢胞	膵のう胞	新生児中耳炎
虫刺症	蜂刺症	晩期梅毒性聴神経炎
第二趾爪囲炎	爪囲炎	股関節亜脱臼二次性変股症
膵仮性嚢胞破裂	仮性膵のう胞	フリーマン・シェルドン症候群
シェーンラインヘノッホ紫斑病	ＩｇＡ血管炎	乳児ボツリヌス症
記銘障害	記銘力低下	海綿静脈洞部海綿状血管腫
上歯肉癌	上顎歯肉癌	フォヴィル症候群
チャーグ－ストラウス症候群	好酸球性多発血管炎性肉芽腫症	術後性下顎顎欠損
低ＡＴⅢ血症	アンチトロンビン欠乏症	気管支内異物による窒息
超皮質性感覚性失語	皮質下感覚性失語症	若年性皮膚筋炎
ＮＯＭＩ	腸壊死	シャガス病脊髄炎
肥厚性幽門狭窄	肥厚性幽門狭窄症	尺骨神経痛
問題なし脊柱管狭窄症	脊柱管狭窄症	鉄沈着性白内障
左踵骨裂離骨折	踵骨骨折	デング熱
慢性糸球体炎	糸球体腎炎	本態性低ナトリウム血症
左眼結膜下出血	結膜下出血	食後悪心
子宮頸部上皮内腫瘍	子宮頚部上皮内腫瘍	腓腹筋肉離れ
左腰部有棘細胞癌	腰部有棘細胞癌	疼痛性側弯症
糖尿病罹患	糖尿病	陰茎挫傷
四肢圧痛	圧痛	癌性胸水
関節変形	関節奇形	潜伏眼球
気分変動	気分変調症	症状精神病
左鎖骨下動脈起始異常	鎖骨下動脈起始異常	唾液分泌過多
立位バランス練習重症筋無力症	重症筋無力症	前立腺欠損
腰椎脊柱管狭窄	腰部脊柱管狭窄症	鼻部皮下腫瘤
左上葉小細胞肺癌	上葉小細胞肺癌	習慣性丹毒
左後縦隔腫瘍	後縦隔腫瘍	先天性水痘症候群
食道カンジタ症合併ＨＩＶ感染症	ＨＩＶカンジダ病	頬腔異物
固縮無動	こわばり	筋緊張性障害
小体認知症	認知症	関節型若年性特発性関節炎・指関節
突然腹痛	腹痛症	淋菌性肺炎
尿閉気味	尿閉	結膜瘢痕
生検部感染徴候	創傷感染症	中毒性肝静脈閉塞症
痛風症状	痛風	思春期障害
脳転移新出	転移性脳腫瘍	頭蓋咽頭腫
両側肩関節痛	肩関節痛症	低心拍出量症候群
右眼下鼻側視野異常	視野障害	骨腫瘤
右肺Ｓ４原発腺癌	肺腺癌	食道横紋筋肉腫
右肘関節骨折	肘関節骨折	新生児一過性糖尿病
両耳下腺腫脹	耳下腺腫脹	耳管閉塞症
再下血	下血	頬部単純性血管腫
両変形性股関節症	変形性股関節症	肝肉芽腫
喘息コントロール不良	咳喘息	医原性新生児低血糖
腹部大動脈狭窄症	大腿動脈狭窄症	びまん性脳損傷・頭蓋内に達する開放創合併なし
左肺良性腫瘍	肺良性腫瘍	脱髄性脳梁エンセファロパシー
頸動脈狭窄症	内頚動脈狭窄症	胸部昆虫螫
若年結核性腹膜炎	結核性腹膜炎	腓骨開放性粉砕骨折
発赤部分	発赤	少関節型若年性関節炎・手関節
大腸疾患	腸疾患	リンパ球減少症
頚部血腫	頚部表在損傷	溶血緑内障
肺雑聴取	胸部音異常	咬耗症
急性冠症候群発症	急性冠症候群	手扁平母斑
皮下浮腫	浮腫	眼部咬創
低活動型せん妄	せん妄	転移性腹壁腫瘍
左化膿性耳下腺炎	化膿性耳下腺炎	全身膿痂疹性湿疹
痔核症状	痔核	閉塞性イレウス
拘束性心筋症	拘束型心筋症	上顎のう腫
右内頸動脈血栓閉塞	動脈血栓症	頭部悪性黒色腫
肝うっ血	うっ血肝	低アルドステロン症
ＣＮＩ腎症	薬剤性腎障害	妄想性障害
浮腫軽減	浮腫	未萌出歯
胃液様	嘔吐症	ピロゴフ切断術後
右鼡径部出血	出血	背部石灰化上皮腫
右肺上葉肺炎	肺炎	子宮頚部環状剥離
膠原病外来	膠原病	肋骨多発開放骨折
門亢症	門脈圧亢進症	痔瘻
在型食道癌	食道癌	副甲状腺過形成
創内異物	外傷性異物	陰のう膿瘍
膀胱内尿貯留	後腹膜尿貯留	過熟白内障
肢痛	疼痛	切歯破折
肺結核性腹膜炎	結核性腹膜炎	腓骨開放性粉砕骨折
腸管内血腫	血腫	短母趾伸筋腱断裂
ネフローゼ状態	ネフローゼ症候群	抑うつ神経症
軽度僧帽弁逆流症	僧帽弁逆流症	掌蹠膿疱症性骨関節炎
前胸部粉瘤	粉瘤	回腸膀胱瘻
左室中部閉塞性肥大型心筋症	閉塞性肥大型心筋症	処女膜強靱
しびれがきつい	しびれ感	肩甲部圧挫傷
両側内耳奇形	内耳先天奇形	微細脳損傷
完全右脚ブロック指摘	完全右脚ブロック	心気性うつ病
肛門部潰瘍	肛門潰瘍	脛骨骨折
臀部紅斑	紅斑症	五胎分娩
アレルギ—性鼻炎	アレルギー性鼻炎	ミエロペルオキシダーゼ欠損症
末節骨骨折	骨折	上肢不全麻痺
脊椎症性変化	脊椎症	局部義歯破損
腸閉塞気味	イレウス	子宮頚管無力症のための母体管理
浅呼吸	呼吸困難	一側性外傷後膝関節症
無症候性狭心症	狭心症	卵巣卵管周囲炎
右顎下リンパ節腫脹	顎下リンパ節腫脹	急性出血性膀胱炎
左側頭葉海綿状血管腫	側頭葉海綿状血管腫	陳旧性脱臼
直腸癌術後直腸癌	直腸癌	足底有棘細胞癌
痛覚消失	異常知覚	冠形態歯周治療用装置不適合
膵炎再燃	膵炎	頚部有棘細胞癌
肘頭部潰瘍	前腕皮膚潰瘍	外陰部出血
反復性腸閉塞	イレウス	網膜中心静脈閉塞症による黄斑浮腫
胎児腹水	胎児水腫	新生児帽状腱膜下出血
失見当識障害	見当識障害	急性心内膜炎
皮膚ツルゴール低下	脱水症	緩徐進行１型糖尿病・末梢循環合併症あり
右肩悪性軟部腫瘍	悪性軟部腫瘍	新生児非感染性乳腺炎
非定型うつ	非定型うつ病	髄膜炎菌性心炎
右中指スワンネック変形肩関節	スワンネック変形	視床腫瘍
胸郭運動異常	胸郭異常	殿部平滑筋肉腫
前頭蓋底腫瘍	頭蓋底腫瘍	症候性炎症性ミオパチー
腹部肥満	肥満症	虹彩癒着
Ｓ状結腸粘膜下腫瘤	腫瘤	局所出血
両側下腿圧痕性浮腫	下腿浮腫	咽頭のう胞
動脈瘤様骨嚢腫	動脈瘤様骨のう腫	Ｓ状結腸腫瘍
軟性腫瘤	腫瘤	鼻部皮膚良性腫瘍
本日疼痛	疼痛	閉経期障害
出血軽度	出血	口腔上顎洞瘻
軽度間歇性跛行	間欠性跛行	若年者キーンベック病
蛋白血症	異常蛋白血症	純粋性腺形成異常症
不眠時２錠	不眠症	１型糖尿病性潰瘍
後縦隔膿瘍	縦隔膿瘍	有機リン中毒
胸水排出	胸水貯留	分葉腎
ＡＩＤＳ非定型抗酸菌症	非結核性抗酸菌症	突出痛
尺側神経麻痺	尺骨神経麻痺	三叉神経痛第１枝領域
徐脈等	徐脈	大腿骨顆上骨折後偽関節
てんかんの発作	てんかん	動眼神経萎縮
腹部大動脈石灰化	大動脈石灰化症	大脳皮質基底核変性症
サルコイドーシス疑	サルコイドーシス	坐骨恥骨軟骨結合若年性骨軟骨症
左片麻痺	片麻痺	陳旧性圧迫骨折
足部冷感	下肢冷感	非医学的人工妊娠中絶
下痢〜水様便	下痢症	殿部胞巣状軟部肉腫
コレステロールポリープ	ポリープ	三角骨開放骨折
１型糖尿除	糖尿	頬部皮膚良性腫瘍
関節固縮	関節拘縮	腋窩癌
肺多型癌	癌	１型糖尿病性胃腸症
慢性アレルギ—性鼻炎	アレルギー性鼻炎	ミエロペルオキシダーゼ欠損症
下顎骨正中部骨折	下顎正中部骨折	胸骨軟骨肉腫
後嘔吐	嘔吐症	膀胱瘤合併妊娠
気分不快出現	悪心	脳表ヘモジデリン沈着症
劇症Ａ群溶連菌感染症	劇症型Ａ群連鎖球菌感染症	上腕骨遠位端開放骨折
内腸骨静脈血栓症	静脈血栓症	腎後性血尿
軽度咽頭期嚥下障害	嚥下障害	卵巣損傷
舌根扁桃炎	扁桃炎	頚部脂腺癌
右肺上葉小細胞癌	上葉小細胞肺癌	頚部蜂巣炎
ＣＭＶ網膜症	サイトメガロウイルス網膜炎	外耳道癌
脊椎側弯症	脊柱側弯症	尺骨神経麻痺
悪心Ｇ１	悪心	知的障害・行動機能障害の言及なし
上腹部鈍痛	上腹部痛	高齢妊娠
脊髄視神経炎	視神経炎	偽性ミオトニア
本日血尿	血尿	中指深指屈筋腱断裂
クラミジア頸管炎	クラミジア頚管炎	歯科インプラント不適合
性急性リンパ性白血病	急性リンパ性白血病	腟乳頭腫
周囲リンパ節腫大	リンパ節腫大	足炎
印環細胞癌	癌	縦隔膿瘍
６月肝転移	転移性肝腫瘍	膀胱下垂
左内頸動脈中等度狭窄	頚動脈硬化症	顔面しゅさ
左外耳道閉鎖	外耳道閉鎖	卵管峡部妊娠
右鼡径部ヘルニア	鼡径ヘルニア	痙攣発作
ＭＬＦ症候群	核間性眼筋麻痺	眼部皮下血腫
醜形恐怖	醜形恐怖症	関節型若年性特発性関節炎
肩関節疼痛	肩関節痛症	耳介皮下血腫
右手痺れ	上肢しびれ	肺動脈拡張
逆流感	胃食道逆流症	丹毒
播種性クリプトコックス症	播種性クリプトコッカス症	迷路機能損失
左尿管導管吻合部狭窄	吻合部狭窄	ラッサ熱
口唇落屑	皮膚落屑	子宮不全破裂
時折不整	不整脈	真菌性外陰腟炎
僧帽弁狭窄症兼閉鎖不全症	僧帽弁狭窄症	足底部悪性黒色腫
伸筋腱脱臼	脱臼	感染性口内炎
両下腿潰瘍	下腿皮膚潰瘍	サットン母斑
内転障害	眼球運動痙攣	外傷性内反足
びまん性リンパ腫	リンパ腫	四肢小児湿疹
多発嚢胞腎	多発性のう胞腎	乳房異物
足首骨折	足関節骨折	口唇の先天奇形
右目白内障	白内障	腸管破裂・腹腔に達する開放創合併あり
嘔吐１回	嘔吐症	膀胱瘤合併妊娠
深夜低血糖	夜間低血糖症	口唇石灰化上皮腫
過敏症状	過敏症	耳介刺創
高Ｂｉｌ血症	高ビリルビン血症	眼瞼外傷性色素沈着
右足小指骨折	小指骨折	強膜疾患
第一腰椎破裂骨折	腰椎破裂骨折	脊椎関節症
せん妄発言	せん妄	頚椎胸椎捻挫
ヒステリー症状	ヒステリー反応	膀胱扁平上皮癌
歩行時創部痛	術創部痛	大腿単独欠損
パニック	パニック障害	頭部打撲血腫
正色素性正球性貧血	正球性正色素性貧血	直腸切断術後後遺症
右足腫脹	足部腫脹	皮膚悪性腫瘍
両肺胸膜肥厚	胸膜肥厚	１型糖尿病性低血糖性昏睡
ＡＰＳ	抗リン脂質抗体症候群	サルモネラ敗血症
脳圧亢進症状	頭蓋内圧亢進症	メタルリテーナー不適合
眼鏡　近視	近視	若年性パーキンソン病Ｙａｈｒ４
二次性ヘモクロマトーシス	ヘモクロマトーシス	クレブシェラ腸炎
潜在性副甲状腺機能低下症	副甲状腺機能低下症	双胎の対児の臍帯断端からの胎児失血
両眼瞼黄色腫	眼瞼黄色腫	角膜片雲
右内腸骨動脈狭窄	動脈狭窄	鼻腔異物挿入後遺症
正中頚嚢胞	正中頚のう胞	閉鎖性腸管破裂
両側尿管結石	尿管結石症	骨盤切断術後
高血圧状態	高血圧症	侵襲性髄膜炎菌感染症
喀血症状	喀血	アレシェリア症
指発赤	発赤	少関節型若年性関節炎・手関節
Ⅱａ型高脂血症	高脂血症	リンパ球増加症
右手橈骨骨折	橈骨骨折	踵部有棘細胞癌
右睾丸痛	精巣痛	増殖性外毛根鞘性のう腫
本日血便	血便	ウェルニッケ失語症
回腸出血	腸出血	しゅう酸症
左副腎出血	副腎出血	錐体外路症候群
後頭蓋下髄膜腫	髄膜腫	２型糖尿病性腎症第３期Ａ
急性前壁中隔梗塞	急性前壁中隔心筋梗塞	ヘモクロマトーシス性関節障害
右顔面部帯状疱疹	顔面帯状疱疹	上鼓室化膿症
びまん性管内増殖性糸球体腎炎	慢性びまん性管内増殖性糸球体腎炎	皮膚動脈炎
傍腹部大動脈リンパ節腫大	リンパ節腫大	足炎
左上腕脂肪腫	上腕脂肪腫	アデノウイルス咽頭炎
尿道口発赤	発赤	小指屈曲拘縮
冠動脈狭窄症	冠状動脈狭窄症	腰椎骨髄炎
膵石灰化	膵石灰化症	陰唇肥大
丘疹様	丘疹	縁取り空胞を伴う遠位型ミオパチー
肺上葉原発性肺癌	原発性肺癌	１型糖尿病性動脈閉塞症
労作時胸部不快	労作時呼吸困難	閉鎖性胆のう損傷
２型＋ステロイド性糖尿病	ステロイド糖尿病	背側骨間筋麻痺
腫瘤縮小	腫瘤	鼻部皮膚良性腫瘍
Ｓａｌｍｏｎｅｌｌａ　ｅｎｔｅｒｉｔｉｄｉｓ敗血症	サルモネラ敗血症	サイトメガロウイルス性肝炎
グル音異常	異常腸音	続発性副腎皮質機能低下症
鉄吸収障害	鉄欠乏症	脂漏性角化症
水中毒症状	水中毒	ゴーシェ病１型
鼻中隔彎曲	鼻中隔弯曲症	指骨骨折
本日右眼白内障	白内障	限局性悪性胸膜中皮腫
過敏性腸症侯群	過敏性腸症候群	脾静脈損傷
会話性幻聴	幻聴	小児アトピー性湿疹
筋疲労感	筋疲労	声帯機能不全
水疱後びらん	水疱症	上腕扁平母斑
胆管内結石	胆管結石症	妊娠性痒疹
時々せん妄	せん妄	頚椎胸椎捻挫
処置後膵炎	膵炎	不穏状態
術後右反回神経麻痺	術後性反回神経麻痺	門脈圧亢進症性胃腸症
反復性細菌感染	細菌感染症	アルカプトン尿性関節症
ｗｉｄｅ　ＱＲＳ頻拍	頻拍症	尿路閉塞
両側性末梢性顔面神経麻痺	末梢性顔面神経麻痺	下腿滑膜肉腫
皮膚軟部組織感染症	皮膚感染症	無虹彩
腰痛ヘルニア	椎間板ヘルニア性腰痛症	胎児心音異常
イレウス合併	イレウス	外耳道奇形
息苦しく	呼吸困難	血行性骨髄炎
肺好酸球性肉芽腫	肺好酸球性肉芽腫症	小腸上皮内癌
無菌性腸炎	非感染性腸炎	膵のう腫
骨盤内リンパ嚢腫	骨盤部感染性リンパのう胞	傍骨性骨肉腫
両側眼瞼下垂症	眼瞼下垂症	ヘーガース結節
両側性結核性胸膜炎	結核性胸膜炎	腎盂癌
甲状腺機能亢進症状	甲状腺機能亢進症	メタルコア不適合
平坦Ｔ波	心電図異常	新生児ビタミンＫ欠乏症
ペーシング不全	両室ペーシング機能付き植込型除細動器不全	上衣下巨細胞性星細胞腫
後頭部打撲	頭部打撲	腸アトニー
薬剤性過敏症候群	薬剤性過敏症症候群	急性骨髄炎
両側喉頭肉芽腫	喉頭肉芽腫	モンロー孔閉塞症
ふらつきあり	めまい	ＡＢＯ因子不適合
右鼡径ヘルニア	鼡径ヘルニア	痙攣発作
職業性ストレス	急性ストレス反応	マルケサーニ症候群
卵管水腫	卵管留水症	ウイルソン病
左下葉原発性肺扁平上皮癌	肺扁平上皮癌	脊髄硬膜内髄外神経鞘腫
外気胸	気胸	先天性頭蓋変形
ポリープ数個	ポリープ	趾挫傷
右低音障害型感音難聴	急性低音障害型感音難聴	慢性膀胱炎
外陰部血腫	外陰血腫	高身長児
左乳突蜂巣炎	乳様突起炎	副腎皮質腫瘍
未破裂左内頸動脈瘤	内頚動脈瘤	結腸上皮内癌
中咽頭側壁扁平上皮癌	癌	頭部頚部挫傷
ＥＶＡＮＳ症候群	エバンス症候群	小児肺炎
右聴神経腫瘍	聴神経腫瘍	必須脂肪酸欠乏症
両肺多発結節性陰影	胸部異常陰影	腹部膿瘍
左血腫	血腫	晩期先天梅毒
早期乳癌	乳癌	顎関節突起欠如
脾臓腫瘤	腫瘤	多形滲出性紅斑
多発髄膜腫	多発性髄膜腫	外頚静脈損傷
術中出血多	多量出血	口腔上顎洞瘻
先天性嚢胞肺	先天性のう胞肺	尺骨骨肉腫
手背部疼痛	手背部痛	根尖膿瘍
腹部大動脈嚢状瘤	腹部大動脈瘤	妊娠中の外陰静脈瘤
腫瘍感染合併	腫瘍	陳旧性足関節外側靱帯損傷
ＩＰ合併	間質性肺炎	サルモネラ敗血症
左腫瘤	腫瘤	鼻部皮膚良性腫瘍
ゾメタ骨髄炎	骨髄炎	第ＩＸ因子インヒビター陽性先天性血友病
葉酸欠乏	葉酸欠乏症	解離性胸部大動脈瘤
右胸膜原発血管肉腫	血管肉腫	下腿多発開放骨折
拘縮気味	筋拘縮症	筋緊張性障害
手関節圧痛	圧痛	子宮直腸瘻
浮腫残存	浮腫	肢運動失行症
非てんかん性心因性発作	てんかん	卵巣損傷・骨盤腔に達する開放創合併なし
鼻口蓋管嚢胞	鼻口蓋管のう胞	頚部転移性腺癌
下腸間膜動脈閉塞	腸間膜動脈塞栓症	若年性多発性関節炎
右中大脳動脈領域梗塞	中大脳動脈閉塞症	胃腸管損傷・腹腔に達する開放創合併あり
消化管腫瘤	腫瘤	前腕皮膚良性腫瘍
脛骨前面圧痕性浮腫	浮腫	腸間膜静脈血栓症
多少眠気	非器質性過眠症	起立性蛋白尿
高濃度腫瘤	腫瘤	巨頭症
ＤＧＥ症状	消化管術後後遺症	シャガス病脊髄炎
過形成性ポリープ	胃過形成ポリープ	趾挫傷
日光アレルギー	光線過敏症	副腎髄質機能亢進症
両膝痛	膝関節痛	慢性腸炎
こわばりあり	こわばり	手変形
慢性炎症性腸疾患	腸炎	外傷性股関節症
尺骨頭脱臼	脱臼	側頭部母斑
けいれん症状	痙攣	外耳道膿瘍
重度三尖弁閉鎖不全症	三尖弁閉鎖不全症	胆のう管肥大
肺炎併発	肺炎	子宮頚部環状剥離
右下肢感覚鈍麻	感覚異常症	肝静脈塞栓症
第二度房室ブロック	第２度房室ブロック	真性包茎
慢性進行性肺アスペルギルス症	肺アスペルギルス症	先天性白内障
点状発赤	発赤	少関節型若年性関節炎・手関節
白血病化	白血病	舟底足
消退性発赤	発赤	少関節型若年性関節炎・手関節
ヒステリー	ヒステリー反応	瞳孔不整
手指皮疹	発疹	肺静脈損傷
残尿	残尿感	高張性脱水症
腫脹圧痛	圧痛	急性放射線皮膚炎
ループスアンチコアグラント陰性	ループスアンチコアグラント	側胸部第２度熱傷
両肺気胸	気胸	会陰血腫
右肺胸水貯留	胸水貯留	先天性巨大動脈瘤
血性吐物	吐血	右脚ブロック
両側腓骨神経麻痺	腓骨神経麻痺	鈍痛
廃用	廃用症候群	直乱視
浮動感	めまい	膵漿液性のう胞腫瘍
軽度右室肥大	右室肥大	血小板機能低下
右膝蜂窩織炎	膝部蜂巣炎	外傷性脳室内出血・頭蓋内に達する開放創合併なし
強制換気	人工呼吸器装着状態	卵巣胚細胞腫瘍
２型＋ステロイド糖尿病	ステロイド糖尿病	背側骨間筋麻痺
左下肢ガス壊疽	ガス壊疽	両側性停留精巣
低血糖用	低血糖	風疹様発疹
喚語障害	不全失語症	大腿骨遠位端開放骨折
右足底潰瘍	足底皮膚潰瘍	混合性特異的発達障害
右網膜静脈分枝閉塞症	網膜静脈分枝閉塞症	腸脛靱帯症候群
腹痛時	腹痛症	淋菌性肺炎
多動多弁	多動性障害	頬部皮膚癌
右手背浮腫	限局性浮腫	器質性の妄想状態および幻覚妄想状態
足趾しびれ	下肢しびれ	汎発性ヘルペス
突然意識障害	意識障害	ヒステリー性側弯症
足底痺れ	しびれ感	スキーン腺膿瘍
角膜ヘルペス	ヘルペス角膜炎	腟熱傷
食思不振症状	食欲不振	ジスキネジア
細菌性食道炎	食道炎	鎮痛薬依存
開大代謝性アシドーシス	代謝性アシドーシス	腰部脂肪腫
心因性過食症	心因性過食	乳頭周囲炎
術後肺転移	転移性肺腫瘍	腹壁冷膿瘍
転移性腫瘤	転移性腫瘍	前腕皮膚良性腫瘍
夜間尿意	夜間頻尿症	咽頭創傷
右下腿腫脹	下腿腫脹	環指化膿性腱鞘炎
背部皮脂欠乏性湿疹	皮脂欠乏性湿疹	下腿陳旧性打撲
足爪白鮮	足爪白癬	クロム中毒
神経性疼痛	神経痛	膵損傷・腹腔に達する開放創合併あり
房室接合部調律	異所性調律	肺動脈弁上狭窄症
末梢循環不全徴候	末梢循環不全	血管性頭痛
眼瞼下垂自覚	眼瞼下垂症	ヘーガース結節
右上顎洞乳頭腫	上顎洞乳頭腫	慢性特発性偽性腸閉塞症
帯状疱疹拡大	帯状疱疹	項部有棘細胞癌
左尾状核ラクナ硬塞	ラクナ梗塞	前腕横紋筋肉腫
ＳＭＡ閉塞	急性上腸間膜動脈閉塞症	坐骨直腸窩脂肪肉腫
めまいの発作	めまい	老人性紫斑
呼吸切迫	急性呼吸窮迫症候群	趾基節骨開放骨折
劇症型連鎖球菌感染症	連鎖球菌感染症	上腕骨遠位端開放骨折
腹部疝痛	仙痛	皮膚原発性未分化大細胞リンパ腫
胆嚢多発ポリープ	胆のうポリープ	自己免疫性心膜炎
柑皮症	カロチン血症	第４脳室脈絡叢乳頭腫
浮腫状	浮腫	未萌出歯
陰部掻痒	外陰部そう痒症	良性反復性肝内胆汁うっ滞症
十二指腸多発びらん	十二指腸びらん	根面板不適合
前立性肥大症	前立腺肥大症	舌骨骨折
嘔気状況	嘔気	急性細菌性心膜炎
両側眼球外転障害	眼球運動障害	皮膚腫瘤
元々浮腫	浮腫	肢運動失行症
左小脳出血	小脳出血	ＢＬＮＡＲ感染症
躁うつ	躁うつ病	覚醒剤中毒後遺症
夜間失禁	尿失禁症	後腹膜悪性腫瘍
ベージェット病	ベーチェット病	デビス紫斑
元来頭痛	頭痛	炭坑夫塵肺症
褥瘡発生リスク低い	褥瘡	異所性膵
下部直腸癌	直腸癌	足底有棘細胞癌
両側総腸骨動脈狭窄	総腸骨動脈狭窄	続発性虹彩炎
牽引痛	牽引性頭痛	レフレル心内膜炎
Ⅱ度熱傷	熱傷	汎小葉性肺気腫
重度感覚障害	体感異常	スリム病
両側肺尖部進行性胸膜肥厚	胸膜肥厚	子癇
婦人入院脳梗塞	脳梗塞	梅毒性粘膜疹
炎症性ポリープ多発	ポリープ	静脈機能不全症
右坐骨結節転移再発	転移性腫瘍	肝内胆管癌
ダンピング症候群併発	ダンピング症候群	副鼻腔癌
右上肢痺れ	しびれ感	咬合平面の異常
ＭＣＴＤ	混合性結合組織病	血小板無力症
ループスアンチコアグラント陽性	ループスアンチコアグラント	側胸部第２度熱傷
昨日水様便	下痢症	副筋
気分不快増強	悪心	先天性大動脈弁閉鎖不全症
拡張期高血圧	高血圧症	リポイド肝炎
右気管支肺炎	気管支肺炎	上肢皮膚癌
左頸部リンパ節腫大	薬剤性自己免疫性溶血性貧血	足炎
右低音部感音難聴	感音難聴	過外転症候群
ＰＨＴ	肺高血圧症	動脈還流異常
夜間失見当	見当識障害	陰のう開放創
劇症型髄膜炎菌感染症	髄膜炎菌感染症	三叉神経痛第３枝領域
物忘れ気	健忘症	乳頭形成不全
両難聴	難聴	ピルビン酸脱水素酵素複合体欠損症
左腎細胞癌	腎細胞癌	しゃっくり
多発膵転移	転移性膵腫瘍	悪心
両眼白内障手	白内障	腸管破裂・腹腔に達する開放創合併あり
右手関節滑膜炎	滑膜炎	振動性じんま疹
膠原病由来	膠原病	肋骨多発開放骨折
声門上喉頭癌	喉頭癌	内臓下垂
右膝メルケル細胞癌	メルケル細胞癌	スケレトンタイプ急速拡大装置破損
右椎骨動脈起始部狭窄	椎骨動脈狭窄症	鼡径部腫瘍
加害妄想	妄想反応	耳介ボーエン病
嚢胞性胸腺腫	胸腺腫	股関節異所性骨化
急性乳突洞炎	急性中耳炎	腹壁神経痛
舌内リンパ節転移	リンパ節転移	先天性肺線維症
悪性リンパ腫既往	悪性リンパ腫	二次性糖尿病・糖尿病性合併症あり
左肺下葉腫瘤影	肺腫瘤	視床下部機能障害
Ｌ３圧迫骨折	圧迫骨折	陰のう湿疹
左感音性難聴	感音難聴	非定型精神病
腎臓疾患	腎疾患	ひ素色素沈着
ＣＯＰＤＩ期	慢性閉塞性肺疾患	サルモネラ敗血症
転倒歴多数	よろめき歩行	胸郭出口症候群
ＤＩＨＳ	薬疹	サルモネラ敗血症
夜勤帯下血	下血	膿痂疹性湿疹
インスリン依存性糖尿病	１型糖尿病	外陰炎
頸部椎間板ヘルニア	頚椎椎間板ヘルニア	線維性骨異形成症
右眼網膜裂孔	網膜裂孔	耳介打撲傷
拍動性疼痛	疼痛	縫合部膿瘍
下血増悪	下血	頬部単純性血管腫
ＤＭ性腎不全	糖尿病性腎不全	急性炎症性緑内障
膝関節軽度屈曲拘縮	屈曲拘縮	大腿骨軟骨肉腫
ＡＴＬ	成人Ｔ細胞白血病リンパ腫	血小板無力症
肺動脈弁閉鎖不全	肺動脈弁閉鎖	上腕悪性線維性組織球腫
熱感軽度	ほてり	肺炎桿菌性先天性肺炎
重度不眠	不眠症	人工弁感染
咀嚼困難感	咀嚼障害	混合型先天性ヨード欠乏症候群
食道圧迫	食道圧迫症	食事性下痢
両足関節痛	足関節痛	顔面皮膚腫瘍
術後肝転移	転移性肝癌	膀胱下垂
朝低血糖	低血糖	口唇石灰化上皮腫
喘息疑い	咳喘息	足底疣贅
顔皮疹	発疹	膵臓破裂・腹腔に達する開放創合併なし
子宮筋腫有	子宮筋腫	先天性股関節亜脱臼
淡明細胞型腎細胞癌	腎細胞癌	しゃっくり
浮腫生	浮腫	未萌出歯
再出血徴候	出血	橈骨尺骨骨折
アシネトバクター敗血症	敗血症	サイトメガロウイルス性肝炎
左自然気胸再発	自然気胸	体表面積５０−５９％の熱傷
高度肥満２型糖尿病	２型糖尿病	虹彩毛様体炎
右大腿骨骨肉腫	大腿骨骨肉腫	人工授精後骨盤内炎症性疾患
左腎盂腎炎治癒後	腎盂腎炎	アルプス病
二次性水頭症	外傷後水頭症	緑内障性乳頭陥凹
ダグラス窩播種	腹膜播種	湿疹性眼瞼皮膚炎
左室拡張能低下	左室不全	前額部母斑細胞母斑
ウィルス感染症	ウイルス感染症	糖尿病性神経障害性疼痛
左手尺骨神経麻痺	尺骨神経麻痺	変視症
周期性呼吸時折	周期性呼吸	幼稚症
異常帯下	帯下	ウェルニッケ脳症を伴う妊娠悪阻
多発性大腸ポリープ	大腸ポリープ	先天性魚鱗癬
糖尿病用	糖尿病	陰茎挫傷
術前心電図異常	心電図異常	グリオーシス
中耳炎症状	中耳炎	陰茎萎縮
脱力症状	脱力感	上腕骨通顆骨折
上半身掻痒感	そう痒	陳旧性手指捻挫
動揺性めまい	めまい	虚血性脳卒中
褥瘡発生歴	褥瘡	複雑性合指症
水分摂取困難	嚥下障害	脳卒中
趾爪囲炎	爪囲炎	股関節亜脱臼二次性変股症
右下葉原発低分化腺癌	癌	小児ＥＢＶ陽性Ｔ細胞リンパ増殖性疾患
挙上期誤嚥	異物誤嚥	Ｓ状結腸憩室穿孔
腹部膨満増強	腹部膨満	虹彩癒着
右副腎腫瘍摘出術	副腎腫瘍	腎性蛋白尿
右鎖骨痛	鎖骨痛	皮膚瘻
細菌性扁桃炎	扁桃炎	小水疱性皮膚炎
左歯性上顎洞炎	歯性上顎洞炎	卵管筋腫
重度歯周病	歯周症	ジアルジア症
正常圧緑内障	緑内障	続発性緑内障
梗塞後出血	出血性脳梗塞	ＫＩＴ（ＣＤ１１７）陽性小腸消化管間質腫瘍
骨髄異型性症候群	骨髄異形成症候群	２型糖尿病性腎症第５期
光線過敏	光線過敏症	膝色素性絨毛結節性滑膜炎
副睾丸炎	精巣炎	脳幹部腫瘍
虚脱病変	虚脱	２型糖尿病性腎症第３期Ｂ
慢性アレルギー性鼻炎	季節性アレルギー性鼻炎	ミエロペルオキシダーゼ欠損症
肘痛	肘関節痛	人工股関節脱臼
夕食前低血糖	低血糖	口唇石灰化上皮腫
先天性代謝異常症	代謝障害	慢性表在性舌炎
単頸双角子宮	双角子宮	前頭蓋窩開放骨折
原発性肺高血圧症	肺高血圧症	局所性脳損傷・頭蓋内に達する開放創合併あり
左眼加齢性黄斑変性症	加齢黄斑変性	膝蓋靱帯部分断裂
左鎖骨リンパ節転移	リンパ節転移	慢性尿路感染症
殿部色素沈着	色素異常症	咽頭喉頭炎
舌浮腫	浮腫	捻挫
ストレス性潰瘍	ストレス潰瘍	肋骨線維性骨異形成症
舌損傷	損傷	重複腎動脈
発熱下	発熱	発疹チフス
失見当識発言	見当識障害	急性心内膜炎
右眼内悪性リンパ腫	眼窩悪性リンパ腫	癌
腹部大動脈狭窄	大動脈狭窄症	びまん性脳損傷・頭蓋内に達する開放創合併なし
右季肋部自発痛	季肋部痛	肝脾Ｔ細胞リンパ腫
軽度痺れ	しびれ感	無耳症
星芒状血管腫	血管腫	頑癬
右房内腫瘤	腫瘤	日本海裂頭条虫症
Ｓ状結腸転移	転移性消化器腫瘍	蝸牛耳硬化症
全身掻痒感	そう痒	乾癬性関節炎・足関節
右手舟状骨骨折	手舟状骨骨折	言語理解障害
肉芽腫性腸疾患	腸疾患	非特異性低血圧症
両足圧痕性浮腫	浮腫	器質性の妄想状態および幻覚妄想状態
発作後精神病	精神病	非呼吸性アシドーシス
虫垂粘液嚢胞腺腫	虫垂粘液のう胞	セメント刺激性接触皮膚炎
四肢水疱	水疱症	上腕扁平母斑
右足趾骨髄炎	趾骨髄炎	尿管尿路上皮癌
若年性リウマチ	関節リウマチ	ツースポジショナー不適合
体陽性脳炎	脳炎	２型糖尿病性アシドーシス
境界域ＤＭ	糖尿病	下顎角部開放骨折
結節性不整脈	不整脈	角膜異物
劇症敗血症	敗血症	続発性副甲状腺機能低下症
慢性血腫	血腫	難治性てんかん
骨破壊病変	関節リウマチ	直腸びらん
眼窩部痛	眼痛	ＧＡＬＥ欠損症
昨日不眠	不眠症	人工弁感染
頚椎脊柱管狭窄症	頚部脊柱管狭窄症	多臓器不全
発赤域	発赤	少関節型若年性関節炎・手関節
膵頭部転移	転移性膵腫瘍	悪心
高度肝障害	肝障害	連鎖球菌性アンギナ
右肺下葉腫瘍	肺腫瘍	尿管閉塞
口腔内発赤腫脹	発赤	持続的菌血症
中咽頭再発腫瘍	咽頭腫瘍	サイトメガロウイルス性膵炎
左下肢冷感	下肢冷感	非医学的人工妊娠中絶
大腫瘍	腫瘍	小指中手骨遠位端骨折
胸骨肋骨転移	肋骨転移	筋肉内血腫
重症心身障害児	重症心身障害	多発脂肪腫
腹部軽度膨隆	腹部膨満	精神作用薬中毒
リンパ管症	癌性リンパ管症	ヘモグロビンＳＳ病
遷延性抑うつ状態	うつ状態	脊椎骨端骨異形成症
結核性強膜炎	結核性胸膜炎	後頭蓋窩硬膜外血腫・頭蓋内に達する開放創合併なし
下腿筋萎縮	筋萎縮症	環指屈筋腱癒着
膵頭癌	癌	虹彩形成不全症
ＶＡＨＳ	ウイルス関連血球貪食症候群	動脈還流異常
圧痛自発痛	圧痛	急性放射線皮膚炎
痰中等量引ける	喀痰	静脈内膜炎
放射線障害	放射線宿酔	分娩における麻酔の循環器系合併症
浅眠	不眠症	起立性蛋白尿
反射異常	異常反射	顔面切創
慢性間質性腎炎	慢性尿細管間質性腎炎	大動脈弁狭窄症兼僧帽弁閉鎖不全症
脳溢血	脳卒中	乳頭状上衣腫
右下肢深部静脈血栓症	下肢静脈血栓症	産褥子宮退縮不全
カテーテル感染	カテーテル感染症	乱視
腫瘍多発	腫瘍	小指中手骨遠位端骨折
背部筋緊張高い	筋強直	神経性眼精疲労
全身紅斑	紅斑症	単純性尿路感染症
しびれてる感	しびれ感	肩甲部圧挫傷
少量尿失禁	尿失禁症	内側半月のう腫
脳腫瘍切除	脳腫瘍	Ｂ型急性肝炎
右側下顎骨体部骨折	下顎骨骨折	胸骨軟骨肉腫
高血糖是正	高血糖症	胸椎部打撲挫傷
腫瘤拡大	腫瘤	鼻部皮膚良性腫瘍
病原性大腸菌	病原性大腸菌感染症	乳様突起カリエス
耳小骨奇形	耳小骨の先天奇形	慢性炎症性脱髄性多発神経炎
全身性紫斑	全身性紫斑病	急性硬膜外血腫・頭蓋内に達する開放創合併あり
微小多発脳梗塞	多発性脳梗塞	神経因性膀胱
右股関節亜脱臼	股関節亜脱臼	頻発月経
糸球体血尿	血尿	開放性外傷性小脳血腫
左橈骨神経麻痺	橈骨神経麻痺	上部胆管癌
全身性間代性痙攣	間代性痙攣	しゅさ性眼瞼炎
右肋間痛	肋間痛	下口唇有棘細胞癌
右続発性緑内障	続発性緑内障	顎変形症
軟骨腫	骨軟骨腫	静脈周囲炎
開大性代謝性アシドーシス	代謝性アシドーシス	腰部脂肪腫
パニック様症状	全般性不安障害	転座トリソミー１８
胆嚢充満結石	胆のう結石症	妊娠性痒疹
左上葉肺転移	転移性肺腫瘍	腎疾患
軽度しびれ感	しびれ感	肩甲部圧挫傷
意識レベル低	意識障害	ジューリング病
爪囲紅斑	爪囲炎	単純性尿路感染症
子宮頸癌Ｉｂ１期	子宮頚癌	爪甲軟化症
感覚性運動失調	運動失調	肥満細胞症
両側鎖骨上窩リンパ節腫大	リンパ節腫大	後頭葉神経膠腫
中枢性めまい	中枢性めまい症	四肢末梢循環障害
関節滑膜炎	滑膜炎	振動性じんま疹
続発性膜性腎症	膜性腎症	胸椎椎間板炎
立位保持困難	四肢筋力低下	胸椎腫瘍
先天性風疹症侯群	先天性風疹症候群	尿培養所見陽性
左足痺れ	しびれ感	両側性唇顎軟口蓋裂
Ｒｉｅｄｅｌ甲状腺炎	線維性甲状腺腫	胃食道逆流症
椎骨動脈狭窄	椎骨動脈狭窄症	鼡径部腫瘍
活動性肺結核症	活動性肺結核	趾骨悪性腫瘍
鼻腔化膿性肉芽腫	細菌性肉芽腫症	二次性甲状腺機能低下症
痙攣発作再発	痙攣発作	手掌白癬
右脛骨内果骨折	足関節内果骨折	上腕第２度熱傷
左胸膜転移	胸膜播種	急性心不全
卵巣腫瘍再発	卵巣腫瘍	血管迷走神経性失神
右肺中葉転移	転移性肺癌	インレー脱離
下腿筋痛	下肢筋肉痛	慢性角結膜炎
右大腰筋血腫	血腫	脛骨腓骨骨幹部開放性粉砕骨折
十二指腸潰瘍再発	慢性十二指腸潰瘍	萎縮性咽頭炎
Ａｆ不変	心室細動	眼部皮下血腫
左下腿部帯状疱疹	帯状疱疹	脳回転状皮膚
顔面麻痺１	顔面神経麻痺	円板状角膜炎
巨大腫瘤	腫瘤	鼻部皮膚良性腫瘍
右足関節腫脹	足関節腫脹	重度栄養失調
外陰部湿疹	湿疹	鉄欠乏症
両肺副雑音	胸部音異常	咬耗症
腎機能異常	腎機能検査異常	カッパ鎖欠乏症
姿勢障害	姿勢異常	上腕部挫傷
左肘頭開放骨折	開放骨折	ドルーゼン
イレウス発生	イレウス	外耳道奇形
若干硬結	硬結	ミトコンドリア心筋症
左骨盤内リンパ嚢胞	骨盤部感染性リンパのう胞	縦隔気腫
発作性３度房室ブロック	第３度房室ブロック	胸腰椎側弯症
身体損傷	損傷	頚椎骨肉腫
右大腿骨骨腫瘍	大腿骨腫瘍	直腸肛門周囲膿瘍
慢性胆嚢炎	慢性胆のう炎	毛細血管脆弱症
偽性高Ｋ血症	高カリウム血症	頚皮膚上皮内癌
反応性胸水	胸水貯留	先天性巨大動脈瘤
元々痛み	疼痛	円蓋部髄膜腫
骨盤内膜症	骨盤子宮内膜症	狂信的パーソナリティ障害
右耳下腺腫瘤	耳下腺腫瘤	糸球体性蛋白尿症
肝形質細胞腫	形質細胞腫	異型性ポルフィリン症
躁病相	躁状態	副趾
易出血傾向	出血傾向	死体腎移植後
ジューリング疱疹状皮膚炎	ジューリング病	結腸回転不全
末梢発赤	発赤	少関節型若年性関節炎・手関節
部分性脂肪萎縮症	部分的脂肪萎縮症	複殿位
亜急性脊髄連合変性症	亜急性連合性脊髄変性症	錐体杆体ジストロフィー
副腎偶発腫	良性副腎皮質腫瘍	胃腸ポリープ
右下腿紅斑	紅斑症	五胎分娩
腸管通過障害	消化管狭窄	卵巣周囲炎
努力様呼吸	起坐呼吸	後鼻漏
膿疱形成	膿疱	視神経乳頭萎縮
左卵巣膿瘍	卵巣膿瘍	閉鎖性肝内血腫
発赤皮疹	発疹	動脈瘤
赤痢アメーバ大腸炎	アメーバ赤痢	仮性真珠腫
サイトメガロウイルス感染	サイトメガロウイルス感染症	尿道憩室
Ｇｒａｄｅ　３肝障害	肝障害	上顎セメント芽細胞腫
低ＡＬＢ血症	低アルブミン血症	頭部打撲傷
Ⅱ型糖尿病	２型糖尿病	項部打撲傷
両顎関節痛	顎関節痛	下咽頭癌
逆流性胆管炎	逆行性胆管炎	斜視
関節痛症状	関節痛	梅毒性パーキンソン症候群
空気塞栓	空気塞栓症	鼡径肉芽腫
肝膿瘍破裂	肝膿瘍	僧帽筋筋膜症
総肺静脈還流異常症	肺静脈還流異常症	手指多発開放骨折
両下腿痛	下腿痛	白内障術後結膜炎
左橈骨頭脱臼骨折	脱臼骨折	中手骨内軟骨腫
正中創感染	創傷感染症	うつ状態
左網膜分枝動脈閉塞症	動脈閉塞症	幽門閉鎖
頸部浮腫	浮腫	器質性の妄想状態および幻覚妄想状態
肺扁平上皮癌、病期不明	肺扁平上皮癌	外転神経根性麻痺
低血圧自覚症状	低血圧症	上顎打撲傷
常時痛み	疼痛	中大脳動脈塞栓症
倦怠感増	倦怠感	殿部メルケル細胞癌
脾臓腫瘍	脾腫瘍	新生児皮脂漏
多発肝転移増大	転移性肝癌	気圧性外傷
頸部食道狭窄	食道狭窄	関節骨折
陰茎アポクリン癌	陰茎アポクリン腺癌	老人性結膜萎縮
元来月経痛	月経痛	骨膜炎
胆嚢十二指腸瘻	胆のう十二指腸瘻	離開骨折
特発性肺胞出血	肺胞出血	腹部腫瘤
左鼠径部疼痛	鼡径部痛	肺切除術後
左側頬粘膜癌	頬粘膜癌	趾メルケル細胞癌
円盤状皮疹	円板状エリテマトーデス	頭部損傷・頭蓋内に達する開放創合併なし
左手首疼痛	手部痛	先天性腟異常
アレルギー反応	アレルギー	縦隔結核
夜間痙攣	痙攣	手骨多発骨折
膵体部小嚢胞	腫瘍性膵のう胞	ゴールドブラット腎
耳介脂漏性湿疹少	脂漏性皮膚炎	末梢循環不全
両側急性硬膜下出血	急性硬膜下血腫	一次性運動時頭痛
毎回尿失禁	尿失禁症	内側半月のう腫
喉頭蓋腫脹	喉頭蓋炎	重金属誘発性腎症
愁訴	不定愁訴症	牛乳によるアナフィラキシーショック
血腫不変	血腫	晩期先天梅毒
各種膠原病	膠原病	肋骨多発開放骨折
肺気胸	気胸	大動脈弁閉鎖不全症兼肺動脈弁狭窄症
深部感覚鈍麻	感覚異常症	上顎結節部癌
脊柱圧痛	圧痛	急性放射線皮膚炎
亜脱臼傾向	亜脱臼	直腸瘻
自傷痕	自傷	下肢趾脱疽
嘔吐持続	嘔吐症	膀胱瘤合併妊娠
痙攣重積後脳症	痙攣重積型二相性急性脳症	閉塞性血管炎
小腸大腸型	小腸大腸クローン病	喉頭蜂巣炎
薬剤肝障害	薬物性肝障害	脳死状態
転移性膵体部癌	膵体部癌	トリコモナス性精のう炎
左前頭葉神経膠腫	前頭葉神経膠腫	子宮体腫瘍
精神運動興奮	精神運動興奮状態	前立腺症
インフルエンザＡ型感染症	インフルエンザＡ型	小唾液腺癌
紅斑反応	紅斑症	頚髄星細胞腫
右尿管結石症	尿管結石症	骨盤切断術後
瞳孔不同	瞳孔不同症	椎体圧迫骨折
多発肝転移巣	転移性肝腫瘍	気圧性外傷
顕微鏡的大腸炎	大腸炎	肝性浮腫
直腸Ｒａ癌	直腸癌	下行結腸多発憩室
原発性アルドステロン	原発性アルドステロン症	毛様体剥離
苔癬局面	苔癬	掌側手根間靱帯断裂
足趾爪混濁肥厚	ころもじらみ寄生症	食道神経症
ＣＭＶ肺炎	サイトメガロウイルス肺炎	ＧＭ２ガングリオシドーシス１型
右ＩＣＡ狭窄	内頚動脈狭窄症	胸骨傍ヘルニア
痰貯留	喀痰	淋菌性結膜炎
足趾蜂窩織炎	足蜂巣炎	十二指腸ポリポーシス
僧帽弁狭窄兼逆流症	僧帽弁狭窄症	掌蹠膿疱症性骨関節炎
中背部悪性黒色腫	背部悪性黒色腫	肩筋筋膜炎
歯槽膿漏	歯周炎	肩関節唇損傷
左肘関節破壊	関節リウマチ・肘関節	二次性糖尿病
副甲状腺亢進症	副甲状腺機能亢進症	ＰＩＰ関節開放性脱臼骨折
右声帯不全麻痺	声帯不全麻痺	睡眠時無呼吸症候群
心合併症	心臓合併症	先天性気管奇形
皮下石灰化	皮膚石灰沈着症	院内感染敗血症
薬剤性発熱	発熱	殿部よう
労作時前胸部痛	前胸部痛	大腿骨側頚部開放骨折
肺炎等	肺炎	ＨＥＬＬＰ症候群
軽度ＡＤＨＤ	注意欠陥多動障害	結核性気胸
新生児一過性多呼	新生児一過性多呼吸	クラスプ脱離
両心房拡大	心肥大	ＢＫウイルス腎症
上転障害	眼球運動障害	下肢悪性腫瘍
不眠状態	不眠症	人工弁感染
プレクリニカルクッシング症候群	クッシング症候群	硝子体異物残留
左胸鎖乳突筋炎	胸鎖乳突筋炎	メタルコア脱離
腫瘍性	腫瘍	慢性腸アメーバ症
時々関節痛	関節痛	声門うっ血
嫌悪感	悪寒	髄液混濁
二次性僧帽弁閉鎖不全症	僧帽弁閉鎖不全症	小菱形骨開放骨折
急性大動脈弁閉鎖不全	大動脈弁閉鎖不全症	良性成人型家族性ミオクローヌスてんかん
左心肥大	心肥大	多胎自然分娩
腹痛嘔気	嘔気	淋菌性肺炎
前頭部打撲	頭部打撲	腸アトニー
左大腿部骨外性粘液型軟骨肉腫	軟骨肉腫	大腿骨不全骨折
高度異形成相当	子宮頚部高度異形成	顔面凍傷
腹緊なし	腹部膨満	虹彩癒着
右頚部ＬＮ腫大	リンパ節腫大	陳旧性足関節外側靱帯損傷
側卵巣嚢腫	卵巣のう腫	副肝
哺乳後嘔吐	嘔吐症	一過性棘融解性皮膚症
右結石性腎盂腎炎	結石性腎盂腎炎	パラタルバー脱離
Ｃｒｏｎｋｈｉｔｅ−Ｃａｎａｄａ症候群	クロンカイト・カナダ症候群	ペルオキシソーム病
心嚢液貯留	心膜液貯留	下肢末梢循環障害
臓器限局性前立腺癌	限局性前立腺癌	肝門部癌
貧血傾向	貧血	頚部ボーエン病
右中大脳動脈梗塞	内頚動脈塞栓症	胃腸管損傷・腹腔に達する開放創合併あり
日中傾眠	傾眠症	アルコール性肝疾患
脾臓結核	結核	薬剤性溶血性貧血
食後高血糖	高血糖症	胸椎部打撲挫傷
高浸透圧血症	高血糖高浸透圧症候群	角膜移植後
両下肢軽度浮腫	下肢浮腫	腹圧性尿失禁
右間歇性跛行	間欠性跛行	若年者キーンベック病
陰嚢ヘルニア	陰のうヘルニア	中毒性白内障
多形紅斑型薬疹	薬疹	アレルギー性気管支炎
右腋窩リンパ節腫脹	腋窩リンパ節腫脹	皮膚ジフテリア
静脈内腫瘍栓	腫瘍	入水自殺未遂
爪甲剥離症	爪剥離症	麻薬中毒
再度急性腎不全	急性腎不全	急性炎症性緑内障
進行再発大腸癌	大腸癌	先天性四肢麻痺
胃接合部癌	胃癌	１７α−水酸化酵素欠損症
耳閉塞感	耳閉感	微弱陣痛新生児
手足しびれ	しびれ感	汎発性ヘルペス
内膜損傷	損傷	ワンサン気管支炎
胃小彎側ＬＮ転移	胃周囲リンパ節転移	智歯周囲炎
軽度発達遅滞	発達遅滞	うつ病
非浸潤性膀胱癌	膀胱癌	強膜潰瘍
右先天性耳瘻孔	先天性耳瘻孔	カルチノイド
脂肪腫摘出	脂肪腫	脳挫傷
椎間板ヘルニア有	椎間板ヘルニア	化膿性椎間板炎
扁平ポリープ	ポリープ	趾挫傷
咽頭知覚障害	咽頭異常感症	耳性めまい
腸液貯留	体液貯留	日光網膜症
両変形性膝関節症	変形性膝関節症	産褥子宮内膜炎
急性胆嚢胆管炎	胆管炎	眼瞼割創
扁平上皮癌	癌	下背部ストレイン
内痔核脱出	内痔核	住血吸虫性皮膚炎
びまん性脳浮腫	脳浮腫	捻挫
呼気困難	呼吸困難	慢性複雑性膀胱炎
重症鬱血性心不全	うっ血性心不全	本態性高血圧症
大腸早期癌	大腸癌	足底筋肉内異物残留
喘鳴聴取	喘鳴	多のう胞性卵巣症候群
左乳癌特	乳癌	鼻漏
Ａ型溶連菌感染症	溶連菌感染症	局在性網脈絡膜炎
悪性副腎外褐色細胞腫	褐色細胞腫	線維乾酪性心膜炎
傍隔壁型肺気腫	肺気腫	動脈硬化性眼底所見
角膜糜爛	角膜びらん	炎症性ミオパチー
骨盤内播種新生	骨盤転移	本態性自律神経症
急性非代償性心不全	心不全	脛骨腓骨近位端開放骨折
最近便秘	便秘症	排尿障害
右頬部痛	頬部痛	帝王切開創感染症
右肺動静脈瘻	肺動静脈瘻	胎児発育過度
１型高ウイルスＣ型慢性肝炎	Ｃ型慢性肝炎	鼡径部脂肪肉腫
問題なし膀胱直腸障害	膀胱直腸障害	卵巣莢膜細胞腫
Ｌｉｓｔｅｒｉａ腸炎	細菌性腸炎	副眼瞼
右膿胸	膿胸	脾の分娩損傷
ヒリヒリ感	疼痛	多発性角膜びらん
時折胸痛	胸痛	猫ひっかき病
大動脈弁下心室中隔欠損	心室中隔欠損症	子宮強直
右傍矢状静脈洞髄膜腫	髄膜腫	リチウム中毒
無自覚性低血糖	低血糖	風疹様発疹
両側卵管留血腫	卵管留血腫	傍十二指腸ヘルニア
脱水注意	脱水症	植込型カテーテルポート破損
心尖部型肥大型心筋症	肥大型心筋症	薬剤誘発性ループス
右飛蚊症	飛蚊症	眼瞼石灰化上皮腫
腎不全保存期	腎不全	チェーン・ストークス呼吸
口腔内炎	口内炎	術後性慢性中耳炎
びまん性大細胞	びまん性大細胞型Ｂ細胞性リンパ腫	リウマチ性虹彩炎
大うつ病	単極性うつ病	肩甲帯末梢神経損傷後遺症
肝門部悪性リンパ腫	肝門部リンパ節転移	台状根
精神病性うつ病	うつ病	手関節切断
水疱性類天疱	水疱症	多発性下肢挫滅創
中枢性低換気	換気量減少	びまん性気管支拡張症
右膝ＡＣＬ損傷	前十字靱帯損傷	コレラ
全身倦怠感軽度	全身倦怠感	先天性大動脈弁閉鎖不全症
混合難聴	難聴	外傷性脾破裂
毛孔一致性丘疹	丘疹	腰椎硬膜外血腫
先天性巨大色素性母斑	巨大母斑細胞母斑	肩関節脱臼
不安大	不安障害	直腸癌穿孔
胸骨下液体貯留	体液貯留	日光網膜症
新出肺転移	転移性肺腫瘍	腹壁冷膿瘍
左聴器癌	癌	コロラドだに熱
多発脳神経障害	多発性脳神経障害	アジソン病
上腹部リンパ節転移	リンパ節転移	智歯周囲炎
被殻梗塞	被殻出血	脛骨骨挫傷
直腸Ｒａｂ癌	直腸癌	下行結腸多発憩室
軽度高血糖	高血糖症	胸椎部打撲挫傷
本日硬便少量	便異常	側頭葉悪性腫瘍
２型腫瘤	腫瘤	鼻部皮膚良性腫瘍
右腎無形成	腎無形成	手指第２度熱傷
リンパ節圧痛	圧痛	無脳回症
全身性細菌感染症	細菌感染症	アルカプトン尿性関節症
脳髄膜瘤	髄膜脳瘤	脾性好中球減少症
水頭症症状	水頭症	拒絶反応
小血栓	血液凝固異常	頚動脈ステント植え込み状態
右耳失聴	聴覚消失	下腿静脈血栓症
統合失調症合併	統合失調症	直腸Ｓ状部悪性腫瘍
胃痛症状	胃痛	反復性肘関節脱臼
急性期ＨＩＶ感染症	ＨＩＶ感染症	頬腔異物
右下肢運動障害	四肢運動障害	外傷性嗅神経損傷
炎症性脱髄性多発根神経炎	慢性炎症性脱髄性多発神経炎	心因性視力障害
上行結腸腫瘤	腫瘤	４分の３冠粗造
過食症状	過食症	疲労感
疾病不安	不安障害	ラテックスアレルギー
肺癌手術	肺癌	腟癒着
色素脱失	炎症後色素脱失	脳対側損傷
膿貯留	膿瘍	連鎖球菌性胸膜炎
片側副腎腫瘍	副腎腫瘍	ピアソン症候群
リンパ節腫脹	リンパ節腫大	割創
右椎骨動脈巨大血栓化動脈瘤	椎骨動脈瘤	顕微鏡的多発血管炎
カテ感染	カテーテル感染症	乱視
安心感	心気症	髄液混濁
左鼡径ヘルニア再発	鼡径ヘルニア	腫瘍性大腿骨病的骨折
胃食道静脈瘤破裂	食道静脈瘤破裂	ヌーナン症候群
左足背蜂窩織炎	足背蜂巣炎	形質細胞白血病
右胸水貯留	胸水貯留	先天性巨大動脈瘤
暗青色斑	青色母斑	肺カルチノイド
ＨＣＶ陽性	Ｃ型肝炎ウイルス感染	動脈還流異常
疲労感生	疲労感	孤発性クロイツフェルト・ヤコブ病
感染性静脈血栓症	静脈血栓症	脳動静脈奇形破裂によるくも膜下出血
両側腎腫大	腎腫大	骨盤内臓器損傷・骨盤腔に達する開放創合併なし
過敏性膀胱炎	膀胱炎	副子破損
包交時出血	出血	先天性腹部奇形
右坐骨骨折	坐骨骨折	若年型ＧＭ１ガングリオシドーシス
右耳下腺腫脹	耳下腺腫脹	耳管閉塞症
進行肺癌	肺癌	１型糖尿病性胃腸症
肋骨起始部骨転移	肋骨転移	筋肉内血腫
外傷性変化	外傷	非外傷性低脳圧症
中等度精神遅滞	中等度知的障害	二次性会陰裂傷
先天性左股関節脱臼	先天性股関節脱臼	爪下挫滅傷
リポフスチン沈着	神経セロイドリポフスチン症	ＧＶＨＤ・骨髄移植後
鮮血痰	血痰	妊娠性反復性黄疸
壊死性変化	壊死	心臓粘液腫
溶連菌感染	溶連菌感染症	頚肩腕症候群
局所発赤	発赤	少関節型若年性関節炎・手関節
不整脈チーム	不整脈	角膜異物
中等度ＣＯＰＤ	慢性閉塞性肺疾患	蜂巣炎
胸部圧痛	圧痛	皮膚原発性未分化大細胞リンパ腫
両上肢痛	上肢痛	切歯破折
気分不快症状	悪心	脳表ヘモジデリン沈着症
右上腕骨近位端粉砕骨折	上腕骨近位端粉砕骨折	側胸部悪性黒色腫
乳突蜂巣	乳様突起炎	外傷性血気胸・胸腔に達する開放創合併あり
褥創形成	褥瘡	脈絡膜転移癌
ガマ腫	がま腫	上顎セメント質腫
膀胱腫瘍再発	膀胱腫瘍	新生児結膜炎
夜間せん妄状態	せん妄	神経栄養性角結膜炎
神経系腫瘍	腫瘍	１秒率低下
クッシング徴候	クッシング症候群	硝子体異物残留
先天性側弯	肋骨異常を伴う先天性側弯症	前立腺萎縮
非定型抗酸菌肺炎	肺炎	若年性パーキンソン症候群
軽度甲状腺腫大	甲状腺腫	鼻部外傷性腫脹
手足痺れ	四肢しびれ	陰のうそう痒症
節外性濾胞辺縁帯リンパ腫	脾辺縁帯リンパ腫	顎顔面開放骨折
左下葉肺癌	下葉肺癌	虚血性心疾患
Ｋｌｅｂｓｉｅｌｌａ　ｐｎｅｕｍｏｎｉａｅ敗血症	新生児クレブシエラ敗血症	サイトメガロウイルス性肝炎
若年性認知症	認知症	新生児脳出血
外腸骨域リンパ節腫大	リンパ節腫大	１型糖尿病性腎症第５期
貧血高度	貧血	眼球裂傷
腰部腫瘍	腰椎部腫瘍	肋骨外傷
鼠径ヘルニア	鼡径ヘルニア	小手症
分化型管状腺癌	癌	転移性胸壁腫瘍
侵襲性肺アスペルギウス症	侵襲性肺アスペルギルス症	先天性白内障
孤発性ＣＪＤ	孤発性クロイツフェルト・ヤコブ病	サルモネラ敗血症
右下葉結節影	胸部異常陰影	陰のう炎
軽度左軸偏位	心電図左軸偏位	動脈潰瘍
左頚部結核性リンパ節炎	結核性リンパ節炎	インフルエンザ菌肺炎
食道がん	食道癌	植込型カテーテルポート閉塞
肛門部発赤	発赤	上腕動脈瘤
脳室拡大進行	脳室拡大	遺伝性歯の形成異常
下腿潰瘍	下腿皮膚潰瘍	サットン母斑
小脳転移	転移性脳腫瘍	連鎖球菌食中毒
腎盂軽度拡張	腎盂拡張	黄斑ジストロフィー
腫瘍指摘	腫瘍	Ｂ型急性肝炎
心臓原発性悪性リンパ腫	心臓悪性リンパ腫	小指腱性マレット指
準夜帯嘔気	嘔気	急性細菌性心膜炎
成人Ｓｔｉｌｌ病	成人スチル病	副腎皮質機能亢進症
脳血管疾患	脳血管障害	腱付着部炎
左膝窩部痛	膝窩部痛	産褥敗血症
非浸潤性尿路上皮癌	尿管尿路上皮癌	盲腸潰瘍
下咽頭がん	下咽頭癌	ヘルペスウイルス性外耳炎
両上肢痺れ	上肢しびれ	咬合平面の異常
混合性肝癌	肝癌	ヒスタミン様症候群
甲状腺痛	甲状腺炎	腰椎部挫傷
少量血便	血便	ウェルニッケ失語症
脳梗塞有	脳梗塞	示指ＭＰ関節挫傷
痕発赤	発赤	少関節型若年性関節炎・手関節
不消化便	消化不良性下痢	術後消化管出血性ショック
末梢性めまい	めまい症	１型糖尿病性眼筋麻痺
左上腕骨肉腫	上腕骨骨肉腫	グラム陽性菌敗血症
四肢型運動失調	運動失調	外傷性嗅神経損傷
産生胃癌	胃癌	静脈洞欠損症
下肢冷感軽度	下肢冷感	非医学的人工妊娠中絶
左室内同期不全	左室不全	両側性反回神経麻痺
左脛腓骨骨折	腓骨骨折	半球間硬膜下血腫・頭蓋内に達する開放創合併あり
漿液性腺腫	卵巣漿液性腺腫	小児もやもや病
日本海裂頭条虫	日本海裂頭条虫症	橈骨骨肉腫
先天性脳血管異常	脳動静脈奇形	汗管腫
臀部皮疹	発疹	歯槽骨萎縮
歩行時軽度跛行	跛行	胃十二指腸クローン病
心室中隔扁平化	心室中隔欠損症	擦過皮下血腫
フルニエ壊疽	外陰部壊死性筋膜炎	職業喘息
肝芽腫再発	肝芽腫	側胸部膿瘍
状血管腫	血管腫	前腕有棘細胞癌
卵巣癌破裂	卵巣癌	膝関節伸展拘縮
右下腿疼痛	下腿痛	白内障術後結膜炎
軽度眼球突出	眼球突出症	不完全型心内膜床欠損症
前頭葉障害	前頭葉症候群	筋電図異常
歯牙損傷	切歯破折	胎児水腫のための母体管理
両側乳糜胸水	胸水貯留	新生児帽状腱膜下出血
肺門部リンパ節腫大	肺門リンパ節腫脹	播種性スポロトリコーシス
麻疹罹患歴	麻疹	趾間挫傷
尿漏れ	尿失禁症	急性胃炎
心膜播種	腹膜播種	肋軟骨離断
髄液播種	腹膜播種	本態性自律神経症
左腎動脈狭窄症	腎動脈狭窄症	フェナセチン中毒
体動時創部痛	術創部痛	大腿単独欠損
後頭部皮下血腫	頭部皮下血腫	角膜着色
ＭＲＳＡ菌血症	ＭＲＳＡ感染症	趾基節骨悪性腫瘍
篩骨蜂巣	篩骨洞炎	胆のう腺腫
左退形成性星細胞腫	退形成性星細胞腫	甲状軟骨の悪性腫瘍
仮性動脈瘤切除	偽性動脈瘤	ヌーナン症候群
鼻中隔血腫	血腫	歯質くさび状欠損
左嗅裂ポリープ	ポリープ	大腿頚部骨折後遺症
労作時疲労	疲労感	孤発性クロイツフェルト・ヤコブ病
不定愁訴多	不定愁訴症	牛乳によるアナフィラキシーショック
軽度失調性構音障害	構音障害	腰部筋肉内異物残留
びらんからの出血	出血	遺伝性難聴
動揺性精神神経症状	神経症	瞼板腺分泌過多
過呼吸気味	過換気症	一側性外傷後膝関節症
真菌性感染性心内膜炎	細菌性心内膜炎	続発性血小板減少症
気道狭窄音	気道狭窄	口腔内装置不適合
未分類関節炎	関節炎	下肢奇形
左視床出血	視床出血	無鉤条虫症
骨突出部発赤	発赤	口蹄疫
神経症性うつ病	抑うつ神経症	仙骨部脊椎破裂
右浸潤影	胸部異常陰影	偽視神経炎
四肢近位筋筋力低下	筋力低下	卵巣腫瘍
左耳後部腫瘤	耳後部腫瘤	肛門管上皮内癌
右乳腺良性腫瘍	乳腺腫瘍	環指母斑細胞母斑
左尿管結石性腎盂腎炎	結石性腎盂腎炎	パラタルバー脱離
イレウス気味	偽性イレウス	薬疹
筋力低下可能性	筋力低下	頚部横紋筋肉腫
咽喉頭違和感	咽喉頭異常感症	足部悪性軟部腫瘍
前立腺癌死	前立腺癌	顆粒状角膜ジストロフィー
再度皮疹	発疹	頭部損傷・頭蓋内に達する開放創合併なし
左肩腱板損傷	肩腱板損傷	仙骨部悪性黒色腫
低形成	骨髄低形成	術後イレウス
再脱臼	脱臼	外傷性外転神経損傷
左肺動脈狭窄症	肺動脈狭窄症	自傷
肺動脈弁上狭窄	肺動脈弁上狭窄症	骨盤部悪性軟部腫瘍
後頸部発赤	発赤	少関節型若年性関節炎・手関節
血管原性浮腫	浮腫	後天性下腿欠損
偽粘液腫	粘液腫	ＫＩＴ（ＣＤ１１７）陽性胃消化管間質腫瘍
毛包向性菌状息肉症	菌状息肉症	慢性リウマチ性心膜炎
Ｂｌｕｅ　ｔｏｅ　ｓｙｎｄｒｏｍｅ	末梢動脈疾患	ペルオキシソーム病
嚢胞様腫瘤像	腫瘤	頭皮剥離
右足不随意運動	不随意運動症	胸膜癒着
婦人科癌	癌	足関節拘縮
両側眼振	眼振	甲状腺癌
爪水虫	爪白癬	膝関節部ガングリオン
子宮体癌Ｉａ期	子宮体癌	会陰切開創離開
過活動型せん妄	せん妄	転移性腹壁腫瘍
左下肢鬱滞性皮膚炎	うっ滞性皮膚炎	ミトコンドリア糖尿病・腎合併症あり
ＢＰＳＤ	認知症に重なったせん妄	血小板無力症
進行性核上麻痺	進行性核上性麻痺	腰椎棘間靱帯損傷
汎発性水痘感染症	水痘	直腸神経内分泌細胞癌
えん下障害	嚥下障害	外耳道膿瘍
左上腕悪性黒色腫	上腕部悪性黒色腫	歯冠補綴物過高
左側頭葉挫傷	脳挫傷	腓骨軟骨肉腫
虚血性肝炎	肝炎	眼瞼メルケル細胞癌
重症敗血症	敗血症	胃腸管損傷
幽門前部狭窄	幽門狭窄症	外傷性外陰血腫
圧迫移植部ネクローシス	壊死	足底基底細胞癌
子宮頸癌子宮頚癌	子宮頚癌	原始神経外胚葉腫瘍
舌乾燥	口腔乾燥症	腎血管性高血圧症
足痛い	足痛	角膜上皮剥離
円形紅斑	紅斑症	強皮症性ミオパチー
左眼後発性白内障	白内障	大腸静脈瘤
徐脈気味	徐脈	大腿骨顆上骨折後偽関節
境界性パーソナリティ障害	境界型パーソナリティ障害	妊娠中気管支炎
鼻骨折	鼻骨骨折	趾基節骨内軟骨腫
膵尾部腫瘤性病変	膵腫瘤	腹部てんかん
重症腸炎	腸炎	新生児筋性斜頚
左大腿骨転子下骨折	転子下骨折	化膿性扁桃周囲炎
左低形成腎	低形成腎	視床症候群
肺野すりガラス状陰影	肺野異常陰影	関節強直
アテローム性血栓性脳梗塞	血栓性脳梗塞	めまい発作
結腸癌肝転移	転移性肝癌	尿道膿瘍
診察時皮疹	発疹	対人関係障害
切開関連性心房粗動	心房粗動	虚血性全腸炎
硬性白斑	白斑	アンジェルマン症候群
術後不整脈	不整脈	耳介低位
広範囲脊柱管狭窄症	広範脊柱管狭窄症	肛門部周囲炎
中～低分化肝細胞癌	肝細胞癌	きのこ作業者肺
起床時咳嗽	咳	母指有棘細胞癌
腰骨骨折	腰椎骨折	パラチフス熱関節炎
血性腹水貯留	腹水症	ヘラー症候群
心理的不安	不安障害	ラテックスアレルギー
カンジダ肺炎	肺カンジダ症	大腿部蜂巣炎
右小細胞癌	小細胞肺癌	縦隔膿瘍
頬部悪性腫瘍	頬部腫瘍	家族性片麻痺性片頭痛
多源性ＰＶＣ散発	心室期外収縮	大腸憩室出血
原発性甲状腺機能低下	甲状腺機能低下症	レプトスピラ症
ヨードアレルギー	ヨード過敏症	縦隔結核
右ＩＣ動脈瘤	内頚動脈脳動脈瘤	母趾ガングリオン
顔面形成	顔面形成異常	複雑酩酊
活動性肝炎	肝炎	低在横定位
インフルエンザ陽性	インフルエンザ	反射欠如
眼球結膜浮腫	結膜浮腫	肘挫滅傷
排便なし	便秘症	直腸粘膜下腫瘍
全身性Ｃａｎｄｉｄａ感染症	カンジダ症	直腸神経内分泌細胞癌
顔面神経痛	三叉神経痛	ルリッシュ症候群
多発肺膿瘍	肺膿瘍	外傷性腎梗塞
疣贅様構造物	疣贅	多形紅斑
アルコ−ル性肝硬変	肝硬変症	境界母斑
皮質層状壊死	壊死	前置血管からの胎児失血
発熱随伴症状	発熱	発疹チフス
急性肺動脈血栓塞栓症	肺動脈血栓塞栓症	外陰上皮異形成・異型度１
両下肢深部静脈血栓症	下肢静脈血栓症	産褥子宮退縮不全
右上腕骨近位端骨折	上腕骨近位端骨折	触覚鈍麻
脳炎脳症	脳症	２型糖尿病性アシドーシス
辺縁性脳炎	脳炎	手関節症
易疲労性強い	易疲労感	急性全部性化膿性歯髄炎
せん妄生	せん妄	頚椎胸椎捻挫
右第３趾爪囲炎	爪囲炎	股関節亜脱臼二次性変股症
多発縦隔リンパ節転移	縦隔リンパ節転移	新生児直腸出血
家族性ＣＪＤ	家族性クロイツフェルト・ヤコブ病	サルモネラ敗血症
圧迫時疼痛	疼痛	悪性腫瘍に伴う貧血
症型Ａ群溶連菌感染症	溶連菌感染症	局在性網脈絡膜炎
末梢肺動脈塞栓症	動脈塞栓症	外陰上皮異形成・異型度１
歩容困難	歩行障害	先天性爪異常
脳室出血	出血	若年性特発性関節炎・膝関節
顔面痺れ	しびれ感	家族性パーキンソン病Ｙａｈｒ３
尿失禁状態	尿失禁症	内側半月のう腫
重度失調性構音障害	構音障害	小指骨性マレット指
卵巣癌Ⅲｃ期	卵巣癌	気管切開部出血
低血糖鞘状	低血糖	芽球増加を伴う不応性貧血−１
発赤潰瘍	発赤	第１手根中手関節脱臼骨折・手根骨
左下肺浸潤影	肺部異常陰影	偽視神経炎
右大脳動脈未破裂動脈瘤	脳動脈瘤	顎骨インプラント不適合
失語正常	失語症	気管支瘻
先週頭痛	頭痛	炭坑夫塵肺症
ｃｅｌｌ　ｌｅｕｋｅｍｉａ	白血病	十二指腸静脈瘤
失語持続	失語症	ＣＡＤ／ＣＡＭ冠粗造
ＧＣＡ	巨細胞動脈炎	アテローム血栓性脳梗塞・慢性期
大動脈弁硬化症	大動脈弁狭窄症	インフルエンザＢ型
多発筋炎	多発性筋炎	骨幹病的組織結合
呼吸促迫症状	呼吸促迫	趾基節骨開放骨折
大腿骨骨頭壊死	大腿骨頭壊死	紫斑型薬疹
呼気喘鳴	喘鳴	多のう胞性卵巣症候群
サイトメガロ網膜炎	サイトメガロウイルス網膜炎	急性耳痛
ＡＣＴＨ非依存性Ｃｕｓｈｉｎｇ症候群	クッシング症候群	ペルオキシソーム病
次週左気胸	気胸	下腿隆起性皮膚線維肉腫
内分泌機能不全	内分泌機能異常	反応性てんかん
熱	発熱	発疹チフス
Ｍａｌｌｏｒｙ−Ｗｅｉｓｓ症候群	マロリ・ワイス症候群	ペルオキシソーム病
軽度音声障害	音声障害	膝部胞巣状軟部肉腫
緑膿菌腸炎	緑膿菌性腸炎	延髄空洞症
ドレーン出血	出血	脊髄挫傷
副鼻腔転移	副鼻腔癌	ウェルニッケ・ポサダ病
原発不明癌頸部転移	原発不明癌	変形性胸鎖関節症
発熱中	発熱	発疹チフス
再発腫瘤	腫瘤	前腕皮膚良性腫瘍
右錐体路障害	錐体路障害	不適合輸血反応
犬吠様咳嗽	咳	胎盤機能不全症
両下肢筋痛	下肢筋肉痛	背部軟部腫瘍
左室ブロック波形	心電図異常	毛包上皮腫
有痛性腫瘤	腫瘤	前腕皮膚良性腫瘍
難治性冠攣縮性狭心症	冠攣縮性狭心症	みずかき指
起床時頭痛	頭痛	悪性ガストリノーマ
Ⅱ型房室ブロック	房室ブロック	薬剤性間質性肺炎
眼白内障	白内障	腸管破裂・腹腔に達する開放創合併あり
慢性下気道感染	急性気管支炎	細菌感染症
乳頭様腎盂腫瘍	腎盂乳頭状癌	足背部ガングリオン
喀痰付着	喀痰	淋菌性結膜炎
両側下腿潰瘍	下腿皮膚潰瘍	サットン母斑
心肺停止後蘇生	心肺停止	多胞性エキノコックス症
ＳＣＤ	脊髄小脳変性症	血小板無力症
無症候性腸アメーバ症	腸アメーバ症	脳毛細血管拡張症
手首痛	手部痛	角膜上皮剥離
頸部食道癌	頚部食道癌	特発性腎出血
症候性てんかん発症	症候性てんかん	歯髄出血
左腎血管腫	腎血管腫	女子慢性びまん性脱毛症
地誌的失認	失認	ＤＩＰ関節捻挫
命令性幻聴	幻聴	小児アトピー性湿疹
子宮体癌Ⅱ期	子宮体癌	会陰切開創離開
両側副腎腫瘍	副腎腫瘍	精巣上体のう腫
左顔面神経麻痺症状	顔面神経麻痺	円板状角膜炎
左顔面痛覚障害	片側痛覚鈍麻	ストレイン
顎部痛	顎痛	脳リピドーシスの認知症
元々疼痛	疼痛	閉経期障害
粘膿性鼻汁	鼻汁	慢性膵炎
膣原発横紋筋肉腫	横紋筋肉腫	大腿血管肉腫
卵巣嚢腫ＯＰ	卵巣のう腫	散在性網膜炎
遅発性ペースメーカー感染症	ペースメーカ植え込み後感染症	無菌性骨壊死
子宮筋肉腫	子宮肉腫	核黄疸ＩＩ期
肺血管陰影増強	肺血管疾患	腹部膿瘍
頭頸部放線菌症	放線菌症	小腸大腸クローン病
腎機能障害	腎機能低下	中枢性嘔吐症
Ｈｏｄｇｋｉｎ　Ｌｙｍｐｈｏｍａ	ホジキンリンパ腫	シャガス病脊髄炎
冠動脈−肺動脈瘻	肺動脈瘻	聴神経腫瘍
嚥下時疼痛	嚥下痛	フライ症候群
術後創感染	術後膿瘍	胸腺増殖遺残
大腸ポリープ後	大腸ポリープ	先天性魚鱗癬
右下葉扁平上皮癌	下葉肺扁平上皮癌	下背部ストレイン
咳嗽法	咳	母指有棘細胞癌
高リスク前立腺癌	前立腺癌	大網腫瘍
門脈圧亢進	門脈圧亢進症	血液ガス値異常
認知面低下	軽度認知障害	胸椎椎間板ヘルニアによる脊髄症
ノカルジア	ノカルジア症	緑膿菌性腸炎
右人工膝関節感染	人工膝関節感染	足関節両側靱帯損傷
膿梗塞	脳梗塞	局所性痙攣
下大静脈狭窄	大静脈狭窄症	病巣性口腔ムチン症
十二指腸穿通性潰瘍	穿通性十二指腸潰瘍	硬口蓋骨異常
左横隔膜弛緩症	横隔膜弛緩症	精神衰弱
火傷	熱傷	Ｄ群連鎖球菌敗血症
入眠困難感	不眠症	先天性大動脈弁閉鎖不全症
非定型カルチノイド腫瘍	カルチノイド	足部良性軟部腫瘍
軽度食欲低下	食欲不振	過強陣痛
尿管結石有	尿管結石症	骨盤切断術後
両下腿壊疽性膿皮症様潰瘍	膿皮症	中毒
冠攣縮型狭心症	冠攣縮性狭心症	みずかき指
恥骨骨髄炎	骨髄炎	足関節内骨折
かすみ目	視力低下	下肢形成不全
眩暈消失	めまい	出血性十二指腸潰瘍
手指関節腫脹	関節炎	重度栄養失調
ＳＰＮ	充実性偽乳頭状腫瘍	動脈還流異常
夜間嘔気	嘔気	急性細菌性心膜炎
左足背発赤	下腿発赤	少関節型若年性関節炎・手関節
女性器クラミジア感染症	クラミジア感染症	手指伸筋腱断裂
血液凝固障害	血液凝固異常	頬骨変形治癒骨折
慢性的な呼吸困難	呼吸困難	先天性赤血球形成異常性貧血
右肺下葉肺炎	肺炎	ＨＥＬＬＰ症候群
低酸素虚血性脳症	低酸素性脳症	耳の気圧性外傷
左大葉性肺炎	大葉性肺炎	馬尾神経腫瘍
膵臓癌術後再発	膵癌	外傷性動脈血腫
足底湿疹	足湿疹	膝部有棘細胞癌
歩行ふらつき	めまい	胃十二指腸クローン病
結腸縫合不全	縫合不全	足痛
多発肝血管腫	多発性肝血管腫	分娩時新生児脳出血
紅色腫瘤	腫瘤	植込型除細動器不全
気管支閉鎖症	気管支閉鎖	狭隅角
神経アミロイドーシス	アミロイドーシス	小脳動脈血栓症
夜疼痛	疼痛	閉経期障害
咽頭粘膜発赤	発赤	上腕動脈瘤
時々不整脈	不整脈	角膜異物
多発性リンパ節転移	多部位リンパ節転移	嗅覚障害
新生児死亡	原因不明の死亡	カンジダ性肉芽腫
最近花粉症	花粉症	下腹神経叢損傷
食道空腸吻合部狭窄	吻合部狭窄	しらみ媒介性回帰熱
クリオグロブリン性血管炎	クリオグロブリン血症性血管炎	巣状腎硬化症
右頬部擦過傷	頬部擦過創	先天性喘鳴
右肺下葉癌	下葉肺癌	虚血性心疾患
腎結石多発	腎結石症	部分癒着胎盤・出血を伴わない
ＥＢウイルス初感染	ＥＢウイルス感染症	心因性腹痛
外表奇形	奇形	反復性股関節脱臼
急性膵臓炎	急性膵炎	壊死性膵炎
Ｉｓｐポリープ	大腸ポリープ	趾挫傷
咽頭部発赤	発赤	上腕動脈瘤
頭部腫瘍	頭部皮下腫瘍	頚部椎間板変性症
遅発性発疹	発疹	陰のう腫瘍
肺炎悪化	肺炎	子宮頚部環状剥離
朝痰	喀痰	神経線維腫症１型
子宮体癌Ⅳ期	子宮体癌	会陰切開創離開
骨外腫瘤形成	腫瘤	四肢痙攣
低悪性度Ｂ細胞性リンパ腫	びまん性大細胞型Ｂ細胞性リンパ腫	鎖骨部打撲傷
視神経脊髄炎（ＮＭＯ）	視神経脊髄炎	偽性ミオトニア
左下副甲状腺腺腫	副甲状腺腺腫	ぶどう球菌性股関節炎
単形性ＶＴ	非持続性心室頻拍	顔面肩甲上腕型筋ジストロフィー
特発性心室細動	心室細動	母指ＭＰ関節橈側側副靱帯損傷
高脂血症高脂血症	高脂血症	口底腫瘍
白色調腫瘍	腫瘍	無水晶体性緑内障
左頬部有棘細胞癌	頬部有棘細胞癌	顎関節部擦過創
Ｇｏｔｔｒｏｎ徴候	ゴットロン丘疹	ペルオキシソーム病
脊柱起立筋膿瘍	筋膿瘍	原発性月経困難症
左踵骨骨折	踵骨骨折	迷路骨包耳硬化症
胃癌幽門狭窄	幽門狭窄症	胃癌
拡張能障害	心不全	プロテインＳ欠乏症
小腸静脈瘤破裂	食道静脈瘤破裂	扁平足
右上肢振戦	一側上肢振戦	肘上部外傷性切断
中枢性甲状腺機能低下症	甲状腺機能低下症	レプトスピラ症
左肺動脈閉塞	肺動脈狭窄症	アスペルギルス腫
単純性網膜症	網膜症	手関節捻挫
両眼性複視	複視	急性細気管支炎
Ｈｅｎｏｃｈ−Ｓｃｈｏｎｌｅｉｎ紫斑病	ＩｇＡ血管炎	ペルオキシソーム病
右胸腔内腫瘍	腫瘍	パリノー結膜炎
尿もれ	尿失禁症	化膿性膵炎
下肢筋力低下自覚	筋力低下	災害神経症
右足静脈瘤	静脈瘤	光接触皮膚炎
上気道浮腫	咽頭浮腫	高血糖性糖尿
複雑型熱性痙攣	熱性痙攣	肩皮膚良性腫瘍
吻合部浮腫	浮腫	器質性の妄想状態および幻覚妄想状態
右膀胱側壁部膀胱癌	膀胱側壁部膀胱癌	唾液瘻
Ｃａｐｎｏｃｙｔｏｐｈａｇａ　ｃａｎｉｍｏｒｓｕｓ感染症	グラム陰性菌感染症	金属歯冠修復不適合
子宮頸部頸管狭窄	子宮頚管狭窄症	巨口症
呼吸喘鳴	喘鳴	多のう胞性卵巣症候群
口腔内乾燥	口腔乾燥症	喘鳴
脊椎管狭窄症	脊柱管狭窄症	鉄沈着性白内障
ヘルペス髄膜炎	髄膜炎	松果体腫瘍
左股関節破壊	股関節症	外傷性脳症・頭蓋内に達する開放創合併なし
左前庭障害	前庭障害	大腿骨骨肉腫
膠原繊維性腸炎	腸炎	副眼瞼
食道期軽度障害	嚥下障害	カンピロバクター腸炎
右外腸骨静脈狭窄	静脈狭窄	鼻腔異物挿入後遺症
妊娠発覚	妊娠	頭部有棘細胞癌
両膝関節症	膝関節症	半身知覚障害
類もやもや病	もやもや病	背部ボーエン病
呼内疾患ベース肺炎	肺炎	悪阻
左足関節開放性脱臼骨折	足関節開放性脱臼骨折	反復性膝蓋骨脱臼
白色粘性痰	喀痰	多発開放骨折
食道癌２病変	食道癌	副甲状腺過形成
右卵巣奇形腫	卵巣奇形腫	頚椎椎間板症性脊髄症
感冒罹患	感冒	結膜のう胞
血腫像	血腫	溶血緑内障
ｌｙｍｐｈｏｍａ	悪性リンパ腫	下顎角部開放骨折
左足首骨折	足関節骨折	口唇の先天奇形
慢性血栓性肺高血圧症	慢性血栓塞栓性肺高血圧症	中毒性脊髄症
眼振誘発	眼振	示指マレット指
急性ウイルス性脳炎	ウイルス性脳炎	開散不全
掻痒等	そう痒	乾癬性関節炎・足関節
労作時呼吸困難感軽度	労作時呼吸困難	汗孔角化症
逆流性食道炎症状	逆流性食道炎	頭蓋骨異常
非代償性Ｃ型肝硬変	Ｃ型非代償性肝硬変	喉頭蓋癌
子宮筋腫大	子宮筋腫	手指神経断裂
ヘルペス感染症	ヘルペスウイルス感染症	眼筋内異物
抑うつあり	うつ状態	仙骨部脊椎破裂
出血腫脹	出血	急性角結膜炎
急性感音性難聴	感音難聴	サイトメガロウイルス肺炎
肺塞栓既往	肺塞栓症	乳腺腫大
リンパ節多発転移	多部位リンパ節転移	先天性膝関節脱臼
ｉｎｖａｓｉｖｅ　ｔｈｙｍｏｍａ	悪性胸腺腫	血中の向精神薬の検出
イレウスリスク高い	イレウス	先天歯
左肺下葉扁平上皮癌	下葉肺扁平上皮癌	脊髄硬膜内髄外神経鞘腫
分類不能型免疫不全	免疫不全	転移性副鼻腔癌
高度拘束性換気障害	拘束性換気障害	卵巣線維腫
非典型的胸痛	胸痛	単純ヘルペス
ＭＲＳＡ感染	ＭＲＳＡ感染症	直腸神経内分泌細胞癌
肝多発腫瘤	肝腫瘤	副腎皮質ホルモン剤副作用
左大腿骨病的骨折	大腿骨病的骨折	性腺機能低下症
Ｓ状結腸癌術後肝転移	転移性肝癌	尿道膿瘍
棘波	心電図異常	Ｉ型溶血性非球状赤血球性貧血
黄色痰自己喀出	膿性痰	淋菌性結膜炎
心膜腔内播種	転移性心腫瘍	下顎頭骨折
耳痛	耳痛症	肩部第３度熱傷
四肢末端しびれ	しびれ感	前腕骨折
内頸動脈狭窄	内頚動脈狭窄症	胸部昆虫螫
胃部分壊死	壊死	先天性腎異常
転倒受傷	外傷	胸郭出口症候群
左急性感音難聴	感音難聴	盲腸カルチノイド
タール便少量	黒色便	側頭葉悪性腫瘍
切除不能胃癌	胃癌	黒皮症
後頭葉脳出血	脳出血	ＢＬＮＡＲ感染症
隅角結節	虹彩結節	シェーグレン症候群ミオパチー
落ち着かなさ	多動性障害	開放性胃腸管損傷
脊椎多発圧迫骨折	圧迫骨折	足部ボーエン病
左傍脊柱筋膿瘍	筋膿瘍	原発性月経困難症
Ⅰ型ＤＭ	糖尿病	サルモネラ敗血症
多発ＬＮ転移	多部位リンパ節転移	先天性胸骨欠損
右角膜ヘルペス	ヘルペス角膜炎	腟熱傷
大腸粘膜癌	癌	サルコスポリジウム症
大動脈損傷	上大動脈損傷	下腿関節痛
仙骨前腫瘤	腫瘤	胸腔内血腫・胸腔に達する開放創合併なし
前頭葉脳出血	脳出血	ＢＬＮＡＲ感染症
社会不安症	不安神経症	斜台髄膜腫
左頚部食道傍リンパ節転移	リンパ節転移	先天性肺線維症
時折物忘れ	健忘症	真菌性外陰腟炎
左頬部未分化腺癌	癌	小児ＥＢＶ陽性Ｔ細胞リンパ増殖性疾患
ＩＩ型ＤＭ	２型糖尿病	サルモネラ敗血症
脊椎管狭窄	脊柱管狭窄症	多臓器不全
膨満　グル音正常	腹部膨満	外傷性角膜炎
顔面神経麻痺静的再建	顔面神経麻痺	胸部腫脹
低分化性扁平上皮癌	癌	下背部ストレイン
左房内粘液腫	心臓粘液腫	若年性骨粗鬆症
重症うつ病	うつ病	肩甲帯末梢神経損傷後遺症
左肺下葉浸潤影	胸部異常陰影	偽視神経炎
中葉舌区症候群	中葉無気肺	クインケ浮腫
膵管炎	膵炎	頚部有棘細胞癌
軟部組織腫瘤	腫瘤	遅発性尺骨神経麻痺
腫瘤構造	腫瘤	鼻部皮膚良性腫瘍
慢性誤嚥	嚥下障害	Ｓ状結腸憩室穿孔
Ｇｍ敗血症	敗血症	下咽頭創傷
右大腿部蜂窩織炎	大腿部蜂巣炎	人工肘関節周囲骨折
病的腹水	腹水症	ヘラー症候群
慢性疲労	疲労感	孤発性クロイツフェルト・ヤコブ病
膿性喀痰	膿性痰	多発開放骨折
Ｃｈｏｌｅｄｏｃｈｏｃｅｌｅ	総胆管のう腫	アテローム血栓性脳梗塞・慢性期
癌再発	癌	顆粒状角膜ジストロフィー
胆汁うっ滞型	胆汁うっ滞	後天性水腎症
肺門腫瘤	縦隔腫瘍	間脳症
両膝関節疼痛	膝関節痛	慢性腸炎
右鎖骨転移	骨転移癌	筋肉内血腫
緑内症	緑内障	下肢熱傷
夕方痛み	疼痛	消化管アニサキス症
左側副部痛	側腹部痛	足底多汗症
後腹膜腫瘍上行結腸浸潤	後腹膜腫瘍	乳幼児突発性危急事態
心窩部自発痛	心窩部痛	肝移植後
リンパ節腫大傾向	リンパ節腫大	足炎
時々尿失禁	尿失禁症	内側半月のう腫
左臀部悪性軟部腫瘍	殿部悪性軟部腫瘍	凍傷
低血糖遷延	低血糖	過敏性腸症候群
右中大脳動脈閉塞症	中大脳動脈閉塞症	セザリー症候群
重症ＣＭＶ腸炎	サイトメガロウイルス腸炎	副眼瞼
発熱コントロール	発熱	発疹チフス
右下腿蜂窩織炎	下腿蜂巣炎	アレルギー性接触皮膚炎
膿瘍形成	膿瘍	心因性無月経
右尿管損傷	尿管損傷	顎関節部挫創
感染性心内膜症	感染性心内膜炎	続発性血小板減少症
ブドウ球菌検出	ぶどう球菌感染症	外耳部割創
副腎皮質機能不全	副腎皮質機能低下症	上唇癌
Ｅｓｃｈｅｒｉｃｈｉａ　ｃｏｌｉ	大腸菌感染症	十二指腸静脈瘤
両側網膜剥離	網膜剥離	グラム陰性球菌感染症
播種性血管内凝固症	播種性血管内凝固	髄膜炎罹患後精神障害
肺野肺門部異常陰影	肺門部異常陰影	インレー脱離
右房浸潤	乳房悪性腫瘍	外傷性腎被膜下血腫
屈筋腱鞘炎	腱鞘炎	外傷性脳症・頭蓋内に達する開放創合併あり
肺結節陰影	胸部異常陰影	二重歯列
呼吸困難感等自覚症状	呼吸困難	慢性複雑性膀胱炎
原発性肺腫瘍	肺腫瘍	腎疾患
右下腿コンパートメント症候群	下腿コンパートメント症候群	膵管内管状腫瘍
右鎖骨上窩リンパ節腫大	鎖骨上リンパ節腫脹	後頭葉神経膠腫
右鼡径部腫脹	鼡径部腫脹	手舟状骨骨折
低悪性度リンパ腫	ホジキンリンパ腫	二次性糖尿病・糖尿病性合併症あり
右側胸部皮下結節	皮下結節	被包型胸腺腫
両側卵巣チョコレート嚢胞	チョコレートのう胞	蝸牛型メニエール病
回盲部悪性リンパ腫	悪性リンパ腫	癌
陰部腫脹	陰のう腫大	続発性月経困難症
腹水浸出	腹水症	転移性肺腫瘍
ＴＡＡ	胸部大動脈瘤	サルモネラ敗血症
腸管皮膚瘻	腸瘻	皮膚良性腫瘍
ライン感染	カテーテル感染症	モークレアー病
多発擦過傷	擦過創	代謝性アシドーシス
脂質異常	脂質異常症	一次性頭痛
肺嚢胞感染	肺のう胞	ウィリス動脈輪周囲炎
Ｃｈｕｒｇ−Ｓｔｒａｕｓｓ　症候群	好酸球性多発血管炎性肉芽腫症	ペルオキシソーム病
脾結核	結核	薬剤性溶血性貧血
潰瘍性大腸炎急性増悪	潰瘍性大腸炎	大頭型白質脳症
肺抗酸菌感染症	肺非結核性抗酸菌症	肺動脈血栓塞栓症
２型大腸癌	大腸癌	足底筋肉内異物残留
両眼網膜症	網膜症	手関節捻挫
左眼結膜炎	結膜炎	前腕腫脹
右肺原発腺癌	肺腺癌	慢性心因反応
ＣＲＥＳＴ症候群	クレスト症候群	閉経後出血
感覚神経障害	知覚障害	腹部悪性腫瘍
物忘れ	健忘症	僧帽弁閉鎖不全症兼肺動脈弁閉鎖不全症
脳筋症	ミトコンドリア脳筋症	膀胱結核
駆細胞型急性リンパ性白血病再発	急性リンパ性白血病	外傷性穿孔性中耳炎
左大腿骨骨腫瘍	大腿骨腫瘍	直腸肛門周囲膿瘍
膿瘍縮小	膿瘍	児頭回旋異常
右後頭葉塞栓性脳梗塞	塞栓性脳梗塞	症候性原発性胆汁性胆管炎
肝内転移	転移性肝腫瘍	膀胱下垂
膵管内乳頭粘液腫瘍	膵管内乳頭粘液性腫瘍	Ｓ状結腸過長症
胃癌多発骨転移	胃癌骨転移	肝硬変に伴う食道静脈瘤
僧房弁疣贅	疣贅	肝ヘモクロマトーシス
左膝窩動脈瘤	膝窩動脈瘤	脳神経腫瘍
腹部背部痛	背部痛	下肢筋萎縮
アルコール性ニューロパチー	アルコール性多発ニューロパチー	上腹部痛
体幹部発赤	発赤	口蹄疫
慢性突発性血小板減少性紫斑病	血小板減少性紫斑病	手部挫傷
下部消化管穿孔	腸穿孔	流行性多発関節炎
Ｔ字杖歩行可能	歩行障害	前立腺無形成
鎖骨上リンパ節腫大	鎖骨上リンパ節腫脹	後頭葉神経膠腫
右大腿ヘルニア嵌頓	大腿ヘルニア嵌頓	先天性限局白皮症
大腫瘤影	腫瘤	視床下部機能障害
双極２型障害	２型双極性障害	ヒルシュスプルング病
感染性腹部動脈瘤	感染性腹部大動脈瘤	好酸球性多発血管炎性肉芽腫症
ヘルペス性脳炎	サル痘	急性後基部心筋梗塞
不安症様	不安神経症	直腸癌穿孔
右前額部痛	前頭部痛	多部位リンパ節転移
右胸膜播種	胸膜播種	下顎頭骨折
骨折病変	骨折	膝蓋部血腫
半月体形成糸球体腎炎	半月体形成性糸球体腎炎	交代性共同性内斜視
筋力低下著明	筋力低下	頚部横紋筋肉腫
下肢骨折	骨折	涙管損傷
付属器圧痛	圧痛	急性放射線皮膚炎
アスピリンアレルギー	アスピリン不耐症	縦隔結核
固形腫瘍	腫瘍	尿道短縮症
嘔吐出現	嘔吐症	膀胱瘤合併妊娠
統合失調症残遺状態	統合失調症	肺動脈弁狭窄兼閉鎖不全症
右上肢不全片麻痺	不全片麻痺	Ｔ細胞性大顆粒リンパ球白血病
低血糖生	低血糖	風疹様発疹
劇症型肺炎球菌性敗血症	肺炎球菌性敗血症	一次性脳幹外傷・頭蓋内に達する開放創合併なし
左大腿蜂窩織炎	蜂窩織炎	人工肘関節周囲骨折
発熱有	発熱	発疹チフス
頭位性回転性めま	体位性めまい	静脈性血管腫
不眠考	不眠症	人工弁感染
全失語	全失語症	ＣＡＤ／ＣＡＭ冠粗造
口唇紅潮	紅潮	機械的イレウス
開腹腫瘤	腫瘤	母趾ＭＰ関節側副靱帯損傷
左尺骨神経障害	尺骨神経麻痺	変視症
外側部乳癌	乳癌	第２度凍傷
脳幹部神経膠腫	脳幹神経膠腫	一過性低血圧症
両足関節以遠しびれ感	しびれ感	陰茎肥大
左再発性気胸	続発性気胸	脛骨神経損傷
胃のむかつき	悪心	子宮収縮不全
気管性喘息	気管支喘息	足挫創
痒疹結節散在	痒疹	完全麻痺
日中下痢	下痢症	殿部胞巣状軟部肉腫
骨粗鬆症有	骨粗鬆症	結腸瘻
先天性胆管欠損	胆管先天奇形	急性錯乱状態
左深部静脈血栓症	深部静脈血栓症	動脈硬化性記憶障害
冠性Ｔ波	心電図異常	上腕骨外顆開放骨折
多発胸膜肥厚斑	胸膜肥厚	先天性腎性尿崩症
カンジダ眼内炎	眼内炎	神経鞘腫
副腎転移	転移性副腎腫瘍	アキレス腱挫傷
左緊張性気胸	緊張性気胸	腸下垂
度腟壁裂傷	腟裂傷	脾捻転
仙骨部腫瘤	腫瘤	四肢痙攣
帯状疱疹再燃	帯状疱疹	項部有棘細胞癌
左前胸部腫瘤	前胸部腫瘤	大動脈弁閉鎖不全症兼僧帽弁閉鎖不全症兼三尖弁閉鎖不全症
喘息症状	咳喘息	足底疣贅
ふらつく気	よろめき歩行	仮性膵のう胞
拡張障害型心不全	心不全	血中の幻覚剤の検出
アカシジア症状	錐体路障害	緑膿菌性腸炎
間歇的腹痛	腹痛症	淋菌性肺炎
左肺舌区扁平上皮癌	肺扁平上皮癌	開放性腸管破裂
星状細胞腫	星細胞腫	２型糖尿病・神経学的合併症あり
急性腎障害	腎障害	麻疹性結膜炎
左鎖骨上リンパ節腫脹	鎖骨上リンパ節腫脹	後頭葉神経膠腫
陳旧性脳出血	脳出血	術後癒着性イレウス
良性下垂体腫瘍	下垂体腫瘍	腹部母斑細胞母斑
腸雑音聴取可	異常腸音	示指側副靱帯損傷
左側頭部帯状疱疹	帯状疱疹	交感性ぶどう膜炎
左肺原発性肺癌	原発性肺癌	慢性心因反応
頭蓋内出血性病変	非外傷性頭蓋内出血	新生児鎖骨骨折
閉塞性睡眠呼吸障害	睡眠時無呼吸症候群	母趾皮膚潰瘍
右披裂部腫瘍	腫瘍	外毛根鞘腫
両膝変形	変形性膝関節症	子宮内胎児死亡のための母体管理
表在性腫瘍	腫瘍	慢性腸アメーバ症
左母指多指症	副母趾	ポワッサンウイルス病
両側側脳室軽度拡大	脳室拡大	遺伝性歯の形成異常
脈性右室心筋症	不整脈原性右室心筋症	心因性胃液分泌過多症
アルコール性末梢神経障害	アルコール性多発ニューロパチー	内頚動脈血栓症
縦隔炎併発	縦隔炎	先天性プラスミノゲン欠損症
暗紅色斑	紅斑症	頚髄星細胞腫
骨盤圧痛	骨盤痛	陰茎第２度熱傷
骨巨細胞腫瘍	骨巨細胞腫	リスフラン関節炎
Ｌａｎｇｈａｎｓ巨細胞	ランゲルハンス細胞組織球症	可撤性歯科矯正装置破損
気管支喘息発症	気管支喘息	足挫創
分葉状嚢胞性腫瘤	腫瘤	出血傾向
胆管拡張	胆管拡張症	小葉間肺気腫
甲状腺肥大	甲状腺疾患	腸骨悪性腫瘍
患肢発赤	発赤	口蹄疫
好中球浸潤	好中球増加症	インスリン低血糖
多房性腫瘤	腫瘤	巨頭症
夜間不安	不安障害	ラテックスアレルギー
右上肢線状強皮症	線状強皮症	急性循環不全
左内耳障害	迷路障害	橈骨頚部開放骨折
左耳介発赤	発赤	少関節型若年性関節炎・手関節
朝方倦怠感	倦怠感	殿部メルケル細胞癌
後頚部脂肪腫	頚部脂肪腫	ＰＣＷＨ
副腎性クッシング症侯群	クッシング症候群	眼瞼虫刺傷
混合性アルカローシス	アルカローシス	陰茎良性腫瘍
痛く	疼痛	円蓋部髄膜腫
皮疹再燃	発疹	頭部損傷・頭蓋内に達する開放創合併なし
再発悪性リンパ腫	悪性リンパ腫	二次性糖尿病・糖尿病性合併症あり
子宮筋腫手術	子宮筋腫	先天性尿道狭窄症
時折心窩部痛	心窩部痛	肝移植後
右足根骨骨折	足根骨骨折	慢性腎不全
腕頭静脈血栓症	静脈血栓症	新生児発熱
脊椎病変	脊椎異常	脊椎分離症
歯状核	歯状核赤核淡蒼球ルイ体萎縮症	下葉肺大細胞癌
右脛骨骨幹部骨折	脛骨骨幹部骨折	食道消化管間質腫瘍
両側腎盂軽度拡張	腎盂拡張	黄斑ジストロフィー
軽度屈曲拘縮	屈曲拘縮	特発性高カルシウム尿症
左下肺野陰影	下肺野陰影	偽視神経炎
ＥＢＶ腸炎	細菌性腸炎	副眼瞼
左側舌癌	舌癌	上腕三頭筋不全断裂
足しびれ	下肢しびれ	肩甲部圧挫傷
膵内分泌腫瘍肝転移	転移性肝癌	気圧性外傷