副腎原発神経芽腫	副腎神経芽腫	副腎神経芽腫
個細胞壊死	壊死	壊死
レム睡眠行動異常症	レム睡眠行動障害	レム睡眠行動障害
脱髄性疾患	脱髄疾患	脱髄疾患
多発性脾膿瘍	脾膿瘍	脾膿瘍
無動性無言	無動性無言症	無動性無言症
軽度悪心	悪心	悪心
慢性活動性ＥＢウルス感染症	ＥＢウイルス感染症	ＥＢウイルス感染症
蛋白尿減少	蛋白尿	蛋白尿
中心性奬液性網脈絡膜症	中心性漿液性網脈絡膜症	中心性漿液性網脈絡膜症
左一側性反回神経麻痺	一側性反回神経麻痺	一側性反回神経麻痺
イレウス様	イレウス	イレウス
水痘帯状疱疹	帯状疱疹	帯状疱疹
早発黄疸	早発性黄疸	早発性黄疸
急性細菌性気管支炎	急性気管支炎	急性気管支炎
右上葉肺小細胞癌	上葉肺大細胞癌	上葉肺大細胞癌
腟癌１期	腟癌	腟癌
嚥下時痛軽度	嚥下痛	嚥下痛
左顔面血管腫	顔面血管腫	顔面血管腫
鼻汁多く	鼻汁	鼻汁
口腔内出血痕	口腔出血	口腔出血
夜両足痛	足痛	足痛
左内眼角基底細胞癌	眼角基底細胞癌	眼角基底細胞癌
難治性イレウス	イレウス	イレウス
副鼻腔腫瘍	鼻副鼻腔腫瘍	鼻副鼻腔腫瘍
左膝部痛	膝窩部痛	膝窩部痛
軽度咽頭発赤	咽頭発赤	咽頭発赤
痙攣起	痙攣	痙攣
左側頬部腫脹	頬部腫脹	頬部腫脹
四肢浮腫軽度	四肢浮腫	四肢浮腫
大腸ポリープ　ポリペク後	大腸ポリープ	大腸ポリープ
腰椎椎体椎間板炎	腰椎椎間板炎	腰椎椎間板炎
創部痛	術創部痛	術創部痛
軽度右気胸	気胸	気胸
左大腿骨骨折	大腿骨骨折	大腿骨骨折
子宮頸管ポリープ切除	子宮頚管ポリープ	子宮頚管ポリープ
左中耳炎	中耳炎	中耳炎
胃食道逆流症状	胃食道逆流症	胃食道逆流症
両側卵巣子宮内膜症性嚢胞	卵巣子宮内膜症のう胞	卵巣子宮内膜症のう胞
妊娠性糖尿病	妊娠糖尿病	妊娠糖尿病
左寛骨臼骨折	寛骨臼骨折	寛骨臼骨折
原発性両眼内悪性リンパ腫	眼窩悪性リンパ腫	眼窩悪性リンパ腫
両下肢静脈血栓	下肢静脈血栓症	下肢静脈血栓症
神経根障害	神経根炎	神経根炎
クモ膜下出血	くも膜下出血	くも膜下出血
左臀部慢性膿皮症	慢性膿皮症	慢性膿皮症
メサンギウム増殖性腎炎	メサンギウム増殖性糸球体腎炎	メサンギウム増殖性糸球体腎炎
上行結腸癌肝転移	転移性肝癌	転移性肝癌
肥満糖尿病	糖尿病	糖尿病
顎変形症術後顎変形症	顎変形症	顎変形症
２型食道癌	食道癌	食道癌
外傷性脊髄損傷	脊髄損傷	脊髄損傷
下肢結節性紅斑	結節性紅斑	結節性紅斑
左動眼神経麻痺	動眼神経麻痺	動眼神経麻痺
家族性海綿状血管腫	海綿状血管腫	海綿状血管腫
術中直腸損傷	直腸損傷	直腸損傷
夜頻尿	夜間頻尿症	夜間頻尿症
回盲部炎	回盲部憩室炎	回盲部憩室炎
左歯痛	歯痛	歯痛
腹膜播種切除	腹膜播種	腹膜播種
左頬部痛	頬部痛	頬部痛
肺クリプトコックス症	急性肺クリプトコッカス症	急性肺クリプトコッカス症
マラセチア毛嚢炎	マラセチア毛包炎	マラセチア毛包炎
腫瘍床	腫瘍	腫瘍
左膀胱尿管逆流症	膀胱尿管逆流	膀胱尿管逆流
リンパ球性白血病	リンパ性白血病	リンパ性白血病
クラミジア感染	クラミジア感染症	クラミジア感染症
夜間倦怠感	倦怠感	倦怠感
右下腿潰瘍感染	下腿皮膚潰瘍	下腿皮膚潰瘍
問題なし前立腺肥大	前立腺肥大症	前立腺肥大症
急性パルボウイルスＢ１９感染症	パルボウイルス感染症	パルボウイルス感染症
肺動脈狭窄	肺動脈狭窄症	肺動脈狭窄症
夜間不眠状態	不眠症	不眠症
熱型	発熱	発熱
夢遊病	夢遊症	夢遊症
脊髄小脳変性症６型	脊髄小脳変性症	脊髄小脳変性症
左内頚動脈閉塞	内頚動脈閉塞症	内頚動脈閉塞症
脳虚血症状	脳虚血症	脳虚血症
頚椎症神経根症	頚椎症性神経根症	頚椎症性神経根症
睡眠障害招くリスク	睡眠障害	睡眠障害
骨盤内ＬＮ転移	骨盤内リンパ節転移	骨盤内リンパ節転移
挙上空腸穿孔	腸穿孔	腸穿孔
腸管アメーバ感染症	腸アメーバ症	腸アメーバ症
放射線性皮膚炎	放射線皮膚炎	放射線皮膚炎
髄膜炎徴候	髄膜炎	髄膜炎
下葉肺炎	肺炎	肺炎
蛋白漏出胃腸症	蛋白漏出性胃腸症	蛋白漏出性胃腸症
腹水多量	腹水症	腹水症
右卵巣悪性腫瘍	卵巣悪性腫瘍	卵巣悪性腫瘍
糖尿病（２型）	２型糖尿病	２型糖尿病
化膿性胸鎖関節炎	化膿性関節炎・胸鎖関節	化膿性関節炎・胸鎖関節
児嘔気	嘔気	嘔気
尿閉歴	尿閉	尿閉
陰嚢びらん	陰のうびらん	陰のうびらん
精神的ショック	ショック	ショック
右上腕骨外側上顆炎	外側上顆炎	外側上顆炎
軽度腹水	腹水症	腹水症
右無機能腎	無機能腎	無機能腎
月経痛コントロール不十分	月経痛	月経痛
左鎖骨下動脈閉塞	鎖骨下動脈閉塞症	鎖骨下動脈閉塞症
逆行性健忘	逆向性健忘	逆向性健忘
認知症様症状	認知症	認知症
顎骨骨折	下顎骨骨折	下顎骨骨折
右顔面骨骨折	顔面骨骨折	顔面骨骨折
炎症性粉瘤	粉瘤	粉瘤
脂質異常症（＋）	脂質異常症	脂質異常症
上腹部圧痛	腹部圧痛	腹部圧痛
両側椎骨動脈瘤	椎骨動脈瘤	椎骨動脈瘤
誤嚥性肺炎併発	誤嚥性肺炎	誤嚥性肺炎
右末梢前庭障害	末梢前庭障害	末梢前庭障害
閉塞性動脈硬化症　症状	閉塞性動脈硬化症	閉塞性動脈硬化症
洞不全	洞不全症候群	洞不全症候群
特発性リンパ浮腫	リンパ浮腫	リンパ浮腫
無気力	無力症	無力症
ナッツアレルギー	ピーナッツアレルギー	ピーナッツアレルギー
甲状腺乳頭癌術後再発	甲状腺乳頭癌	甲状腺乳頭癌
肝臓機能障害用	肝機能障害	肝機能障害
下痢治	下痢症	下痢症
朝方疼痛	疼痛	疼痛
右気管支狭窄	気管支狭窄症	気管支狭窄症
非ヘルペス性辺縁系脳炎	辺縁系脳炎	辺縁系脳炎
好酸球増多	好酸球増加症	好酸球増加症
両下腿皮膚潰瘍	下腿皮膚潰瘍	下腿皮膚潰瘍
ｓ型ポリープ	ポリープ	ポリープ
時折頭痛	頭痛	頭痛
関節リウマチ発症	関節リウマチ	関節リウマチ
両顎下腺腫大	顎下腺肥大	顎下腺肥大
今朝頭痛	頭痛	頭痛
眼球偏移	眼球偏位	眼球偏位
腹腔内癒着高度	腹膜癒着	腹膜癒着
肥満	肥満症	肥満症
網膜中心動脈閉塞	網膜中心動脈閉塞症	網膜中心動脈閉塞症
旅行者下痢症	下痢症	下痢症
右声帯ポリープ	声帯ポリープ	声帯ポリープ
頭部皮下結節	皮下結節	皮下結節
下肢潰瘍	下肢皮膚潰瘍	下肢皮膚潰瘍
難治性胸腹水	難治性腹水	難治性腹水
幻覚症状	幻覚	幻覚
異常腫瘤	腫瘤	腫瘤
未破裂脳動脈瘤コイル塞栓	未破裂脳動脈瘤	未破裂脳動脈瘤
左下顎骨慢性骨髄炎	慢性顎骨骨髄炎	慢性顎骨骨髄炎
左側頭葉膠芽腫	側頭葉膠芽腫	側頭葉膠芽腫
脳血管障害性パーキンソニズム	脳血管障害性パーキンソン症候群	脳血管障害性パーキンソン症候群
右後角脳室内出血	脳室内出血	脳室内出血
再発脊索腫	脊索腫	脊索腫
Ｃ型肝硬変症	Ｃ型肝硬変	Ｃ型肝硬変
左踵部悪性黒色腫	踵部悪性黒色腫	踵部悪性黒色腫
帯状疱疹無	帯状疱疹	帯状疱疹
右下腿痛	下腿痛	下腿痛
気管支喘息症状	気管支喘息	気管支喘息
大腿骨内顆骨壊死	特発性大腿骨内顆骨壊死	特発性大腿骨内顆骨壊死
女性化乳房	女性化乳房症	女性化乳房症
大動脈弁膜症	大動脈弁弁膜症	大動脈弁弁膜症
右下腿麻痺	下肢麻痺	下肢麻痺
切除不能多発性肝転移	転移性肝腫瘍	転移性肝腫瘍
発作性上室性頻拍	発作性上室頻拍	発作性上室頻拍
筋肉痛生	筋肉痛	筋肉痛
腰椎滑り症	腰椎すべり症	腰椎すべり症
淡血性胸水	血性胸水	血性胸水
腎被膜下出血	外傷性腎被膜下血腫	外傷性腎被膜下血腫
仙骨部褥瘡痕	仙骨部褥瘡	仙骨部褥瘡
左肝腫瘍	肝腫瘍	肝腫瘍
非Ｃｌｏｓｔｒｉｄｉｕｍ性ガス壊疽	ガス壊疽	ガス壊疽
心室二段脈	心室性二段脈	心室性二段脈
鼻腔腫瘍摘出	鼻腔腫瘍	鼻腔腫瘍
左胸壁腫瘍切除	胸壁腫瘍	胸壁腫瘍
右尿管癌	尿管癌	尿管癌
両側浸出性中耳炎	滲出性中耳炎	滲出性中耳炎
高血糖	高血糖症	高血糖症
胸痛無	胸痛	胸痛
好酸球増多症	好酸球増加症	好酸球増加症
右腎明細胞肉腫	腎明細胞肉腫	腎明細胞肉腫
甲状腺左葉濾胞腺腫	濾胞性甲状腺腺腫	濾胞性甲状腺腺腫
下位運動ニューロン徴候	運動ニューロン疾患	運動ニューロン疾患
左眼鼻涙管閉塞症	鼻涙管閉鎖症	鼻涙管閉鎖症
子宮がん	子宮癌	子宮癌
Ｂｉｃｋｅｒｓｔａｆｆ型脳幹脳炎	ビッカースタッフ脳幹脳炎	ビッカースタッフ脳幹脳炎
右中皮腫	中皮腫	中皮腫
ジベル薔薇色粃糠疹	ジベルばら色粃糠疹	ジベルばら色粃糠疹
口内出血	口腔出血	口腔出血
右上方視野欠損	視野欠損	視野欠損
両側臼蓋形成不全症	臼蓋形成不全	臼蓋形成不全
進行肝癌	肝癌	肝癌
前股関節症	股関節症	股関節症
多発肝嚢胞	多発性肝のう胞	多発性肝のう胞
過換気状態	過換気症	過換気症
サルモネラ菌感染症	サルモネラ感染症	サルモネラ感染症
両側性多発性嚢胞腎	多発性のう胞腎	多発性のう胞腎
右手指腫脹	手指腫脹	手指腫脹
右足背発赤	発赤	発赤
脊柱管高度狭窄	脊柱管狭窄症	脊柱管狭窄症
右急性網膜壊死	急性網膜壊死	急性網膜壊死
皮膚硬化がまだかなり	新生児皮膚硬化症	新生児皮膚硬化症
口腔内乾燥軽度	口腔乾燥症	口腔乾燥症
下肢筋痛	下肢筋肉痛	下肢筋肉痛
四肢腱反射亢進	反射亢進	反射亢進
胸部陰影	胸部異常陰影	胸部異常陰影
２次性糖尿病	二次性糖尿病	二次性糖尿病
慢性期疼痛	慢性疼痛	慢性疼痛
一般細菌感染	細菌感染症	細菌感染症
急性小脳失調症	急性小脳性失調症	急性小脳性失調症
左心室内血栓症	心室内血栓症	心室内血栓症
傍神経節腫瘍	傍神経節腫	傍神経節腫
左小細胞肺癌	小細胞肺癌	小細胞肺癌
右大腿骨外顆骨折	大腿骨外顆骨折	大腿骨外顆骨折
巨大膵仮性嚢胞	仮性膵のう胞	仮性膵のう胞
右外耳道炎	外耳炎	外耳炎
分食道癌	食道癌	食道癌
ポリープ状病変	ポリープ	ポリープ
既往高血圧	高血圧症	高血圧症
右リウマチ性膝関節症	関節リウマチ・膝関節	関節リウマチ・膝関節
急性骨髄性白血病（ＡＭＬ）	急性骨髄性白血病	急性骨髄性白血病
腹水大量	腹水症	腹水症
右小脳橋角部腫瘍	小脳橋角部腫瘍	小脳橋角部腫瘍
右眼網膜静脈分枝閉塞症	網膜静脈分枝閉塞症	網膜静脈分枝閉塞症
右脛骨腓骨開放骨折	脛骨腓骨開放骨折	脛骨腓骨開放骨折
左側卵巣腫瘍	卵巣腫瘍	卵巣腫瘍
気管支喘息小発作	気管支喘息発作	気管支喘息発作
左眼窩内腫瘍	眼窩腫瘍	眼窩腫瘍
高度大動脈弁狭窄症	大動脈弁狭窄症	大動脈弁狭窄症
両側声帯外転障害	声帯外転筋麻痺	声帯外転筋麻痺
一部水疱形成	水疱症	水疱症
糖尿病潰瘍	糖尿病性潰瘍	糖尿病性潰瘍
左腎低形成	低形成腎	低形成腎
左母趾疼痛	母趾痛	母趾痛
右眼糖尿病網膜症	糖尿病網膜症	糖尿病網膜症
下肢浮腫左	下肢浮腫	下肢浮腫
遺伝性低尿酸血症	低尿酸血症	低尿酸血症
低アルドステロン血症	低アルドステロン症	低アルドステロン症
脳原発性悪性リンパ腫	脳悪性リンパ腫	脳悪性リンパ腫
抜管後両側反回神経麻痺	両側性反回神経麻痺	両側性反回神経麻痺
左肺下葉肺癌	下葉肺癌	下葉肺癌
アルコール離脱症候群	アルコール離脱状態	アルコール離脱状態
左腸骨骨肉腫	腸骨軟骨肉腫	腸骨軟骨肉腫
脳梁低形成	脳梁形成不全	脳梁形成不全
不定愁訴様	不定愁訴症	不定愁訴症
左下葉非小細胞肺癌	下葉非小細胞肺癌	下葉非小細胞肺癌
膵尾部腫大	膵腫大	膵腫大
両足関節炎	足関節炎	足関節炎
不適応	適応障害	適応障害
陰茎部痛	陰茎部疼痛	陰茎部疼痛
両白内障	白内障	白内障
腎結石	腎結石症	腎結石症
穿刺部発赤	発赤	発赤
時々背部痛	背部痛	背部痛
腎機能悪化	腎機能低下	腎機能低下
高度視力障害	視力障害	視力障害
周期性クッシング症候群	クッシング症候群	クッシング症候群
昨夜微熱	微熱	微熱
左肋骨打撲	肋骨部打撲	肋骨部打撲
胆嚢破裂	胆のう管破裂	胆のう管破裂
潜在結核	結核	結核
胸水セルブロック	胸水貯留	胸水貯留
右精巣上体炎	精巣上体炎	精巣上体炎
左聴神経腫瘍	聴神経腫瘍	聴神経腫瘍
母体出血	出血	出血
胃腸障害	急性胃腸障害	急性胃腸障害
残遺癌	癌	癌
不安大きく	不安障害	不安障害
水腎再燃	水腎症	水腎症
しびれていない	しびれ感	しびれ感
時々血痰	血痰	血痰
遺伝性腎性尿崩症	先天性腎性尿崩症	先天性腎性尿崩症
尿管結石	尿管結石症	尿管結石症
右大腿部骨幹部骨折	大腿骨骨幹部骨折	大腿骨骨幹部骨折
腫瘍感染	腫瘍	腫瘍
悪性腫瘍スクリーニング	悪性腫瘍	悪性腫瘍
外陰部炎	外陰炎	外陰炎
軽度骨髄抑制	骨髄機能低下	骨髄機能低下
頭痛時折	頭痛	頭痛
血腫貯留	血腫	血腫
不整脈発作	不整脈	不整脈
静脈炎症状	静脈炎	静脈炎
時々頭痛	頭痛	頭痛
上行結腸早期癌	上行結腸癌	上行結腸癌
意識変動	意識障害	意識障害
胃癌多発肝転移	転移性肝癌	転移性肝癌
左耳介欠損	耳介欠損	耳介欠損
尿路感染	尿路感染症	尿路感染症
縦隔炎再発	縦隔炎	縦隔炎
前立腺肥大有	前立腺肥大症	前立腺肥大症
必要認知症	認知症	認知症
肝腫瘤性病変	肝腫瘤	肝腫瘤
大動脈瘤解離	解離性大動脈瘤	解離性大動脈瘤
眠前発熱	発熱	発熱
肺炎反復	肺炎	肺炎
子宮内発育不全	子宮発育不全	子宮発育不全
左眼窩内腫瘤	眼窩腫瘤	眼窩腫瘤
多臓器不全状態	多臓器不全	多臓器不全
再度痙攣発作	痙攣発作	痙攣発作
良性発作性頭位めまい	良性発作性頭位めまい症	良性発作性頭位めまい症
両側声帯不全麻痺	声帯不全麻痺	声帯不全麻痺
舌痛	舌痛症	舌痛症
肺動脈弁下狭窄	肺動脈弁下狭窄症	肺動脈弁下狭窄症
頚椎症性神経根炎	頚椎症性神経根症	頚椎症性神経根症
中等度咽頭期嚥下障害	嚥下障害	嚥下障害
ビタミンＤ不足	ビタミンＤ欠乏症	ビタミンＤ欠乏症
日中下痢便	下痢症	下痢症
頻脈傾向変	頻脈症	頻脈症
パーキンソン病関連疾患	パーキンソン病	パーキンソン病
右上肢腫脹	上肢腫脹	上肢腫脹
左肩甲骨部痛	肩甲骨痛	肩甲骨痛
腫瘤残存	腫瘤	腫瘤
原発性空腸癌	空腸癌	空腸癌
左腎梗塞	腎梗塞	腎梗塞
滑液貯留	体液貯留	体液貯留
発赤強い	発赤	発赤
冠動脈高度石灰化	冠動脈石灰化	冠動脈石灰化
慢性痛	慢性疼痛	慢性疼痛
心室内血栓	心室内血栓症	心室内血栓症
腹膜播種結節摘出	腹膜播種	腹膜播種
冠動脈硬化	冠状動脈硬化症	冠状動脈硬化症
右中葉肺癌	中葉肺癌	中葉肺癌
血管免疫芽球型Ｔ細胞リンパ腫	血管免疫芽球性Ｔ細胞リンパ腫	血管免疫芽球性Ｔ細胞リンパ腫
腹部緊満	腹部膨満	腹部膨満
舌骨喉頭下垂	喉頭下垂症	喉頭下垂症
脳梗塞症	脳梗塞	脳梗塞
左非浸潤性乳管癌	非浸潤性乳管癌	非浸潤性乳管癌
右反復性膝蓋骨脱臼	反復性膝蓋骨脱臼	反復性膝蓋骨脱臼
子宮頸がん	子宮頚癌	子宮頚癌
結核性	結核	結核
両側急性硬膜外血腫	急性硬膜外血腫	急性硬膜外血腫
高レニン高血圧	高レニン性高血圧症	高レニン性高血圧症
右前胸部痛	前胸部痛	前胸部痛
唾石	唾石症	唾石症
びまん性肺胞出血	肺胞出血	肺胞出血
左足背疼痛	足背痛	足背痛
双極Ⅱ型障害	２型双極性障害	２型双極性障害
右水晶体脱臼	水晶体脱臼	水晶体脱臼
心サルコイト゛ーシス	心サルコイドーシス	心サルコイドーシス
右側頬部腫脹	頬部腫脹	頬部腫脹
右上背部痛	背部痛	背部痛
多発海綿状血管腫	多発性海綿状血管腫	多発性海綿状血管腫
結核歴	結核	結核
左帯状疱疹	帯状疱疹	帯状疱疹
マルチミニコア病	マルチコア病	マルチコア病
脳底動脈閉塞	脳底動脈閉塞症	脳底動脈閉塞症
胸背部圧迫感	背部圧迫感	背部圧迫感
傍卵巣嚢胞	傍卵巣のう胞	傍卵巣のう胞
血管性紫斑病	症候性紫斑病	症候性紫斑病
時々右股関節痛	股関節痛	股関節痛
母子感染歴	母子感染	母子感染
頸腕症候群	頚肩腕症候群	頚肩腕症候群
右膝違和感	全身違和感	全身違和感
腓骨神経麻痺徴候	腓骨神経麻痺	腓骨神経麻痺
身体外傷	外傷	外傷
心源性塞栓症	心原性脳塞栓症	心原性脳塞栓症
左上腕骨近位端骨折	上腕骨近位端骨折	上腕骨近位端骨折
転移性肝癌術後再発	転移性肝癌	転移性肝癌
劇症Ａ型肝炎	Ａ型劇症肝炎	Ａ型劇症肝炎
右眼増殖性糖尿病網膜症	増殖性糖尿病性網膜症	増殖性糖尿病性網膜症
右上腕腫脹	上腕部腫脹	上腕部腫脹
右側胸水貯留	胸水貯留	胸水貯留
肝性脳症再発	肝性脳症	肝性脳症
二絨毛膜二羊膜性双胎第	二絨毛膜二羊膜性双胎	二絨毛膜二羊膜性双胎
浮腫傾向	浮腫	浮腫
左頚部内頸動脈狭窄	内頚動脈狭窄症	内頚動脈狭窄症
卵管狭窄	卵管狭窄症	卵管狭窄症
蜂窩織炎発症	蜂窩織炎	蜂窩織炎
左下肢蜂窩織炎	下肢蜂巣炎	下肢蜂巣炎
肺塞栓	肺塞栓症	肺塞栓症
低髄圧症状	低髄液圧症	低髄液圧症
左腓骨開放骨折	腓骨開放骨折	腓骨開放骨折
大量水様下痢	下痢症	下痢症
症候性けいれん	症候性てんかん	症候性てんかん
低血糖回避	低血糖	低血糖
左慢性閉塞隅角緑内障	慢性閉塞隅角緑内障	慢性閉塞隅角緑内障
呼吸機能低下	呼吸機能検査異常	呼吸機能検査異常
足変形	足部変形	足部変形
腹部瘢痕ヘルニア	腹壁瘢痕ヘルニア	腹壁瘢痕ヘルニア
月経困難	月経困難症	月経困難症
左局所進行乳癌	進行乳癌	進行乳癌
即時型アレルギー	アレルギー	アレルギー
ループス腎炎Ｖ型	ループス腎炎	ループス腎炎
右下肢しびれ	下肢しびれ	下肢しびれ
頭部脂漏性皮膚炎	脂漏性皮膚炎	脂漏性皮膚炎
左真珠腫性中耳炎再発	真珠腫性中耳炎	真珠腫性中耳炎
傍大動脈ＬＮ転移	大動脈周囲リンパ節転移	大動脈周囲リンパ節転移
労作時呼吸苦自覚	労作時呼吸困難	労作時呼吸困難
間質性肺炎像	間質性肺炎	間質性肺炎
嘔気様	嘔気	嘔気
左上腕骨開放骨折	上腕骨開放骨折	上腕骨開放骨折
腹部膨満継続	腹部膨満	腹部膨満
両側顎関節症	顎関節症	顎関節症
右鼡径部疼痛	鼡径部痛	鼡径部痛
Ｌａｍｉｖｕｄｉｎｅ耐性Ｂ型肝硬変	Ｂ型肝硬変	Ｂ型肝硬変
遺伝性腎炎	家族性腎炎	家族性腎炎
湿疹化	湿疹	湿疹
左大腿部蜂窩織炎	大腿部蜂巣炎	大腿部蜂巣炎
成長発達遅滞	発達遅滞	発達遅滞
下腿点状出血	点状出血	点状出血
手指欠損	手指欠損症	手指欠損症
咽頭粘膜軽度発赤	咽頭発赤	咽頭発赤
下垂手	垂れ手	垂れ手
左陰嚢内容腫大	陰のう腫大	陰のう腫大
朝出血	出血	出血
ステロイド骨粗鬆症	ステロイド性骨粗鬆症	ステロイド性骨粗鬆症
足趾冷感	下肢冷感	下肢冷感
不整腫瘤	腫瘤	腫瘤
左肩部痛	肩部痛	肩部痛
多発腫大リンパ節	リンパ節腫大	リンパ節腫大
左一側性形成不全性股関節症	一側性形成不全性股関節症	一側性形成不全性股関節症
好酸球性気道炎症	好酸球性気管支炎	好酸球性気管支炎
腸管蠕動障害	腸管運動障害	腸管運動障害
十二指腸原発神経内分泌腫瘍	十二指腸神経内分泌腫瘍	十二指腸神経内分泌腫瘍
内腸骨リンパ節転移	腸骨リンパ節転移	腸骨リンパ節転移
虚血性心疾患合併	虚血性心疾患	虚血性心疾患
全肺腫瘍	肺腫瘍	肺腫瘍
軽度構音障害	構音障害	構音障害
項部硬直軽度	項部硬直	項部硬直
下熱	発熱	発熱
左気管支狭窄	気管支狭窄症	気管支狭窄症
肺線維化	肺線維症	肺線維症
味覚異常Ｇｒ１	味覚異常	味覚異常
中心視野欠損	視野欠損	視野欠損
両水腎症	両側水腎症	両側水腎症
口内炎再発	口内炎	口内炎
足背発赤	発赤	発赤
軽鎖沈着症	単クローン性軽鎖重鎖沈着症	単クローン性軽鎖重鎖沈着症
胸椎後縦靭帯骨化症	胸椎後縦靱帯骨化症	胸椎後縦靱帯骨化症
重症敗血症性ショック	敗血症性ショック	敗血症性ショック
間質性肺炎評価	間質性肺炎	間質性肺炎
右腎損傷	腎損傷	腎損傷
再発食道癌	食道癌	食道癌
不定愁訴多い	不定愁訴症	不定愁訴症
発熱再燃	発熱	発熱
左肩関節痛	肩関節痛症	肩関節痛症
浮腫対策	浮腫	浮腫
市中感染型ＭＲＳＡ	ＭＲＳＡ感染症	ＭＲＳＡ感染症
左尿管結石	尿管結石症	尿管結石症
延長症候群	ＱＴ延長症候群	ＱＴ延長症候群
両側肺動脈狭窄症	肺動脈狭窄症	肺動脈狭窄症
胆道系閉塞	胆道閉塞	胆道閉塞
パ−キンソン症候群	パーキンソン症候群	パーキンソン症候群
右原発性肺癌	原発性肺癌	原発性肺癌
敗血症性ショック状態	敗血症性ショック	敗血症性ショック
時々発疹	発疹	発疹
胸膜悪性中皮腫	悪性胸膜中皮腫	悪性胸膜中皮腫
頸椎症性	頚椎症	頚椎症
多発外傷	多発性外傷	多発性外傷
皮膚損傷起	皮膚損傷	皮膚損傷
採血上脱水	脱水症	脱水症
脳血管芽腫	小脳血管芽腫	小脳血管芽腫
右慢性中耳炎	慢性中耳炎	慢性中耳炎
アレルギー様	アレルギー	アレルギー
大腸ポリープ有	大腸ポリープ	大腸ポリープ
右後頭部帯状疱疹	後頭部帯状疱疹	後頭部帯状疱疹
右頚部結核性リンパ節炎	結核性リンパ節炎	結核性リンパ節炎
陳旧性多発アテローム血栓性脳梗塞	陳旧性アテローム血栓性脳梗塞	陳旧性アテローム血栓性脳梗塞
誤嚥徴候	異物誤嚥	異物誤嚥
多発肺腫瘤	肺腫瘤	肺腫瘤
ゲノタイプ１ｂ型Ｃ型肝硬変	Ｃ型肝硬変	Ｃ型肝硬変
頚部蜂窩織炎	頚部蜂巣炎	頚部蜂巣炎
高齢者Ｃ型慢性肝炎	Ｃ型慢性肝炎	Ｃ型慢性肝炎
軽度咽頭違和感	咽頭異常感症	咽頭異常感症
悪性腫瘍評価	悪性腫瘍	悪性腫瘍
発赤領域	発赤	発赤
閉塞性大腸癌	大腸癌	大腸癌
子宮頚部ポリープ	子宮頚管ポリープ	子宮頚管ポリープ
羊水過多	羊水過多症	羊水過多症
筋肉痛症状	筋肉痛	筋肉痛
心外膜石灰化	心膜石灰化	心膜石灰化
右下肢急性動脈閉塞症	下肢急性動脈閉塞症	下肢急性動脈閉塞症
４型進行胃癌	胃進行癌	胃進行癌
貧血性網膜症	貧血網膜症	貧血網膜症
多発性嚢胞肝	多発性肝のう胞	多発性肝のう胞
仙骨奇形	仙骨部奇形	仙骨部奇形
遊走性静脈炎	遊走性血栓性静脈炎	遊走性血栓性静脈炎
左胸膜炎	胸膜炎	胸膜炎
直腸癌術後異時性肝転移	転移性肝癌	転移性肝癌
老人性紅皮症	紅皮症	紅皮症
自律神経ニューロパチー	自律神経性ニューロパチー	自律神経性ニューロパチー
右原発閉塞隅角緑内障	原発閉塞隅角緑内障	原発閉塞隅角緑内障
両下肢浮腫軽度	下肢浮腫	下肢浮腫
右化膿性肩関節炎	化膿性関節炎・肩関節	化膿性関節炎・肩関節
体力低下著明	体力低下	体力低下
外傷所見	外傷	外傷
発赤局面	発赤	発赤
膀胱癌既往	膀胱癌	膀胱癌
夕方発熱	発熱	発熱
左水腎	水腎症	水腎症
代謝異常	代謝障害	代謝障害
左股関節脱臼	股関節脱臼	股関節脱臼
ルーフ゜ス腎炎	ループス腎炎	ループス腎炎
鼠径部腫脹	鼡径部腫脹	鼡径部腫脹
内鼠径ヘルニア	内鼡径ヘルニア	内鼡径ヘルニア
左頬部血管腫	頬部血管腫	頬部血管腫
初回歩行時ふらつき	よろめき歩行	よろめき歩行
洞性頻脈	洞頻脈	洞頻脈
腹膜播種巣	腹膜播種	腹膜播種
アレルギ—性結膜炎	アレルギー性結膜炎	アレルギー性結膜炎
直腸癌ＯＰ	直腸癌	直腸癌
左大腿有棘細胞癌	大腿有棘細胞癌	大腿有棘細胞癌
右顎関節症	顎関節症	顎関節症
骨頭壊死	骨壊死	骨壊死
前立腺癌既往	前立腺癌	前立腺癌
失見当障害	見当識障害	見当識障害
特発性血小板減少症紫斑病	特発性血小板減少性紫斑病	特発性血小板減少性紫斑病
初発癌	癌	癌
痙攣様	痙攣	痙攣
股関節部骨折	股関節骨折	股関節骨折
吸収不全症侯群	吸収不良症候群	吸収不良症候群
甲状腺低下症	甲状腺機能低下症	甲状腺機能低下症
頭部皮膚欠損	頭部皮膚欠損創	頭部皮膚欠損創
傍大動脈リンパ節転移	大動脈周囲リンパ節転移	大動脈周囲リンパ節転移
ビタミンＤ欠乏	ビタミンＤ欠乏症	ビタミンＤ欠乏症
器質的心疾患	心疾患	心疾患
温痛覚	温痛覚過敏	温痛覚過敏
両側内反足	内反足	内反足
孤立性左室緻密化障害	孤立性心筋緻密化障害	孤立性心筋緻密化障害
左手関節痛	手関節痛	手関節痛
びりびりしたしびれ	しびれ感	しびれ感
発赤軽減	発赤	発赤
悪寒等	悪寒	悪寒
中毒性	中毒	中毒
骨膜肥厚	肥厚性皮膚骨膜症	肥厚性皮膚骨膜症
右鼡径部リンパ節腫脹	鼡径部リンパ節腫脹	鼡径部リンパ節腫脹
多発肺塞栓	肺塞栓症	肺塞栓症
右腋窩リンパ節転位	腋窩リンパ節転移	腋窩リンパ節転移
後腹膜脂胞肉腫	後腹膜脂肪肉腫	後腹膜脂肪肉腫
胆管閉塞機転	胆管閉塞症	胆管閉塞症
腰椎圧迫骨折既往	腰椎圧迫骨折	腰椎圧迫骨折
肺動脈分岐部狭窄	肺動脈分岐部狭窄症	肺動脈分岐部狭窄症
右鼡径リンパ節腫脹	鼡径部リンパ節腫脹	鼡径部リンパ節腫脹
左足多趾症	多趾症	多趾症
不安感	不安障害	不安障害
腰椎変性側弯症	腰椎側弯症	腰椎側弯症
右腎低形成	低形成腎	低形成腎
膿胸合併肺放線菌症	肺放線菌症	肺放線菌症
左水尿管症	水尿管症	水尿管症
右大腿部発赤	下腿発赤	下腿発赤
分破水	破水	破水
重症マイコプラズマ肺炎	マイコプラズマ肺炎	マイコプラズマ肺炎
卵巣嚢腫破裂	卵巣のう腫破裂	卵巣のう腫破裂
褥瘡発症	褥瘡	褥瘡
過換気症状	過換気症	過換気症
上右卵管留血腫	卵管留血腫	卵管留血腫
濾胞性リンパ腫再発	濾胞性リンパ腫	濾胞性リンパ腫
左外傷性大腿骨頭壊死	外傷性大腿骨頭壊死	外傷性大腿骨頭壊死
腋窩痛	腋窩部痛	腋窩部痛
右アスペルギルス肺炎	肺アスペルギルス症	肺アスペルギルス症
無疱疹帯状疱疹	帯状疱疹	帯状疱疹
前胸痛	胸痛	胸痛
洞結節不全症候群	洞不全症候群	洞不全症候群
右喉頭腫瘍	喉頭腫瘍	喉頭腫瘍
細菌性脳動脈瘤破裂	脳動脈瘤破裂	脳動脈瘤破裂
痒感	そう痒	そう痒
大動脈リンパ節転移	大動脈周囲リンパ節転移	大動脈周囲リンパ節転移
心内血栓	心内血栓症	心内血栓症
気分悪	悪心	悪心
腰部脊椎管狭窄症	腰部脊柱管狭窄症	腰部脊柱管狭窄症
左総腸骨動脈狭窄	総腸骨動脈狭窄	総腸骨動脈狭窄
尿潜血遷延	顕微鏡的血尿	顕微鏡的血尿
夜間悪寒	悪寒	悪寒
腫瘍制御	腫瘍	腫瘍
右上腕骨頸部骨折	上腕骨頚部骨折	上腕骨頚部骨折
リンハ゜節腫大	リンパ節腫大	リンパ節腫大
依然浮腫	浮腫	浮腫
血栓閉塞型大動脈解離	早期血栓閉鎖型大動脈解離	早期血栓閉鎖型大動脈解離
朝方痰	喀痰	喀痰
進行性直腸癌	直腸癌	直腸癌
小腸型クローン病	小腸クローン病	小腸クローン病
右顔面疼痛	顔面痛	顔面痛
便失禁多量	便失禁	便失禁
労作時頻脈	頻脈症	頻脈症
両下肢結節性紅斑	結節性紅斑	結節性紅斑
右小指基節骨骨折	小指基節骨骨折	小指基節骨骨折
右足背腫脹	足背腫脹	足背腫脹
右大腿痛	大腿痛	大腿痛
動悸等症状	動悸	動悸
顆粒膜細胞腫	卵巣顆粒膜細胞腫	卵巣顆粒膜細胞腫
意識障害患者	意識障害	意識障害
切迫早産腹緊	切迫早産	切迫早産
発赤範囲	発赤	発赤
左腕腫脹	前腕腫脹	前腕腫脹
器質化肺炎	特発性器質化肺炎	特発性器質化肺炎
浮腫悪化	浮腫	浮腫
左頭頂葉神経膠腫	頭頂葉神経膠腫	頭頂葉神経膠腫
骨盤内多発リンパ節転移	骨盤内リンパ節転移	骨盤内リンパ節転移
直腸閉塞	直腸閉鎖	直腸閉鎖
運動ニューロン病	運動ニューロン疾患	運動ニューロン疾患
肺犬糸状虫症	犬糸状虫症	犬糸状虫症
軽度骨棘	骨棘	骨棘
疲労感少	疲労感	疲労感
皮膚損傷リスク	皮膚損傷	皮膚損傷
左母指痛	母指痛	母指痛
間質性肺炎発症	間質性肺炎	間質性肺炎
右環指基節骨骨折	環指基節骨骨折	環指基節骨骨折
左殿部疼痛	殿部痛	殿部痛
両側錐体路障害	錐体路障害	錐体路障害
下肢血流障害	下肢血行障害	下肢血行障害
左肺上葉大細胞癌	上葉肺大細胞癌	上葉肺大細胞癌
結核性肋膜炎	結核性胸膜炎	結核性胸膜炎
疼痛有	疼痛	疼痛
骨盤部リンパ節転移	骨盤内リンパ節転移	骨盤内リンパ節転移
左三叉神経帯状疱疹	三叉神経帯状疱疹	三叉神経帯状疱疹
間質性肺炎悪化	間質性肺炎	間質性肺炎
仙骨部骨折	仙骨骨折	仙骨骨折
重症低体温症	低体温	低体温
右尖足	尖足	尖足
左主気管支狭窄	気管支狭窄症	気管支狭窄症
浸潤癌化	癌	癌
仮性膵嚢胞	仮性膵のう胞	仮性膵のう胞
右肺上葉癌	上葉肺癌	上葉肺癌
膠原病様症状	膠原病	膠原病
軽度黄染	黄疸	黄疸
転移性膵癌	膵癌	膵癌
除皮質硬直様	除皮質硬直	除皮質硬直
食思不振傾向	食欲不振	食欲不振
右脳梗塞	脳梗塞	脳梗塞
不整脈誘発	不整脈	不整脈
胆石膵炎	胆石性膵炎	胆石性膵炎
右腕頭動脈瘤	腕頭動脈瘤	腕頭動脈瘤
左上腕骨顆部骨折	上腕骨顆部骨折	上腕骨顆部骨折
大腿骨骨折後	大腿骨骨折	大腿骨骨折
下顎腫脹	下顎部腫脹	下顎部腫脹
鼻中隔弯曲	鼻中隔弯曲症	鼻中隔弯曲症
逆流性食道炎無	逆流性食道炎	逆流性食道炎
致死性偽膜性腸炎	偽膜性腸炎	偽膜性腸炎
眼窩蜂窩織炎	眼窩蜂巣炎	眼窩蜂巣炎
排尿後痛	排尿痛	排尿痛
右腎梗塞	腎梗塞	腎梗塞
右前頭葉膠芽腫	前頭葉膠芽腫	前頭葉膠芽腫
急性水頭症	水頭症	水頭症
活動性肺結核所見	活動性肺結核	活動性肺結核
右眼白内障	白内障	白内障
本日胸痛	胸痛	胸痛
直腸膀膀胱窩	直腸膀胱瘻	直腸膀胱瘻
頚部結核性リンパ節炎	結核性リンパ節炎	結核性リンパ節炎
左橈骨遠位骨折	橈骨遠位端骨折	橈骨遠位端骨折
しびれない	しびれ感	しびれ感
咽頭血腫	咽頭部血腫	咽頭部血腫
膀胱癌再発	膀胱癌	膀胱癌
両側肺動脈血栓塞栓症	肺動脈血栓塞栓症	肺動脈血栓塞栓症
左胸膜播種	胸膜播種	胸膜播種
左鼡径部腫脹	鼡径部腫脹	鼡径部腫脹
突然呼吸困難	呼吸困難	呼吸困難
両下肢腫脹	下肢腫脹	下肢腫脹
左傍矢状洞髄膜腫	傍矢状洞髄膜腫	傍矢状洞髄膜腫
限局性皮膚硬化型全身性強皮症	全身性強皮症	全身性強皮症
右小脳腫瘍	小脳腫瘍	小脳腫瘍
続発性サルコペニア	サルコペニア	サルコペニア
非医原性左尿管狭窄	尿管狭窄	尿管狭窄
卵巣原発腫瘍	卵巣腫瘍	卵巣腫瘍
右肩周囲炎	肩周囲炎	肩周囲炎
軽度動悸	動悸	動悸
左ポスナーシュロスマン症候群	ポスナーシュロスマン症候群	ポスナーシュロスマン症候群
液体貯留	体液貯留	体液貯留
低張性低ナトリウム血症	低ナトリウム血症	低ナトリウム血症
癌性胸腹膜炎	癌性腹膜炎	癌性腹膜炎
心臓内腫瘍	心臓腫瘍	心臓腫瘍
左坐骨神経麻痺	坐骨神経麻痺	坐骨神経麻痺
リステリア髄膜脳炎	リステリア性髄膜脳炎	リステリア性髄膜脳炎
点圧痛	圧痛	圧痛
帯状疱疹ウイルス脳炎	帯状疱疹性脳炎	帯状疱疹性脳炎
齲蝕	う蝕	う蝕
甲状腺乳頭腺癌	甲状腺乳頭癌	甲状腺乳頭癌
圧迫性骨折	圧迫骨折	圧迫骨折
縱隔リンパ節転移	縦隔リンパ節転移	縦隔リンパ節転移
呼気時喘鳴	喘鳴	喘鳴
苦悶症状	胸内苦悶	胸内苦悶
トルーソー症候群	トルソー症候群	トルソー症候群
全身浮腫不変	全身性浮腫	全身性浮腫
左側頭円蓋部髄膜腫	円蓋部髄膜腫	円蓋部髄膜腫
周術期喘息発作	気管支喘息発作	気管支喘息発作
巣状分節状糸球体硬化症	巣状糸球体硬化症	巣状糸球体硬化症
口腔乾燥感	口腔乾燥症	口腔乾燥症
心配症	心配	心配
アシドーシス進行	アシドーシス	アシドーシス
第５胸椎転移	胸椎転移	胸椎転移
表出性言語発達遅滞	言語発達遅滞	言語発達遅滞
発作性心房細動既往	発作性心房細動	発作性心房細動
左リウマチ性膝関節症	関節リウマチ・膝関節	関節リウマチ・膝関節
腫瘤状構造	腫瘤	腫瘤
門脈右枝血栓	門脈血栓症	門脈血栓症
倦怠感等	倦怠感	倦怠感
筋攣縮	筋痙縮	筋痙縮
元々徐脈	徐脈	徐脈
特発性側彎症	特発性側弯症	特発性側弯症
回盲部放線菌症	放線菌症	放線菌症
右眼球破裂	眼球破裂	眼球破裂
前失神	失神	失神
低分化型肝細胞癌	肝細胞癌	肝細胞癌
右葉間胸水	葉間胸水	葉間胸水
子宮内膜症性卵巣嚢胞	卵巣子宮内膜症のう胞	卵巣子宮内膜症のう胞
受容体脳炎	抗ＮＭＤＡ受容体脳炎	抗ＮＭＤＡ受容体脳炎
左硝子体混濁	硝子体混濁	硝子体混濁
統合失調症既往	統合失調症	統合失調症
平衡機能障害	平衡障害	平衡障害
皮膚潰瘍形成	皮膚潰瘍	皮膚潰瘍
元々不眠症	不眠症	不眠症
左肩甲骨軟骨肉腫	肩甲骨軟骨肉腫	肩甲骨軟骨肉腫
凝固線溶系異常	血液凝固異常	血液凝固異常
全身性サルコイドーシス	サルコイドーシス	サルコイドーシス
脱分化型脂肪肉腫	脂肪肉腫	脂肪肉腫
ＡＣＴＨ分泌不全	ＡＣＴＨ分泌低下症	ＡＣＴＨ分泌低下症
時々残尿感	残尿感	残尿感
マルファン症候群合併	マルファン症候群	マルファン症候群
右眼網膜症	網膜症	網膜症
咽喉頭炎	咽頭喉頭炎	咽頭喉頭炎
右下葉肺扁平上皮癌	下葉肺扁平上皮癌	下葉肺扁平上皮癌
遺尿	遺尿症	遺尿症
右腎門部腹側脂肪肉腫	腎周囲脂肪肉腫	腎周囲脂肪肉腫
左中頭蓋窩髄膜腫	中頭蓋窩髄膜腫	中頭蓋窩髄膜腫
含歯性嚢胞	含歯性のう胞	含歯性のう胞
右重症下肢虚血	重症虚血肢	重症虚血肢
亀頭部発赤	発赤	発赤
重症強迫性障害	強迫性障害	強迫性障害
左椎間板ヘルニア	椎間板ヘルニア	椎間板ヘルニア
咀嚼時痛	咀嚼筋痛障害	咀嚼筋痛障害
左膝関節偽痛風	膝関節偽痛風	膝関節偽痛風
右上腕蜂窩織炎	上腕蜂巣炎	上腕蜂巣炎
悪性リンハ゜腫	悪性リンパ腫	悪性リンパ腫
胆管腫瘍栓	胆管腫瘍	胆管腫瘍
白内障Ｏ	白内障	白内障
帯状疱疹既往	帯状疱疹	帯状疱疹
腫瘤所見	腫瘤	腫瘤
時折血痰	血痰	血痰
帰室時疲労感	疲労感	疲労感
糖尿病等	糖尿病	糖尿病
後腹膜腫瘍切除術	後腹膜腫瘍	後腹膜腫瘍
右中咽頭癌	中咽頭癌	中咽頭癌
臀部炎症性粉瘤	粉瘤	粉瘤
鼻閉塞	鼻閉	鼻閉
疲労感等	疲労感	疲労感
前交通動脈未破裂脳動脈瘤	未破裂脳動脈瘤	未破裂脳動脈瘤
夜間低酸素血症	低酸素血症	低酸素血症
気管支狭窄	気管支狭窄症	気管支狭窄症
真菌塊	真菌症	真菌症
左横隔膜神経麻痺	横隔神経麻痺	横隔神経麻痺
右高度水腎症	水腎症	水腎症
創傷治癒遅延	創傷	創傷
進行性食道癌	食道癌	食道癌
複雑性熱性痙攣	熱性痙攣	熱性痙攣
先天性鼻咽腔閉鎖不全症	先天性鼻咽腔閉鎖不全	先天性鼻咽腔閉鎖不全
右眼鼻涙管閉塞症	鼻涙管閉鎖症	鼻涙管閉鎖症
縦隔原発Ｂ細胞大細胞型リンパ腫	縦隔原発大細胞型Ｂ細胞性リンパ腫	縦隔原発大細胞型Ｂ細胞性リンパ腫
左半視野障害	視野障害	視野障害
大腿骨近位部骨折	大腿骨骨折	大腿骨骨折
第二趾爪囲炎	爪囲炎	爪囲炎
記銘障害	記銘力低下	記銘力低下
上歯肉癌	上顎歯肉癌	上顎歯肉癌
肥厚性幽門狭窄	肥厚性幽門狭窄症	肥厚性幽門狭窄症
問題なし脊柱管狭窄症	脊柱管狭窄症	脊柱管狭窄症
子宮頸部上皮内腫瘍	子宮頚部上皮内腫瘍	子宮頚部上皮内腫瘍
左腰部有棘細胞癌	腰部有棘細胞癌	腰部有棘細胞癌
糖尿病罹患	糖尿病	糖尿病
左鎖骨下動脈起始異常	鎖骨下動脈起始異常	鎖骨下動脈起始異常
腰椎脊柱管狭窄	腰部脊柱管狭窄症	腰部脊柱管狭窄症
左上葉小細胞肺癌	上葉小細胞肺癌	上葉小細胞肺癌
左後縦隔腫瘍	後縦隔腫瘍	後縦隔腫瘍
突然腹痛	腹痛症	腹痛症
尿閉気味	尿閉	尿閉
脳転移新出	転移性脳腫瘍	転移性脳腫瘍
両側肩関節痛	肩関節痛症	肩関節痛症
右肘関節骨折	肘関節骨折	肘関節骨折
両耳下腺腫脹	耳下腺腫脹	耳下腺腫脹
再下血	下血	下血
両変形性股関節症	変形性股関節症	変形性股関節症
左肺良性腫瘍	肺良性腫瘍	肺良性腫瘍
頸動脈狭窄症	内頚動脈狭窄症	内頚動脈狭窄症
若年結核性腹膜炎	結核性腹膜炎	結核性腹膜炎
発赤部分	発赤	発赤
肺雑聴取	胸部音異常	胸部音異常
急性冠症候群発症	急性冠症候群	急性冠症候群
低活動型せん妄	せん妄	せん妄
左化膿性耳下腺炎	化膿性耳下腺炎	化膿性耳下腺炎
痔核症状	痔核	痔核
拘束性心筋症	拘束型心筋症	拘束型心筋症
肝うっ血	うっ血肝	うっ血肝
浮腫軽減	浮腫	浮腫
膠原病外来	膠原病	膠原病
在型食道癌	食道癌	食道癌
肺結核性腹膜炎	結核性腹膜炎	結核性腹膜炎
ネフローゼ状態	ネフローゼ症候群	ネフローゼ症候群
軽度僧帽弁逆流症	僧帽弁逆流症	僧帽弁逆流症
前胸部粉瘤	粉瘤	粉瘤
左室中部閉塞性肥大型心筋症	閉塞性肥大型心筋症	閉塞性肥大型心筋症
しびれがきつい	しびれ感	しびれ感
両側内耳奇形	内耳先天奇形	内耳先天奇形
完全右脚ブロック指摘	完全右脚ブロック	完全右脚ブロック
肛門部潰瘍	肛門潰瘍	肛門潰瘍
アレルギ—性鼻炎	アレルギー性鼻炎	アレルギー性鼻炎
無症候性狭心症	狭心症	狭心症
左側頭葉海綿状血管腫	側頭葉海綿状血管腫	側頭葉海綿状血管腫
直腸癌術後直腸癌	直腸癌	直腸癌
膵炎再燃	膵炎	膵炎
失見当識障害	見当識障害	見当識障害
非定型うつ	非定型うつ病	非定型うつ病
胸郭運動異常	胸郭異常	胸郭異常
前頭蓋底腫瘍	頭蓋底腫瘍	頭蓋底腫瘍
動脈瘤様骨嚢腫	動脈瘤様骨のう腫	動脈瘤様骨のう腫
軟性腫瘤	腫瘤	腫瘤
本日疼痛	疼痛	疼痛
軽度間歇性跛行	間欠性跛行	間欠性跛行
蛋白血症	異常蛋白血症	異常蛋白血症
後縦隔膿瘍	縦隔膿瘍	縦隔膿瘍
徐脈等	徐脈	徐脈
サルコイドーシス疑	サルコイドーシス	サルコイドーシス
左片麻痺	片麻痺	片麻痺
足部冷感	下肢冷感	下肢冷感
下痢〜水様便	下痢症	下痢症
関節固縮	関節拘縮	関節拘縮
慢性アレルギ—性鼻炎	アレルギー性鼻炎	アレルギー性鼻炎
下顎骨正中部骨折	下顎正中部骨折	下顎正中部骨折
後嘔吐	嘔吐症	嘔吐症
劇症Ａ群溶連菌感染症	劇症型Ａ群連鎖球菌感染症	劇症型Ａ群連鎖球菌感染症
軽度咽頭期嚥下障害	嚥下障害	嚥下障害
脊椎側弯症	脊柱側弯症	脊柱側弯症
上腹部鈍痛	上腹部痛	上腹部痛
本日血尿	血尿	血尿
クラミジア頸管炎	クラミジア頚管炎	クラミジア頚管炎
性急性リンパ性白血病	急性リンパ性白血病	急性リンパ性白血病
周囲リンパ節腫大	リンパ節腫大	リンパ節腫大
左外耳道閉鎖	外耳道閉鎖	外耳道閉鎖
醜形恐怖	醜形恐怖症	醜形恐怖症
播種性クリプトコックス症	播種性クリプトコッカス症	播種性クリプトコッカス症
口唇落屑	皮膚落屑	皮膚落屑
両下腿潰瘍	下腿皮膚潰瘍	下腿皮膚潰瘍
びまん性リンパ腫	リンパ腫	リンパ腫
多発嚢胞腎	多発性のう胞腎	多発性のう胞腎
嘔吐１回	嘔吐症	嘔吐症
深夜低血糖	夜間低血糖症	夜間低血糖症
過敏症状	過敏症	過敏症
右足小指骨折	小指骨折	小指骨折
せん妄発言	せん妄	せん妄
ヒステリー症状	ヒステリー反応	ヒステリー反応
歩行時創部痛	術創部痛	術創部痛
正色素性正球性貧血	正球性正色素性貧血	正球性正色素性貧血
右足腫脹	足部腫脹	足部腫脹
両肺胸膜肥厚	胸膜肥厚	胸膜肥厚
眼鏡　近視	近視	近視
両眼瞼黄色腫	眼瞼黄色腫	眼瞼黄色腫
正中頚嚢胞	正中頚のう胞	正中頚のう胞
両側尿管結石	尿管結石症	尿管結石症
高血圧状態	高血圧症	高血圧症
喀血症状	喀血	喀血
指発赤	発赤	発赤
右手橈骨骨折	橈骨骨折	橈骨骨折
本日血便	血便	血便
左副腎出血	副腎出血	副腎出血
急性前壁中隔梗塞	急性前壁中隔心筋梗塞	急性前壁中隔心筋梗塞
右顔面部帯状疱疹	顔面帯状疱疹	顔面帯状疱疹
びまん性管内増殖性糸球体腎炎	慢性びまん性管内増殖性糸球体腎炎	慢性びまん性管内増殖性糸球体腎炎
傍腹部大動脈リンパ節腫大	リンパ節腫大	リンパ節腫大
左上腕脂肪腫	上腕脂肪腫	上腕脂肪腫
冠動脈狭窄症	冠状動脈狭窄症	冠状動脈狭窄症
膵石灰化	膵石灰化症	膵石灰化症
丘疹様	丘疹	丘疹
２型＋ステロイド性糖尿病	ステロイド糖尿病	ステロイド糖尿病
腫瘤縮小	腫瘤	腫瘤
水中毒症状	水中毒	水中毒
鼻中隔彎曲	鼻中隔弯曲症	鼻中隔弯曲症
過敏性腸症侯群	過敏性腸症候群	過敏性腸症候群
会話性幻聴	幻聴	幻聴
筋疲労感	筋疲労	筋疲労
水疱後びらん	水疱症	水疱症
時々せん妄	せん妄	せん妄
術後右反回神経麻痺	術後性反回神経麻痺	術後性反回神経麻痺
反復性細菌感染	細菌感染症	細菌感染症
皮膚軟部組織感染症	皮膚感染症	皮膚感染症
腰痛ヘルニア	椎間板ヘルニア性腰痛症	椎間板ヘルニア性腰痛症
イレウス合併	イレウス	イレウス
肺好酸球性肉芽腫	肺好酸球性肉芽腫症	肺好酸球性肉芽腫症
両側眼瞼下垂症	眼瞼下垂症	眼瞼下垂症
両側性結核性胸膜炎	結核性胸膜炎	結核性胸膜炎
甲状腺機能亢進症状	甲状腺機能亢進症	甲状腺機能亢進症
後頭部打撲	頭部打撲	頭部打撲
薬剤性過敏症候群	薬剤性過敏症症候群	薬剤性過敏症症候群
両側喉頭肉芽腫	喉頭肉芽腫	喉頭肉芽腫
ポリープ数個	ポリープ	ポリープ
右低音障害型感音難聴	急性低音障害型感音難聴	急性低音障害型感音難聴
外陰部血腫	外陰血腫	外陰血腫
右聴神経腫瘍	聴神経腫瘍	聴神経腫瘍
左血腫	血腫	血腫
早期乳癌	乳癌	乳癌
多発髄膜腫	多発性髄膜腫	多発性髄膜腫
術中出血多	多量出血	多量出血
先天性嚢胞肺	先天性のう胞肺	先天性のう胞肺
手背部疼痛	手背部痛	手背部痛
腹部大動脈嚢状瘤	腹部大動脈瘤	腹部大動脈瘤
左腫瘤	腫瘤	腫瘤
葉酸欠乏	葉酸欠乏症	葉酸欠乏症
鼻口蓋管嚢胞	鼻口蓋管のう胞	鼻口蓋管のう胞
両膝痛	膝関節痛	膝関節痛
こわばりあり	こわばり	こわばり
重度三尖弁閉鎖不全症	三尖弁閉鎖不全症	三尖弁閉鎖不全症
第二度房室ブロック	第２度房室ブロック	第２度房室ブロック
点状発赤	発赤	発赤
白血病化	白血病	白血病
消退性発赤	発赤	発赤
腫脹圧痛	圧痛	圧痛
ループスアンチコアグラント陰性	ループスアンチコアグラント	ループスアンチコアグラント
右肺胸水貯留	胸水貯留	胸水貯留
血性吐物	吐血	吐血
両側腓骨神経麻痺	腓骨神経麻痺	腓骨神経麻痺
軽度右室肥大	右室肥大	右室肥大
右膝蜂窩織炎	膝部蜂巣炎	膝部蜂巣炎
２型＋ステロイド糖尿病	ステロイド糖尿病	ステロイド糖尿病
低血糖用	低血糖	低血糖
右足底潰瘍	足底皮膚潰瘍	足底皮膚潰瘍
右網膜静脈分枝閉塞症	網膜静脈分枝閉塞症	網膜静脈分枝閉塞症
腹痛時	腹痛症	腹痛症
多動多弁	多動性障害	多動性障害
突然意識障害	意識障害	意識障害
角膜ヘルペス	ヘルペス角膜炎	ヘルペス角膜炎
食思不振症状	食欲不振	食欲不振
開大代謝性アシドーシス	代謝性アシドーシス	代謝性アシドーシス
心因性過食症	心因性過食	心因性過食
右下腿腫脹	下腿腫脹	下腿腫脹
背部皮脂欠乏性湿疹	皮脂欠乏性湿疹	皮脂欠乏性湿疹
足爪白鮮	足爪白癬	足爪白癬
末梢循環不全徴候	末梢循環不全	末梢循環不全
眼瞼下垂自覚	眼瞼下垂症	眼瞼下垂症
右上顎洞乳頭腫	上顎洞乳頭腫	上顎洞乳頭腫
浮腫状	浮腫	浮腫
陰部掻痒	外陰部そう痒症	外陰部そう痒症
十二指腸多発びらん	十二指腸びらん	十二指腸びらん
前立性肥大症	前立腺肥大症	前立腺肥大症
嘔気状況	嘔気	嘔気
元々浮腫	浮腫	浮腫
左小脳出血	小脳出血	小脳出血
躁うつ	躁うつ病	躁うつ病
ベージェット病	ベーチェット病	ベーチェット病
元来頭痛	頭痛	頭痛
下部直腸癌	直腸癌	直腸癌
両側総腸骨動脈狭窄	総腸骨動脈狭窄	総腸骨動脈狭窄
牽引痛	牽引性頭痛	牽引性頭痛
婦人入院脳梗塞	脳梗塞	脳梗塞
ダンピング症候群併発	ダンピング症候群	ダンピング症候群
ループスアンチコアグラント陽性	ループスアンチコアグラント	ループスアンチコアグラント
右気管支肺炎	気管支肺炎	気管支肺炎
劇症型髄膜炎菌感染症	髄膜炎菌感染症	髄膜炎菌感染症
両難聴	難聴	難聴
左腎細胞癌	腎細胞癌	腎細胞癌
多発膵転移	転移性膵腫瘍	転移性膵腫瘍
両眼白内障手	白内障	白内障
膠原病由来	膠原病	膠原病
右椎骨動脈起始部狭窄	椎骨動脈狭窄症	椎骨動脈狭窄症
嚢胞性胸腺腫	胸腺腫	胸腺腫
悪性リンパ腫既往	悪性リンパ腫	悪性リンパ腫
Ｌ３圧迫骨折	圧迫骨折	圧迫骨折
腎臓疾患	腎疾患	腎疾患
頸部椎間板ヘルニア	頚椎椎間板ヘルニア	頚椎椎間板ヘルニア
右眼網膜裂孔	網膜裂孔	網膜裂孔
下血増悪	下血	下血
重度不眠	不眠症	不眠症
咀嚼困難感	咀嚼障害	咀嚼障害
食道圧迫	食道圧迫症	食道圧迫症
両足関節痛	足関節痛	足関節痛
子宮筋腫有	子宮筋腫	子宮筋腫
淡明細胞型腎細胞癌	腎細胞癌	腎細胞癌
浮腫生	浮腫	浮腫
左自然気胸再発	自然気胸	自然気胸
右大腿骨骨肉腫	大腿骨骨肉腫	大腿骨骨肉腫
ウィルス感染症	ウイルス感染症	ウイルス感染症
左手尺骨神経麻痺	尺骨神経麻痺	尺骨神経麻痺
周期性呼吸時折	周期性呼吸	周期性呼吸
多発性大腸ポリープ	大腸ポリープ	大腸ポリープ
糖尿病用	糖尿病	糖尿病
術前心電図異常	心電図異常	心電図異常
中耳炎症状	中耳炎	中耳炎
褥瘡発生歴	褥瘡	褥瘡
趾爪囲炎	爪囲炎	爪囲炎
挙上期誤嚥	異物誤嚥	異物誤嚥
腹部膨満増強	腹部膨満	腹部膨満
右鎖骨痛	鎖骨痛	鎖骨痛
左歯性上顎洞炎	歯性上顎洞炎	歯性上顎洞炎
重度歯周病	歯周症	歯周症
梗塞後出血	出血性脳梗塞	出血性脳梗塞
骨髄異型性症候群	骨髄異形成症候群	骨髄異形成症候群
光線過敏	光線過敏症	光線過敏症
虚脱病変	虚脱	虚脱
肘痛	肘関節痛	肘関節痛
先天性代謝異常症	代謝障害	代謝障害
左眼加齢性黄斑変性症	加齢黄斑変性	加齢黄斑変性
ストレス性潰瘍	ストレス潰瘍	ストレス潰瘍
発熱下	発熱	発熱
失見当識発言	見当識障害	見当識障害
右眼内悪性リンパ腫	眼窩悪性リンパ腫	眼窩悪性リンパ腫
右季肋部自発痛	季肋部痛	季肋部痛
右手舟状骨骨折	手舟状骨骨折	手舟状骨骨折
発作後精神病	精神病	精神病
四肢水疱	水疱症	水疱症
右足趾骨髄炎	趾骨髄炎	趾骨髄炎
結節性不整脈	不整脈	不整脈
慢性血腫	血腫	血腫
昨日不眠	不眠症	不眠症
頚椎脊柱管狭窄症	頚部脊柱管狭窄症	頚部脊柱管狭窄症
発赤域	発赤	発赤
膵頭部転移	転移性膵腫瘍	転移性膵腫瘍
高度肝障害	肝障害	肝障害
右肺下葉腫瘍	肺腫瘍	肺腫瘍
左下肢冷感	下肢冷感	下肢冷感
大腫瘍	腫瘍	腫瘍
胸骨肋骨転移	肋骨転移	肋骨転移
重症心身障害児	重症心身障害	重症心身障害
圧痛自発痛	圧痛	圧痛
反射異常	異常反射	異常反射
慢性間質性腎炎	慢性尿細管間質性腎炎	慢性尿細管間質性腎炎
カテーテル感染	カテーテル感染症	カテーテル感染症
腫瘍多発	腫瘍	腫瘍
しびれてる感	しびれ感	しびれ感
少量尿失禁	尿失禁症	尿失禁症
高血糖是正	高血糖症	高血糖症
腫瘤拡大	腫瘤	腫瘤
病原性大腸菌	病原性大腸菌感染症	病原性大腸菌感染症
耳小骨奇形	耳小骨の先天奇形	耳小骨の先天奇形
全身性紫斑	全身性紫斑病	全身性紫斑病
右股関節亜脱臼	股関節亜脱臼	股関節亜脱臼
左橈骨神経麻痺	橈骨神経麻痺	橈骨神経麻痺
全身性間代性痙攣	間代性痙攣	間代性痙攣
右肋間痛	肋間痛	肋間痛
右続発性緑内障	続発性緑内障	続発性緑内障
軟骨腫	骨軟骨腫	骨軟骨腫
開大性代謝性アシドーシス	代謝性アシドーシス	代謝性アシドーシス
左上葉肺転移	転移性肺腫瘍	転移性肺腫瘍
軽度しびれ感	しびれ感	しびれ感
意識レベル低	意識障害	意識障害
感覚性運動失調	運動失調	運動失調
中枢性めまい	中枢性めまい症	中枢性めまい症
続発性膜性腎症	膜性腎症	膜性腎症
先天性風疹症侯群	先天性風疹症候群	先天性風疹症候群
椎骨動脈狭窄	椎骨動脈狭窄症	椎骨動脈狭窄症
活動性肺結核症	活動性肺結核	活動性肺結核
痙攣発作再発	痙攣発作	痙攣発作
卵巣腫瘍再発	卵巣腫瘍	卵巣腫瘍
顔面麻痺１	顔面神経麻痺	顔面神経麻痺
巨大腫瘤	腫瘤	腫瘤
右足関節腫脹	足関節腫脹	足関節腫脹
両肺副雑音	胸部音異常	胸部音異常
腎機能異常	腎機能検査異常	腎機能検査異常
姿勢障害	姿勢異常	姿勢異常
イレウス発生	イレウス	イレウス
左骨盤内リンパ嚢胞	骨盤部感染性リンパのう胞	骨盤部感染性リンパのう胞
右大腿骨骨腫瘍	大腿骨腫瘍	大腿骨腫瘍
反応性胸水	胸水貯留	胸水貯留
骨盤内膜症	骨盤子宮内膜症	骨盤子宮内膜症
右耳下腺腫瘤	耳下腺腫瘤	耳下腺腫瘤
易出血傾向	出血傾向	出血傾向
末梢発赤	発赤	発赤
部分性脂肪萎縮症	部分的脂肪萎縮症	部分的脂肪萎縮症
亜急性脊髄連合変性症	亜急性連合性脊髄変性症	亜急性連合性脊髄変性症
膿疱形成	膿疱	膿疱
左卵巣膿瘍	卵巣膿瘍	卵巣膿瘍
サイトメガロウイルス感染	サイトメガロウイルス感染症	サイトメガロウイルス感染症
Ⅱ型糖尿病	２型糖尿病	２型糖尿病
両顎関節痛	顎関節痛	顎関節痛
逆流性胆管炎	逆行性胆管炎	逆行性胆管炎
関節痛症状	関節痛	関節痛
空気塞栓	空気塞栓症	空気塞栓症
肝膿瘍破裂	肝膿瘍	肝膿瘍
両下腿痛	下腿痛	下腿痛
肺扁平上皮癌、病期不明	肺扁平上皮癌	肺扁平上皮癌
低血圧自覚症状	低血圧症	低血圧症
倦怠感増	倦怠感	倦怠感
脾臓腫瘍	脾腫瘍	脾腫瘍
頸部食道狭窄	食道狭窄	食道狭窄
陰茎アポクリン癌	陰茎アポクリン腺癌	陰茎アポクリン腺癌
元来月経痛	月経痛	月経痛
胆嚢十二指腸瘻	胆のう十二指腸瘻	胆のう十二指腸瘻
特発性肺胞出血	肺胞出血	肺胞出血
左側頬粘膜癌	頬粘膜癌	頬粘膜癌
アレルギー反応	アレルギー	アレルギー
夜間痙攣	痙攣	痙攣
毎回尿失禁	尿失禁症	尿失禁症
愁訴	不定愁訴症	不定愁訴症
血腫不変	血腫	血腫
各種膠原病	膠原病	膠原病
脊柱圧痛	圧痛	圧痛
亜脱臼傾向	亜脱臼	亜脱臼
自傷痕	自傷	自傷
嘔吐持続	嘔吐症	嘔吐症
薬剤肝障害	薬物性肝障害	薬物性肝障害
転移性膵体部癌	膵体部癌	膵体部癌
左前頭葉神経膠腫	前頭葉神経膠腫	前頭葉神経膠腫
精神運動興奮	精神運動興奮状態	精神運動興奮状態
紅斑反応	紅斑症	紅斑症
右尿管結石症	尿管結石症	尿管結石症
瞳孔不同	瞳孔不同症	瞳孔不同症
多発肝転移巣	転移性肝腫瘍	転移性肝腫瘍
原発性アルドステロン	原発性アルドステロン症	原発性アルドステロン症
中背部悪性黒色腫	背部悪性黒色腫	背部悪性黒色腫
副甲状腺亢進症	副甲状腺機能亢進症	副甲状腺機能亢進症
右声帯不全麻痺	声帯不全麻痺	声帯不全麻痺
心合併症	心臓合併症	心臓合併症
労作時前胸部痛	前胸部痛	前胸部痛
肺炎等	肺炎	肺炎
新生児一過性多呼	新生児一過性多呼吸	新生児一過性多呼吸
不眠状態	不眠症	不眠症
プレクリニカルクッシング症候群	クッシング症候群	クッシング症候群
左胸鎖乳突筋炎	胸鎖乳突筋炎	胸鎖乳突筋炎
時々関節痛	関節痛	関節痛
急性大動脈弁閉鎖不全	大動脈弁閉鎖不全症	大動脈弁閉鎖不全症
左心肥大	心肥大	心肥大
前頭部打撲	頭部打撲	頭部打撲
腹緊なし	腹部膨満	腹部膨満
右結石性腎盂腎炎	結石性腎盂腎炎	結石性腎盂腎炎
心嚢液貯留	心膜液貯留	心膜液貯留
臓器限局性前立腺癌	限局性前立腺癌	限局性前立腺癌
日中傾眠	傾眠症	傾眠症
食後高血糖	高血糖症	高血糖症
右間歇性跛行	間欠性跛行	間欠性跛行
陰嚢ヘルニア	陰のうヘルニア	陰のうヘルニア
右腋窩リンパ節腫脹	腋窩リンパ節腫脹	腋窩リンパ節腫脹
爪甲剥離症	爪剥離症	爪剥離症
再度急性腎不全	急性腎不全	急性腎不全
耳閉塞感	耳閉感	耳閉感
胃小彎側ＬＮ転移	胃周囲リンパ節転移	胃周囲リンパ節転移
軽度発達遅滞	発達遅滞	発達遅滞
右先天性耳瘻孔	先天性耳瘻孔	先天性耳瘻孔
椎間板ヘルニア有	椎間板ヘルニア	椎間板ヘルニア
扁平ポリープ	ポリープ	ポリープ
腸液貯留	体液貯留	体液貯留
両変形性膝関節症	変形性膝関節症	変形性膝関節症
びまん性脳浮腫	脳浮腫	脳浮腫
呼気困難	呼吸困難	呼吸困難
大腸早期癌	大腸癌	大腸癌
喘鳴聴取	喘鳴	喘鳴
右頬部痛	頬部痛	頬部痛
右肺動静脈瘻	肺動静脈瘻	肺動静脈瘻
問題なし膀胱直腸障害	膀胱直腸障害	膀胱直腸障害
右膿胸	膿胸	膿胸
時折胸痛	胸痛	胸痛
無自覚性低血糖	低血糖	低血糖
両側卵管留血腫	卵管留血腫	卵管留血腫
脱水注意	脱水症	脱水症
右飛蚊症	飛蚊症	飛蚊症
全身倦怠感軽度	全身倦怠感	全身倦怠感
先天性巨大色素性母斑	巨大母斑細胞母斑	巨大母斑細胞母斑
不安大	不安障害	不安障害
胸骨下液体貯留	体液貯留	体液貯留
新出肺転移	転移性肺腫瘍	転移性肺腫瘍
多発脳神経障害	多発性脳神経障害	多発性脳神経障害
軽度高血糖	高血糖症	高血糖症
２型腫瘤	腫瘤	腫瘤
右腎無形成	腎無形成	腎無形成
リンパ節圧痛	圧痛	圧痛
全身性細菌感染症	細菌感染症	細菌感染症
脳髄膜瘤	髄膜脳瘤	髄膜脳瘤
水頭症症状	水頭症	水頭症
統合失調症合併	統合失調症	統合失調症
胃痛症状	胃痛	胃痛
急性期ＨＩＶ感染症	ＨＩＶ感染症	ＨＩＶ感染症
右下肢運動障害	四肢運動障害	四肢運動障害
炎症性脱髄性多発根神経炎	慢性炎症性脱髄性多発神経炎	慢性炎症性脱髄性多発神経炎
過食症状	過食症	過食症
疾病不安	不安障害	不安障害
肺癌手術	肺癌	肺癌
色素脱失	炎症後色素脱失	炎症後色素脱失
カテ感染	カテーテル感染症	カテーテル感染症
胃食道静脈瘤破裂	食道静脈瘤破裂	食道静脈瘤破裂
左足背蜂窩織炎	足背蜂巣炎	足背蜂巣炎
右胸水貯留	胸水貯留	胸水貯留
疲労感生	疲労感	疲労感
両側腎腫大	腎腫大	腎腫大
右坐骨骨折	坐骨骨折	坐骨骨折
右耳下腺腫脹	耳下腺腫脹	耳下腺腫脹
進行肺癌	肺癌	肺癌
肋骨起始部骨転移	肋骨転移	肋骨転移
先天性左股関節脱臼	先天性股関節脱臼	先天性股関節脱臼
鮮血痰	血痰	血痰
壊死性変化	壊死	壊死
溶連菌感染	溶連菌感染症	溶連菌感染症
局所発赤	発赤	発赤
不整脈チーム	不整脈	不整脈
両上肢痛	上肢痛	上肢痛
右上腕骨近位端粉砕骨折	上腕骨近位端粉砕骨折	上腕骨近位端粉砕骨折
膀胱腫瘍再発	膀胱腫瘍	膀胱腫瘍
クッシング徴候	クッシング症候群	クッシング症候群
軽度甲状腺腫大	甲状腺腫	甲状腺腫
左下葉肺癌	下葉肺癌	下葉肺癌
若年性認知症	認知症	認知症
腰部腫瘍	腰椎部腫瘍	腰椎部腫瘍
鼠径ヘルニア	鼡径ヘルニア	鼡径ヘルニア
侵襲性肺アスペルギウス症	侵襲性肺アスペルギルス症	侵襲性肺アスペルギルス症
軽度左軸偏位	心電図左軸偏位	心電図左軸偏位
左頚部結核性リンパ節炎	結核性リンパ節炎	結核性リンパ節炎
脳室拡大進行	脳室拡大	脳室拡大
下腿潰瘍	下腿皮膚潰瘍	下腿皮膚潰瘍
小脳転移	転移性脳腫瘍	転移性脳腫瘍
腎盂軽度拡張	腎盂拡張	腎盂拡張
心臓原発性悪性リンパ腫	心臓悪性リンパ腫	心臓悪性リンパ腫
準夜帯嘔気	嘔気	嘔気
成人Ｓｔｉｌｌ病	成人スチル病	成人スチル病
脳血管疾患	脳血管障害	脳血管障害
左膝窩部痛	膝窩部痛	膝窩部痛
下咽頭がん	下咽頭癌	下咽頭癌
少量血便	血便	血便
脳梗塞有	脳梗塞	脳梗塞
痕発赤	発赤	発赤
左上腕骨肉腫	上腕骨骨肉腫	上腕骨骨肉腫
産生胃癌	胃癌	胃癌
下肢冷感軽度	下肢冷感	下肢冷感
左室内同期不全	左室不全	左室不全
漿液性腺腫	卵巣漿液性腺腫	卵巣漿液性腺腫
日本海裂頭条虫	日本海裂頭条虫症	日本海裂頭条虫症
肝芽腫再発	肝芽腫	肝芽腫
状血管腫	血管腫	血管腫
右下腿疼痛	下腿痛	下腿痛
軽度眼球突出	眼球突出症	眼球突出症
前頭葉障害	前頭葉症候群	前頭葉症候群
肺門部リンパ節腫大	肺門リンパ節腫脹	肺門リンパ節腫脹
麻疹罹患歴	麻疹	麻疹
心膜播種	腹膜播種	腹膜播種
左腎動脈狭窄症	腎動脈狭窄症	腎動脈狭窄症
体動時創部痛	術創部痛	術創部痛
左退形成性星細胞腫	退形成性星細胞腫	退形成性星細胞腫
労作時疲労	疲労感	疲労感
不定愁訴多	不定愁訴症	不定愁訴症
気道狭窄音	気道狭窄	気道狭窄
未分類関節炎	関節炎	関節炎
左視床出血	視床出血	視床出血
神経症性うつ病	抑うつ神経症	抑うつ神経症
左耳後部腫瘤	耳後部腫瘤	耳後部腫瘤
左尿管結石性腎盂腎炎	結石性腎盂腎炎	結石性腎盂腎炎
筋力低下可能性	筋力低下	筋力低下
咽喉頭違和感	咽喉頭異常感症	咽喉頭異常感症
左肩腱板損傷	肩腱板損傷	肩腱板損傷
再脱臼	脱臼	脱臼
左肺動脈狭窄症	肺動脈狭窄症	肺動脈狭窄症
肺動脈弁上狭窄	肺動脈弁上狭窄症	肺動脈弁上狭窄症
後頸部発赤	発赤	発赤
偽粘液腫	粘液腫	粘液腫
毛包向性菌状息肉症	菌状息肉症	菌状息肉症
右足不随意運動	不随意運動症	不随意運動症
子宮体癌Ｉａ期	子宮体癌	子宮体癌
過活動型せん妄	せん妄	せん妄
進行性核上麻痺	進行性核上性麻痺	進行性核上性麻痺
左上腕悪性黒色腫	上腕部悪性黒色腫	上腕部悪性黒色腫
重症敗血症	敗血症	敗血症
子宮頸癌子宮頚癌	子宮頚癌	子宮頚癌
足痛い	足痛	足痛
徐脈気味	徐脈	徐脈
境界性パーソナリティ障害	境界型パーソナリティ障害	境界型パーソナリティ障害
鼻骨折	鼻骨骨折	鼻骨骨折
左低形成腎	低形成腎	低形成腎
結腸癌肝転移	転移性肝癌	転移性肝癌
硬性白斑	白斑	白斑
広範囲脊柱管狭窄症	広範脊柱管狭窄症	広範脊柱管狭窄症
中～低分化肝細胞癌	肝細胞癌	肝細胞癌
腰骨骨折	腰椎骨折	腰椎骨折
心理的不安	不安障害	不安障害
カンジダ肺炎	肺カンジダ症	肺カンジダ症
頬部悪性腫瘍	頬部腫瘍	頬部腫瘍
顔面形成	顔面形成異常	顔面形成異常
インフルエンザ陽性	インフルエンザ	インフルエンザ
眼球結膜浮腫	結膜浮腫	結膜浮腫
多発肺膿瘍	肺膿瘍	肺膿瘍
発熱随伴症状	発熱	発熱
急性肺動脈血栓塞栓症	肺動脈血栓塞栓症	肺動脈血栓塞栓症
右上腕骨近位端骨折	上腕骨近位端骨折	上腕骨近位端骨折
易疲労性強い	易疲労感	易疲労感
せん妄生	せん妄	せん妄
右第３趾爪囲炎	爪囲炎	爪囲炎
多発縦隔リンパ節転移	縦隔リンパ節転移	縦隔リンパ節転移
尿失禁状態	尿失禁症	尿失禁症
失語正常	失語症	失語症
先週頭痛	頭痛	頭痛
多発筋炎	多発性筋炎	多発性筋炎
呼吸促迫症状	呼吸促迫	呼吸促迫
大腿骨骨頭壊死	大腿骨頭壊死	大腿骨頭壊死
呼気喘鳴	喘鳴	喘鳴
サイトメガロ網膜炎	サイトメガロウイルス網膜炎	サイトメガロウイルス網膜炎
内分泌機能不全	内分泌機能異常	内分泌機能異常
熱	発熱	発熱
軽度音声障害	音声障害	音声障害
緑膿菌腸炎	緑膿菌性腸炎	緑膿菌性腸炎
ドレーン出血	出血	出血
発熱中	発熱	発熱
右錐体路障害	錐体路障害	錐体路障害
両下肢筋痛	下肢筋肉痛	下肢筋肉痛
難治性冠攣縮性狭心症	冠攣縮性狭心症	冠攣縮性狭心症
眼白内障	白内障	白内障
喀痰付着	喀痰	喀痰
両側下腿潰瘍	下腿皮膚潰瘍	下腿皮膚潰瘍
心肺停止後蘇生	心肺停止	心肺停止
頸部食道癌	頚部食道癌	頚部食道癌
症候性てんかん発症	症候性てんかん	症候性てんかん
左腎血管腫	腎血管腫	腎血管腫
命令性幻聴	幻聴	幻聴
子宮体癌Ⅱ期	子宮体癌	子宮体癌
左顔面神経麻痺症状	顔面神経麻痺	顔面神経麻痺
顎部痛	顎痛	顎痛
元々疼痛	疼痛	疼痛
遅発性ペースメーカー感染症	ペースメーカ植え込み後感染症	ペースメーカ植え込み後感染症
腎機能障害	腎機能低下	腎機能低下
冠動脈−肺動脈瘻	肺動脈瘻	肺動脈瘻
嚥下時疼痛	嚥下痛	嚥下痛
大腸ポリープ後	大腸ポリープ	大腸ポリープ
門脈圧亢進	門脈圧亢進症	門脈圧亢進症
認知面低下	軽度認知障害	軽度認知障害
ノカルジア	ノカルジア症	ノカルジア症
右人工膝関節感染	人工膝関節感染	人工膝関節感染
十二指腸穿通性潰瘍	穿通性十二指腸潰瘍	穿通性十二指腸潰瘍
左横隔膜弛緩症	横隔膜弛緩症	横隔膜弛緩症
入眠困難感	不眠症	不眠症
尿管結石有	尿管結石症	尿管結石症
冠攣縮型狭心症	冠攣縮性狭心症	冠攣縮性狭心症
夜間嘔気	嘔気	嘔気
女性器クラミジア感染症	クラミジア感染症	クラミジア感染症
血液凝固障害	血液凝固異常	血液凝固異常
右肺下葉肺炎	肺炎	肺炎
左大葉性肺炎	大葉性肺炎	大葉性肺炎
膵臓癌術後再発	膵癌	膵癌
足底湿疹	足湿疹	足湿疹
多発肝血管腫	多発性肝血管腫	多発性肝血管腫
夜疼痛	疼痛	疼痛
時々不整脈	不整脈	不整脈
多発性リンパ節転移	多部位リンパ節転移	多部位リンパ節転移
最近花粉症	花粉症	花粉症
食道空腸吻合部狭窄	吻合部狭窄	吻合部狭窄
クリオグロブリン性血管炎	クリオグロブリン血症性血管炎	クリオグロブリン血症性血管炎
右頬部擦過傷	頬部擦過創	頬部擦過創
右肺下葉癌	下葉肺癌	下葉肺癌
ＥＢウイルス初感染	ＥＢウイルス感染症	ＥＢウイルス感染症
急性膵臓炎	急性膵炎	急性膵炎
朝痰	喀痰	喀痰
子宮体癌Ⅳ期	子宮体癌	子宮体癌
視神経脊髄炎（ＮＭＯ）	視神経脊髄炎	視神経脊髄炎
左下副甲状腺腺腫	副甲状腺腺腫	副甲状腺腺腫
高脂血症高脂血症	高脂血症	高脂血症
左頬部有棘細胞癌	頬部有棘細胞癌	頬部有棘細胞癌
脊柱起立筋膿瘍	筋膿瘍	筋膿瘍
左踵骨骨折	踵骨骨折	踵骨骨折
右上肢振戦	一側上肢振戦	一側上肢振戦
両眼性複視	複視	複視
複雑型熱性痙攣	熱性痙攣	熱性痙攣
右膀胱側壁部膀胱癌	膀胱側壁部膀胱癌	膀胱側壁部膀胱癌
子宮頸部頸管狭窄	子宮頚管狭窄症	子宮頚管狭窄症
呼吸喘鳴	喘鳴	喘鳴
脊椎管狭窄症	脊柱管狭窄症	脊柱管狭窄症
左前庭障害	前庭障害	前庭障害
妊娠発覚	妊娠	妊娠
両膝関節症	膝関節症	膝関節症
類もやもや病	もやもや病	もやもや病
左足関節開放性脱臼骨折	足関節開放性脱臼骨折	足関節開放性脱臼骨折
食道癌２病変	食道癌	食道癌
右卵巣奇形腫	卵巣奇形腫	卵巣奇形腫
感冒罹患	感冒	感冒
血腫像	血腫	血腫
慢性血栓性肺高血圧症	慢性血栓塞栓性肺高血圧症	慢性血栓塞栓性肺高血圧症
眼振誘発	眼振	眼振
急性ウイルス性脳炎	ウイルス性脳炎	ウイルス性脳炎
労作時呼吸困難感軽度	労作時呼吸困難	労作時呼吸困難
逆流性食道炎症状	逆流性食道炎	逆流性食道炎
非代償性Ｃ型肝硬変	Ｃ型非代償性肝硬変	Ｃ型非代償性肝硬変
ヘルペス感染症	ヘルペスウイルス感染症	ヘルペスウイルス感染症
肺塞栓既往	肺塞栓症	肺塞栓症
左肺下葉扁平上皮癌	下葉肺扁平上皮癌	下葉肺扁平上皮癌
高度拘束性換気障害	拘束性換気障害	拘束性換気障害
ＭＲＳＡ感染	ＭＲＳＡ感染症	ＭＲＳＡ感染症
肝多発腫瘤	肝腫瘤	肝腫瘤
左大腿骨病的骨折	大腿骨病的骨折	大腿骨病的骨折
Ｓ状結腸癌術後肝転移	転移性肝癌	転移性肝癌
耳痛	耳痛症	耳痛症
内頸動脈狭窄	内頚動脈狭窄症	内頚動脈狭窄症
左急性感音難聴	感音難聴	感音難聴
右角膜ヘルペス	ヘルペス角膜炎	ヘルペス角膜炎
重症うつ病	うつ病	うつ病
膵管炎	膵炎	膵炎
腫瘤構造	腫瘤	腫瘤
右大腿部蜂窩織炎	大腿部蜂巣炎	大腿部蜂巣炎
慢性疲労	疲労感	疲労感
膿性喀痰	膿性痰	膿性痰
胆汁うっ滞型	胆汁うっ滞	胆汁うっ滞
両膝関節疼痛	膝関節痛	膝関節痛
緑内症	緑内障	緑内障
夕方痛み	疼痛	疼痛
心窩部自発痛	心窩部痛	心窩部痛
リンパ節腫大傾向	リンパ節腫大	リンパ節腫大
時々尿失禁	尿失禁症	尿失禁症
左臀部悪性軟部腫瘍	殿部悪性軟部腫瘍	殿部悪性軟部腫瘍
低血糖遷延	低血糖	低血糖
右中大脳動脈閉塞症	中大脳動脈閉塞症	中大脳動脈閉塞症
発熱コントロール	発熱	発熱
右下腿蜂窩織炎	下腿蜂巣炎	下腿蜂巣炎
膿瘍形成	膿瘍	膿瘍
右尿管損傷	尿管損傷	尿管損傷
感染性心内膜症	感染性心内膜炎	感染性心内膜炎
播種性血管内凝固症	播種性血管内凝固	播種性血管内凝固
呼吸困難感等自覚症状	呼吸困難	呼吸困難
右下腿コンパートメント症候群	下腿コンパートメント症候群	下腿コンパートメント症候群
右鎖骨上窩リンパ節腫大	鎖骨上リンパ節腫脹	鎖骨上リンパ節腫脹
右鼡径部腫脹	鼡径部腫脹	鼡径部腫脹
右側胸部皮下結節	皮下結節	皮下結節
腹水浸出	腹水症	腹水症
脂質異常	脂質異常症	脂質異常症
２型大腸癌	大腸癌	大腸癌
感覚神経障害	知覚障害	知覚障害
物忘れ	健忘症	健忘症
左大腿骨骨腫瘍	大腿骨腫瘍	大腿骨腫瘍
膵管内乳頭粘液腫瘍	膵管内乳頭粘液性腫瘍	膵管内乳頭粘液性腫瘍
胃癌多発骨転移	胃癌骨転移	胃癌骨転移
左膝窩動脈瘤	膝窩動脈瘤	膝窩動脈瘤
腹部背部痛	背部痛	背部痛
アルコール性ニューロパチー	アルコール性多発ニューロパチー	アルコール性多発ニューロパチー
鎖骨上リンパ節腫大	鎖骨上リンパ節腫脹	鎖骨上リンパ節腫脹
右大腿ヘルニア嵌頓	大腿ヘルニア嵌頓	大腿ヘルニア嵌頓
双極２型障害	２型双極性障害	２型双極性障害
感染性腹部動脈瘤	感染性腹部大動脈瘤	感染性腹部大動脈瘤
右胸膜播種	胸膜播種	胸膜播種
半月体形成糸球体腎炎	半月体形成性糸球体腎炎	半月体形成性糸球体腎炎
筋力低下著明	筋力低下	筋力低下
付属器圧痛	圧痛	圧痛
嘔吐出現	嘔吐症	嘔吐症
低血糖生	低血糖	低血糖
劇症型肺炎球菌性敗血症	肺炎球菌性敗血症	肺炎球菌性敗血症
発熱有	発熱	発熱
不眠考	不眠症	不眠症
全失語	全失語症	全失語症
左尺骨神経障害	尺骨神経麻痺	尺骨神経麻痺
脳幹部神経膠腫	脳幹神経膠腫	脳幹神経膠腫
左再発性気胸	続発性気胸	続発性気胸
気管性喘息	気管支喘息	気管支喘息
日中下痢	下痢症	下痢症
骨粗鬆症有	骨粗鬆症	骨粗鬆症
左深部静脈血栓症	深部静脈血栓症	深部静脈血栓症
副腎転移	転移性副腎腫瘍	転移性副腎腫瘍
左緊張性気胸	緊張性気胸	緊張性気胸
度腟壁裂傷	腟裂傷	腟裂傷
左前胸部腫瘤	前胸部腫瘤	前胸部腫瘤
間歇的腹痛	腹痛症	腹痛症
星状細胞腫	星細胞腫	星細胞腫
急性腎障害	腎障害	腎障害
左鎖骨上リンパ節腫脹	鎖骨上リンパ節腫脹	鎖骨上リンパ節腫脹
陳旧性脳出血	脳出血	脳出血
腸雑音聴取可	異常腸音	異常腸音
左肺原発性肺癌	原発性肺癌	原発性肺癌
両側側脳室軽度拡大	脳室拡大	脳室拡大
脈性右室心筋症	不整脈原性右室心筋症	不整脈原性右室心筋症
縦隔炎併発	縦隔炎	縦隔炎
暗紅色斑	紅斑症	紅斑症
骨盤圧痛	骨盤痛	骨盤痛
骨巨細胞腫瘍	骨巨細胞腫	骨巨細胞腫
Ｌａｎｇｈａｎｓ巨細胞	ランゲルハンス細胞組織球症	ランゲルハンス細胞組織球症
気管支喘息発症	気管支喘息	気管支喘息
胆管拡張	胆管拡張症	胆管拡張症
好中球浸潤	好中球増加症	好中球増加症
夜間不安	不安障害	不安障害
右上肢線状強皮症	線状強皮症	線状強皮症
左耳介発赤	発赤	発赤
朝方倦怠感	倦怠感	倦怠感
後頚部脂肪腫	頚部脂肪腫	頚部脂肪腫
混合性アルカローシス	アルカローシス	アルカローシス
再発悪性リンパ腫	悪性リンパ腫	悪性リンパ腫
時折心窩部痛	心窩部痛	心窩部痛
右足根骨骨折	足根骨骨折	足根骨骨折
右脛骨骨幹部骨折	脛骨骨幹部骨折	脛骨骨幹部骨折
両側腎盂軽度拡張	腎盂拡張	腎盂拡張
左下肺野陰影	下肺野陰影	下肺野陰影
左側舌癌	舌癌	舌癌