副腎原発神経芽腫	副腎神経芽腫	副腎神経芽腫
Ｗｅｎｃｋｅｂａｃｈ型房室ブロック	ウェンケバッハ型第２度房室ブロック	ウェンケバッハ型第２度房室ブロック
病原性大腸菌Ｏ−１５７感染性腸炎	病原性大腸菌感染症	病原性大腸菌感染症
レム睡眠行動異常症	レム睡眠行動障害	レム睡眠行動障害
脱髄性疾患	脱髄疾患	脱髄疾患
無動性無言	無動性無言症	無動性無言症
慢性活動性ＥＢウルス感染症	ＥＢウイルス感染症	ＥＢウイルス感染症
蛋白尿減少	蛋白尿	蛋白尿
中心性奬液性網脈絡膜症	中心性漿液性網脈絡膜症	中心性漿液性網脈絡膜症
左一側性反回神経麻痺	一側性反回神経麻痺	一側性反回神経麻痺
イレウス様	イレウス	イレウス
膵炎併発	膵炎	膵炎
早発黄疸	早発性黄疸	早発性黄疸
右上葉肺小細胞癌	上葉肺大細胞癌	上葉肺大細胞癌
左顔面血管腫	顔面血管腫	顔面血管腫
鼻汁多く	鼻汁	鼻汁
夜両足痛	足痛	足痛
左内眼角基底細胞癌	眼角基底細胞癌	眼角基底細胞癌
副鼻腔腫瘍	鼻副鼻腔腫瘍	鼻副鼻腔腫瘍
軽度咽頭発赤	咽頭発赤	咽頭発赤
痙攣起	痙攣	痙攣
下肢浮腫圧痕	下肢浮腫	下肢浮腫
四肢浮腫軽度	四肢浮腫	四肢浮腫
大腸ポリープ　ポリペク後	大腸ポリープ	大腸ポリープ
腰椎椎体椎間板炎	腰椎椎間板炎	腰椎椎間板炎
右鼠径部痛	鼡径部痛	鼡径部痛
創部痛	術創部痛	術創部痛
左大腿骨骨折	大腿骨骨折	大腿骨骨折
子宮頸管ポリープ切除	子宮頚管ポリープ	子宮頚管ポリープ
左中耳炎	中耳炎	中耳炎
胃食道逆流症状	胃食道逆流症	胃食道逆流症
両側卵巣子宮内膜症性嚢胞	卵巣子宮内膜症のう胞	卵巣子宮内膜症のう胞
妊娠性糖尿病	妊娠糖尿病	妊娠糖尿病
左寛骨臼骨折	寛骨臼骨折	寛骨臼骨折
両下肢静脈血栓	下肢静脈血栓症	下肢静脈血栓症
クモ膜下出血	くも膜下出血	くも膜下出血
メサンギウム増殖性腎炎	メサンギウム増殖性糸球体腎炎	メサンギウム増殖性糸球体腎炎
下肢結節性紅斑	結節性紅斑	結節性紅斑
左動眼神経麻痺	動眼神経麻痺	動眼神経麻痺
術中直腸損傷	直腸損傷	直腸損傷
下肢動脈瘤	下肢の動脈瘤	下肢の動脈瘤
夜頻尿	夜間頻尿症	夜間頻尿症
左歯痛	歯痛	歯痛
腹膜播種切除	腹膜播種	腹膜播種
左頬部痛	頬部痛	頬部痛
右肩関節亜脱臼半横指	肩関節亜脱臼	肩関節亜脱臼
マラセチア毛嚢炎	マラセチア毛包炎	マラセチア毛包炎
腫瘍床	腫瘍	腫瘍
左膀胱尿管逆流症	膀胱尿管逆流	膀胱尿管逆流
クラミジア感染	クラミジア感染症	クラミジア感染症
奬液性嚢胞腺腫	膵漿液性のう胞腺腫	膵漿液性のう胞腺腫
問題なし前立腺肥大	前立腺肥大症	前立腺肥大症
急性パルボウイルスＢ１９感染症	パルボウイルス感染症	パルボウイルス感染症
肺動脈狭窄	肺動脈狭窄症	肺動脈狭窄症
夢遊病	夢遊症	夢遊症
左内頚動脈閉塞	内頚動脈閉塞症	内頚動脈閉塞症
脳虚血症状	脳虚血症	脳虚血症
眼性疲労	眼精疲労	眼精疲労
頚椎症神経根症	頚椎症性神経根症	頚椎症性神経根症
睡眠障害招くリスク	睡眠障害	睡眠障害
骨盤内ＬＮ転移	骨盤内リンパ節転移	骨盤内リンパ節転移
放射線性皮膚炎	放射線皮膚炎	放射線皮膚炎
髄膜炎徴候	髄膜炎	髄膜炎
蛋白漏出胃腸症	蛋白漏出性胃腸症	蛋白漏出性胃腸症
左大脳陳旧性ラクナ梗塞	陳旧性ラクナ梗塞	陳旧性ラクナ梗塞
腹水多量	腹水症	腹水症
右卵巣悪性腫瘍	卵巣悪性腫瘍	卵巣悪性腫瘍
児嘔気	嘔気	嘔気
尿閉歴	尿閉	尿閉
子宮頚上皮内癌	子宮頚部上皮内癌	子宮頚部上皮内癌
湿疹様	湿疹	湿疹
右無機能腎	無機能腎	無機能腎
左鎖骨下動脈閉塞	鎖骨下動脈閉塞症	鎖骨下動脈閉塞症
逆行性健忘	逆向性健忘	逆向性健忘
認知症様症状	認知症	認知症
高度大動脈弁狭窄	大動脈弁狭窄症	大動脈弁狭窄症
右顔面骨骨折	顔面骨骨折	顔面骨骨折
脂質異常症（＋）	脂質異常症	脂質異常症
両側椎骨動脈瘤	椎骨動脈瘤	椎骨動脈瘤
誤嚥性肺炎併発	誤嚥性肺炎	誤嚥性肺炎
右末梢前庭障害	末梢前庭障害	末梢前庭障害
閉塞性動脈硬化症　症状	閉塞性動脈硬化症	閉塞性動脈硬化症
ナッツアレルギー	ピーナッツアレルギー	ピーナッツアレルギー
甲状腺乳頭癌術後再発	甲状腺乳頭癌	甲状腺乳頭癌
肝臓機能障害用	肝機能障害	肝機能障害
下痢治	下痢症	下痢症
右気管支狭窄	気管支狭窄症	気管支狭窄症
好酸球増多	好酸球増加症	好酸球増加症
両下腿皮膚潰瘍	下腿皮膚潰瘍	下腿皮膚潰瘍
関節リウマチ発症	関節リウマチ	関節リウマチ
眼球偏移	眼球偏位	眼球偏位
肥満	肥満症	肥満症
網膜中心動脈閉塞	網膜中心動脈閉塞症	網膜中心動脈閉塞症
右声帯ポリープ	声帯ポリープ	声帯ポリープ
下肢潰瘍	下肢皮膚潰瘍	下肢皮膚潰瘍
難治性胸腹水	難治性腹水	難治性腹水
未破裂脳動脈瘤コイル塞栓	未破裂脳動脈瘤	未破裂脳動脈瘤
左側頭葉膠芽腫	側頭葉膠芽腫	側頭葉膠芽腫
脳血管障害性パーキンソニズム	脳血管障害性パーキンソン症候群	脳血管障害性パーキンソン症候群
Ｃ型肝硬変症	Ｃ型肝硬変	Ｃ型肝硬変
左踵部悪性黒色腫	踵部悪性黒色腫	踵部悪性黒色腫
帯状疱疹無	帯状疱疹	帯状疱疹
右下腿痛	下腿痛	下腿痛
女性化乳房	女性化乳房症	女性化乳房症
大動脈弁膜症	大動脈弁弁膜症	大動脈弁弁膜症
右下腿麻痺	下肢麻痺	下肢麻痺
発作性上室性頻拍	発作性上室頻拍	発作性上室頻拍
筋肉痛生	筋肉痛	筋肉痛
腰椎滑り症	腰椎すべり症	腰椎すべり症
淡血性胸水	血性胸水	血性胸水
仙骨部褥瘡痕	仙骨部褥瘡	仙骨部褥瘡
左肝腫瘍	肝腫瘍	肝腫瘍
心室二段脈	心室性二段脈	心室性二段脈
鼻腔腫瘍摘出	鼻腔腫瘍	鼻腔腫瘍
左胸壁腫瘍切除	胸壁腫瘍	胸壁腫瘍
右尿管癌	尿管癌	尿管癌
高血糖	高血糖症	高血糖症
胸痛無	胸痛	胸痛
好酸球増多症	好酸球増加症	好酸球増加症
右腎明細胞肉腫	腎明細胞肉腫	腎明細胞肉腫
下位運動ニューロン徴候	運動ニューロン疾患	運動ニューロン疾患
鼻部異物肉芽腫	皮膚異物肉芽腫	皮膚異物肉芽腫
Ｂｉｃｋｅｒｓｔａｆｆ型脳幹脳炎	ビッカースタッフ脳幹脳炎	ビッカースタッフ脳幹脳炎
右中皮腫	中皮腫	中皮腫
ジベル薔薇色粃糠疹	ジベルばら色粃糠疹	ジベルばら色粃糠疹
扁桃腺腫大	扁桃肥大	扁桃肥大
口内出血	口腔出血	口腔出血
右上方視野欠損	視野欠損	視野欠損
両側臼蓋形成不全症	臼蓋形成不全	臼蓋形成不全
前股関節症	股関節症	股関節症
多発肝嚢胞	多発性肝のう胞	多発性肝のう胞
過換気状態	過換気症	過換気症
サルモネラ菌感染症	サルモネラ感染症	サルモネラ感染症
右手指腫脹	手指腫脹	手指腫脹
脊柱管高度狭窄	脊柱管狭窄症	脊柱管狭窄症
右急性網膜壊死	急性網膜壊死	急性網膜壊死
口腔内乾燥軽度	口腔乾燥症	口腔乾燥症
下肢筋痛	下肢筋肉痛	下肢筋肉痛
四肢腱反射亢進	反射亢進	反射亢進
胸部陰影	胸部異常陰影	胸部異常陰影
２次性糖尿病	二次性糖尿病	二次性糖尿病
慢性期疼痛	慢性疼痛	慢性疼痛
急性小脳失調症	急性小脳性失調症	急性小脳性失調症
左心室内血栓症	心室内血栓症	心室内血栓症
傍神経節腫瘍	傍神経節腫	傍神経節腫
右大腿骨外顆骨折	大腿骨外顆骨折	大腿骨外顆骨折
分食道癌	食道癌	食道癌
右リウマチ性膝関節症	関節リウマチ・膝関節	関節リウマチ・膝関節
急性骨髄性白血病（ＡＭＬ）	急性骨髄性白血病	急性骨髄性白血病
腹水大量	腹水症	腹水症
右小脳橋角部腫瘍	小脳橋角部腫瘍	小脳橋角部腫瘍
右眼網膜静脈分枝閉塞症	網膜静脈分枝閉塞症	網膜静脈分枝閉塞症
右脛骨腓骨開放骨折	脛骨腓骨開放骨折	脛骨腓骨開放骨折
左側卵巣腫瘍	卵巣腫瘍	卵巣腫瘍
気管支喘息小発作	気管支喘息発作	気管支喘息発作
解離性動脈瘤破裂	解離性動脈瘤	解離性動脈瘤
高度大動脈弁狭窄症	大動脈弁狭窄症	大動脈弁狭窄症
左母趾疼痛	母趾痛	母趾痛
右眼糖尿病網膜症	糖尿病網膜症	糖尿病網膜症
下肢浮腫左	下肢浮腫	下肢浮腫
冠動脈狭窄３枝病変	狭心症３枝病変	狭心症３枝病変
低アルドステロン血症	低アルドステロン症	低アルドステロン症
重度僧帽弁狭窄症	僧帽弁狭窄症	僧帽弁狭窄症
抜管後両側反回神経麻痺	両側性反回神経麻痺	両側性反回神経麻痺
左肺下葉肺癌	下葉肺癌	下葉肺癌
不定愁訴様	不定愁訴症	不定愁訴症
左下葉非小細胞肺癌	下葉非小細胞肺癌	下葉非小細胞肺癌
両足関節炎	足関節炎	足関節炎
夜低血糖	低血糖	低血糖
陰茎部痛	陰茎部疼痛	陰茎部疼痛
髄外形質細胞腫	骨外性形質細胞腫	骨外性形質細胞腫
両白内障	白内障	白内障
腎結石	腎結石症	腎結石症
腎機能悪化	腎機能低下	腎機能低下
尾てい骨骨折	尾骨骨折	尾骨骨折
周期性クッシング症候群	クッシング症候群	クッシング症候群
左肋骨打撲	肋骨部打撲	肋骨部打撲
シャイドレジャー症候群	シャイ・ドレーガー症候群	シャイ・ドレーガー症候群
右精巣上体炎	精巣上体炎	精巣上体炎
左聴神経腫瘍	聴神経腫瘍	聴神経腫瘍
一過性意識消失発作	一過性脳虚血発作	一過性脳虚血発作
水腎再燃	水腎症	水腎症
しびれていない	しびれ感	しびれ感
時々血痰	血痰	血痰
遺伝性腎性尿崩症	先天性腎性尿崩症	先天性腎性尿崩症
右大腿部骨幹部骨折	大腿骨骨幹部骨折	大腿骨骨幹部骨折
糖尿病神経症	糖尿病性神経痛	糖尿病性神経痛
劇症肝炎亜急性型	劇症肝炎	劇症肝炎
静脈炎症状	静脈炎	静脈炎
上行結腸早期癌	上行結腸癌	上行結腸癌
両側小脳梗塞	小脳梗塞	小脳梗塞
赤紫斑	紫斑病	紫斑病
左耳介欠損	耳介欠損	耳介欠損
尿路感染	尿路感染症	尿路感染症
縦隔炎再発	縦隔炎	縦隔炎
前立腺肥大有	前立腺肥大症	前立腺肥大症
子宮内発育不全	子宮発育不全	子宮発育不全
左眼窩内腫瘤	眼窩腫瘤	眼窩腫瘤
多臓器不全状態	多臓器不全	多臓器不全
良性発作性頭位めまい	良性発作性頭位めまい症	良性発作性頭位めまい症
両側声帯不全麻痺	声帯不全麻痺	声帯不全麻痺
舌痛	舌痛症	舌痛症
肺動脈弁下狭窄	肺動脈弁下狭窄症	肺動脈弁下狭窄症
頚椎症性神経根炎	頚椎症性神経根症	頚椎症性神経根症
グラム陰性桿菌菌血症	グラム陰性桿菌敗血症	グラム陰性桿菌敗血症
右上肢腫脹	上肢腫脹	上肢腫脹
腫瘤残存	腫瘤	腫瘤
右卵巣チョコレート嚢腫	チョコレートのう胞	チョコレートのう胞
歩行時呼吸困難感	労作時呼吸困難	労作時呼吸困難
滑液貯留	体液貯留	体液貯留
発赤強い	発赤	発赤
冠動脈高度石灰化	冠動脈石灰化	冠動脈石灰化
慢性痛	慢性疼痛	慢性疼痛
不適応行動	適応障害	適応障害
心室内血栓	心室内血栓症	心室内血栓症
腹膜播種結節摘出	腹膜播種	腹膜播種
冠動脈硬化	冠状動脈硬化症	冠状動脈硬化症
右中葉肺癌	中葉肺癌	中葉肺癌
血管免疫芽球型Ｔ細胞リンパ腫	血管免疫芽球性Ｔ細胞リンパ腫	血管免疫芽球性Ｔ細胞リンパ腫
腹部緊満	腹部膨満	腹部膨満
舌骨喉頭下垂	喉頭下垂症	喉頭下垂症
脳梗塞症	脳梗塞	脳梗塞
左非浸潤性乳管癌	非浸潤性乳管癌	非浸潤性乳管癌
右反復性膝蓋骨脱臼	反復性膝蓋骨脱臼	反復性膝蓋骨脱臼
両側急性硬膜外血腫	急性硬膜外血腫	急性硬膜外血腫
高レニン高血圧	高レニン性高血圧症	高レニン性高血圧症
右前胸部痛	前胸部痛	前胸部痛
両側血気胸	血気胸	血気胸
唾石	唾石症	唾石症
左手首痛	手部痛	手部痛
インフルエンザ菌	インフルエンザ	インフルエンザ
左足背疼痛	足背痛	足背痛
右水晶体脱臼	水晶体脱臼	水晶体脱臼
心サルコイト゛ーシス	心サルコイドーシス	心サルコイドーシス
多発海綿状血管腫	多発性海綿状血管腫	多発性海綿状血管腫
高度肥満症	病的肥満症	病的肥満症
マルチミニコア病	マルチコア病	マルチコア病
脳底動脈閉塞	脳底動脈閉塞症	脳底動脈閉塞症
胸背部圧迫感	背部圧迫感	背部圧迫感
傍卵巣嚢胞	傍卵巣のう胞	傍卵巣のう胞
母子感染歴	母子感染	母子感染
頸腕症候群	頚肩腕症候群	頚肩腕症候群
右膝違和感	全身違和感	全身違和感
腓骨神経麻痺徴候	腓骨神経麻痺	腓骨神経麻痺
心源性塞栓症	心原性脳塞栓症	心原性脳塞栓症
左上腕骨近位端骨折	上腕骨近位端骨折	上腕骨近位端骨折
軽度肺動脈弁狭窄	肺動脈弁狭窄症	肺動脈弁狭窄症
右眼増殖性糖尿病網膜症	増殖性糖尿病性網膜症	増殖性糖尿病性網膜症
右上腕腫脹	上腕部腫脹	上腕部腫脹
右側胸水貯留	胸水貯留	胸水貯留
水疱瘡	水疱症	水疱症
肝性脳症再発	肝性脳症	肝性脳症
二絨毛膜二羊膜性双胎第	二絨毛膜二羊膜性双胎	二絨毛膜二羊膜性双胎
骨Ｐａｇｅｔ病	骨パジェット病	骨パジェット病
腓腹部圧痛	腹部圧痛	腹部圧痛
卵管狭窄	卵管狭窄症	卵管狭窄症
胸部大動脈解離	急性大動脈解離	急性大動脈解離
蜂窩織炎発症	蜂窩織炎	蜂窩織炎
肺塞栓	肺塞栓症	肺塞栓症
低髄圧症状	低髄液圧症	低髄液圧症
左腓骨開放骨折	腓骨開放骨折	腓骨開放骨折
症候性けいれん	症候性てんかん	症候性てんかん
左慢性閉塞隅角緑内障	慢性閉塞隅角緑内障	慢性閉塞隅角緑内障
足変形	足部変形	足部変形
腹部瘢痕ヘルニア	腹壁瘢痕ヘルニア	腹壁瘢痕ヘルニア
月経困難	月経困難症	月経困難症
左局所進行乳癌	進行乳癌	進行乳癌
ループス腎炎Ｖ型	ループス腎炎	ループス腎炎
右下肢しびれ	下肢しびれ	下肢しびれ
頭部脂漏性皮膚炎	脂漏性皮膚炎	脂漏性皮膚炎
左真珠腫性中耳炎再発	真珠腫性中耳炎	真珠腫性中耳炎
労作時呼吸苦自覚	労作時呼吸困難	労作時呼吸困難
間質性肺炎像	間質性肺炎	間質性肺炎
嘔気様	嘔気	嘔気
左上腕骨開放骨折	上腕骨開放骨折	上腕骨開放骨折
腹部膨満継続	腹部膨満	腹部膨満
右足底腱膜炎	足底筋膜炎	足底筋膜炎
両側顎関節症	顎関節症	顎関節症
右鼡径部疼痛	鼡径部痛	鼡径部痛
湿疹化	湿疹	湿疹
左大腿部蜂窩織炎	大腿部蜂巣炎	大腿部蜂巣炎
下腿点状出血	点状出血	点状出血
手指欠損	手指欠損症	手指欠損症
咽頭粘膜軽度発赤	咽頭発赤	咽頭発赤
左陰嚢内容腫大	陰のう腫大	陰のう腫大
ステロイド骨粗鬆症	ステロイド性骨粗鬆症	ステロイド性骨粗鬆症
足趾冷感	下肢冷感	下肢冷感
左肩部痛	肩部痛	肩部痛
左一側性形成不全性股関節症	一側性形成不全性股関節症	一側性形成不全性股関節症
腸管蠕動障害	腸管運動障害	腸管運動障害
腰椎変性辷り症	腰椎変性すべり症	腰椎変性すべり症
十二指腸原発神経内分泌腫瘍	十二指腸神経内分泌腫瘍	十二指腸神経内分泌腫瘍
内腸骨リンパ節転移	腸骨リンパ節転移	腸骨リンパ節転移
虚血性心疾患合併	虚血性心疾患	虚血性心疾患
全肺腫瘍	肺腫瘍	肺腫瘍
項部硬直軽度	項部硬直	項部硬直
左気管支狭窄	気管支狭窄症	気管支狭窄症
肺線維化	肺線維症	肺線維症
味覚異常Ｇｒ１	味覚異常	味覚異常
中心視野欠損	視野欠損	視野欠損
昨晩低血糖	低血糖	低血糖
両水腎症	両側水腎症	両側水腎症
口内炎再発	口内炎	口内炎
皮質性認知症	皮質下認知症	皮質下認知症
胸椎後縦靭帯骨化症	胸椎後縦靱帯骨化症	胸椎後縦靱帯骨化症
重症敗血症性ショック	敗血症性ショック	敗血症性ショック
間質性肺炎評価	間質性肺炎	間質性肺炎
不定愁訴多い	不定愁訴症	不定愁訴症
浮腫対策	浮腫	浮腫
延長症候群	ＱＴ延長症候群	ＱＴ延長症候群
両側肺動脈狭窄症	肺動脈狭窄症	肺動脈狭窄症
胆道系閉塞	胆道閉塞	胆道閉塞
軟骨損傷	肋軟骨損傷	肋軟骨損傷
パ−キンソン症候群	パーキンソン症候群	パーキンソン症候群
右原発性肺癌	原発性肺癌	原発性肺癌
敗血症性ショック状態	敗血症性ショック	敗血症性ショック
多発外傷	多発性外傷	多発性外傷
皮膚損傷起	皮膚損傷	皮膚損傷
脳血管芽腫	小脳血管芽腫	小脳血管芽腫
右慢性中耳炎	慢性中耳炎	慢性中耳炎
アレルギー様	アレルギー	アレルギー
ノカルジア脳膿瘍	ノカルジア症	ノカルジア症
大腸ポリープ有	大腸ポリープ	大腸ポリープ
右後頭部帯状疱疹	後頭部帯状疱疹	後頭部帯状疱疹
陳旧性多発アテローム血栓性脳梗塞	陳旧性アテローム血栓性脳梗塞	陳旧性アテローム血栓性脳梗塞
脳血管傷害	脳血管障害	脳血管障害
頚部蜂窩織炎	頚部蜂巣炎	頚部蜂巣炎
高齢者Ｃ型慢性肝炎	Ｃ型慢性肝炎	Ｃ型慢性肝炎
悪性腫瘍評価	悪性腫瘍	悪性腫瘍
発赤領域	発赤	発赤
子宮頚部ポリープ	子宮頚管ポリープ	子宮頚管ポリープ
羊水過多	羊水過多症	羊水過多症
筋肉痛症状	筋肉痛	筋肉痛
心外膜石灰化	心膜石灰化	心膜石灰化
右下肢急性動脈閉塞症	下肢急性動脈閉塞症	下肢急性動脈閉塞症
４型進行胃癌	胃進行癌	胃進行癌
貧血性網膜症	貧血網膜症	貧血網膜症
カルチノイド腫瘍	カルチノイド	カルチノイド
仙骨奇形	仙骨部奇形	仙骨部奇形
左胸膜炎	胸膜炎	胸膜炎
歩行時呼吸困難	労作時呼吸困難	労作時呼吸困難
自律神経ニューロパチー	自律神経性ニューロパチー	自律神経性ニューロパチー
右原発閉塞隅角緑内障	原発閉塞隅角緑内障	原発閉塞隅角緑内障
両下肢浮腫軽度	下肢浮腫	下肢浮腫
体力低下著明	体力低下	体力低下
左小脳陳旧性梗塞	陳旧性脳梗塞	陳旧性脳梗塞
発赤局面	発赤	発赤
左股関節脱臼	股関節脱臼	股関節脱臼
ルーフ゜ス腎炎	ループス腎炎	ループス腎炎
鼠径部腫脹	鼡径部腫脹	鼡径部腫脹
内鼠径ヘルニア	内鼡径ヘルニア	内鼡径ヘルニア
左頬部血管腫	頬部血管腫	頬部血管腫
変形性関節炎	変形性関節症	変形性関節症
洞性頻脈	洞頻脈	洞頻脈
腹膜播種巣	腹膜播種	腹膜播種
アレルギ—性結膜炎	アレルギー性結膜炎	アレルギー性結膜炎
左大腿有棘細胞癌	大腿有棘細胞癌	大腿有棘細胞癌
右顎関節症	顎関節症	顎関節症
中枢神経浸潤	中枢神経系損傷	中枢神経系損傷
失見当障害	見当識障害	見当識障害
特発性血小板減少症紫斑病	特発性血小板減少性紫斑病	特発性血小板減少性紫斑病
痙攣様	痙攣	痙攣
股関節部骨折	股関節骨折	股関節骨折
吸収不全症侯群	吸収不良症候群	吸収不良症候群
甲状腺低下症	甲状腺機能低下症	甲状腺機能低下症
頭部皮膚欠損	頭部皮膚欠損創	頭部皮膚欠損創
傍大動脈リンパ節転移	大動脈周囲リンパ節転移	大動脈周囲リンパ節転移
ビタミンＤ欠乏	ビタミンＤ欠乏症	ビタミンＤ欠乏症
温痛覚	温痛覚過敏	温痛覚過敏
腎瘢痕	瘢痕	瘢痕
孤立性左室緻密化障害	孤立性心筋緻密化障害	孤立性心筋緻密化障害
左手関節痛	手関節痛	手関節痛
右鼠径部腫脹	鼡径部腫脹	鼡径部腫脹
発赤軽減	発赤	発赤
悪寒等	悪寒	悪寒
リステリア感染症	リステリア症	リステリア症
鼠径部リンパ節腫大	鼡径部リンパ節腫脹	鼡径部リンパ節腫脹
右鼡径部リンパ節腫脹	鼡径部リンパ節腫脹	鼡径部リンパ節腫脹
右腋窩リンパ節転位	腋窩リンパ節転移	腋窩リンパ節転移
両側乳房腫瘤	乳房腫瘤	乳房腫瘤
後腹膜脂胞肉腫	後腹膜脂肪肉腫	後腹膜脂肪肉腫
胆管閉塞機転	胆管閉塞症	胆管閉塞症
右下葉原発扁平上皮癌	下葉肺扁平上皮癌	下葉肺扁平上皮癌
腰椎圧迫骨折既往	腰椎圧迫骨折	腰椎圧迫骨折
便秘悪化	便秘症	便秘症
肺動脈分岐部狭窄	肺動脈分岐部狭窄症	肺動脈分岐部狭窄症
右鼡径リンパ節腫脹	鼡径部リンパ節腫脹	鼡径部リンパ節腫脹
左足多趾症	多趾症	多趾症
不安感	不安障害	不安障害
膿胸合併肺放線菌症	肺放線菌症	肺放線菌症
チクチク痛む	チクチク感	チクチク感
左水尿管症	水尿管症	水尿管症
右顔面打撲	顔面打撲傷	顔面打撲傷
分破水	破水	破水
重症マイコプラズマ肺炎	マイコプラズマ肺炎	マイコプラズマ肺炎
卵巣嚢腫破裂	卵巣のう腫破裂	卵巣のう腫破裂
過換気症状	過換気症	過換気症
上右卵管留血腫	卵管留血腫	卵管留血腫
濾胞性リンパ腫再発	濾胞性リンパ腫	濾胞性リンパ腫
左外傷性大腿骨頭壊死	外傷性大腿骨頭壊死	外傷性大腿骨頭壊死
腋窩痛	腋窩部痛	腋窩部痛
右アスペルギルス肺炎	肺アスペルギルス症	肺アスペルギルス症
洞結節不全症候群	洞不全症候群	洞不全症候群
両側腎膿瘍	腎膿瘍	腎膿瘍
右喉頭腫瘍	喉頭腫瘍	喉頭腫瘍
大動脈リンパ節転移	大動脈周囲リンパ節転移	大動脈周囲リンパ節転移
心内血栓	心内血栓症	心内血栓症
腰部脊椎管狭窄症	腰部脊柱管狭窄症	腰部脊柱管狭窄症
左総腸骨動脈狭窄	総腸骨動脈狭窄	総腸骨動脈狭窄
腫瘍制御	腫瘍	腫瘍
右上腕骨頸部骨折	上腕骨頚部骨折	上腕骨頚部骨折
リンハ゜節腫大	リンパ節腫大	リンパ節腫大
血栓閉塞型大動脈解離	早期血栓閉鎖型大動脈解離	早期血栓閉鎖型大動脈解離
小腸型クローン病	小腸クローン病	小腸クローン病
右顔面疼痛	顔面痛	顔面痛
便失禁多量	便失禁	便失禁
右小指基節骨骨折	小指基節骨骨折	小指基節骨骨折
右足背腫脹	足背腫脹	足背腫脹
右大腿痛	大腿痛	大腿痛
紫斑	紫斑病	紫斑病
顆粒膜細胞腫	卵巣顆粒膜細胞腫	卵巣顆粒膜細胞腫
意識障害患者	意識障害	意識障害
切迫早産腹緊	切迫早産	切迫早産
発赤範囲	発赤	発赤
左腕腫脹	前腕腫脹	前腕腫脹
右麻痺	片麻痺	片麻痺
味覚変化	味覚障害	味覚障害
浮腫悪化	浮腫	浮腫
左頭頂葉神経膠腫	頭頂葉神経膠腫	頭頂葉神経膠腫
骨盤内多発リンパ節転移	骨盤内リンパ節転移	骨盤内リンパ節転移
運動ニューロン病	運動ニューロン疾患	運動ニューロン疾患
肺犬糸状虫症	犬糸状虫症	犬糸状虫症
疲労感少	疲労感	疲労感
皮膚損傷リスク	皮膚損傷	皮膚損傷
左母指痛	母指痛	母指痛
間質性肺炎発症	間質性肺炎	間質性肺炎
右環指基節骨骨折	環指基節骨骨折	環指基節骨骨折
両側錐体路障害	錐体路障害	錐体路障害
下肢血流障害	下肢血行障害	下肢血行障害
結核性肋膜炎	結核性胸膜炎	結核性胸膜炎
疼痛有	疼痛	疼痛
骨盤部リンパ節転移	骨盤内リンパ節転移	骨盤内リンパ節転移
左三叉神経帯状疱疹	三叉神経帯状疱疹	三叉神経帯状疱疹
間質性肺炎悪化	間質性肺炎	間質性肺炎
仙骨部骨折	仙骨骨折	仙骨骨折
関節炎悪化	関節炎	関節炎
右尖足	尖足	尖足
左主気管支狭窄	気管支狭窄症	気管支狭窄症
仮性膵嚢胞	仮性膵のう胞	仮性膵のう胞
除皮質硬直様	除皮質硬直	除皮質硬直
間歇跛行	間欠性跛行	間欠性跛行
紅斑散在	紅斑症	紅斑症
食思不振傾向	食欲不振	食欲不振
不整脈誘発	不整脈	不整脈
胃潰瘍再発	胃潰瘍瘢痕	胃潰瘍瘢痕
胆石膵炎	胆石性膵炎	胆石性膵炎
右腕頭動脈瘤	腕頭動脈瘤	腕頭動脈瘤
肺癌性リンパ管症	癌性リンパ管症	癌性リンパ管症
左上腕骨顆部骨折	上腕骨顆部骨折	上腕骨顆部骨折
大腿骨骨折後	大腿骨骨折	大腿骨骨折
下顎腫脹	下顎部腫脹	下顎部腫脹
鼻中隔弯曲	鼻中隔弯曲症	鼻中隔弯曲症
逆流性食道炎無	逆流性食道炎	逆流性食道炎
致死性偽膜性腸炎	偽膜性腸炎	偽膜性腸炎
眼窩蜂窩織炎	眼窩蜂巣炎	眼窩蜂巣炎
排尿後痛	排尿痛	排尿痛
左下葉扁平上皮癌	下葉肺扁平上皮癌	下葉肺扁平上皮癌
右前頭葉膠芽腫	前頭葉膠芽腫	前頭葉膠芽腫
活動性肺結核所見	活動性肺結核	活動性肺結核
本日胸痛	胸痛	胸痛
直腸膀膀胱窩	直腸膀胱瘻	直腸膀胱瘻
左橈骨遠位骨折	橈骨遠位端骨折	橈骨遠位端骨折
しびれない	しびれ感	しびれ感
両側肺動脈血栓塞栓症	肺動脈血栓塞栓症	肺動脈血栓塞栓症
左胸膜播種	胸膜播種	胸膜播種
左鼡径部腫脹	鼡径部腫脹	鼡径部腫脹
皮下出血斑	皮下出血	皮下出血
両下肢腫脹	下肢腫脹	下肢腫脹
左傍矢状洞髄膜腫	傍矢状洞髄膜腫	傍矢状洞髄膜腫
右小脳腫瘍	小脳腫瘍	小脳腫瘍
続発性サルコペニア	サルコペニア	サルコペニア
右肩周囲炎	肩周囲炎	肩周囲炎
左ポスナーシュロスマン症候群	ポスナーシュロスマン症候群	ポスナーシュロスマン症候群
癌性胸腹膜炎	癌性腹膜炎	癌性腹膜炎
心臓内腫瘍	心臓腫瘍	心臓腫瘍
左坐骨神経麻痺	坐骨神経麻痺	坐骨神経麻痺
リステリア髄膜脳炎	リステリア性髄膜脳炎	リステリア性髄膜脳炎
点圧痛	圧痛	圧痛
喉頭嚢胞	喉頭のう胞	喉頭のう胞
甲状腺乳頭腺癌	甲状腺乳頭癌	甲状腺乳頭癌
圧迫性骨折	圧迫骨折	圧迫骨折
縱隔リンパ節転移	縦隔リンパ節転移	縦隔リンパ節転移
アレルギー性肺アスペルギルス症	アレルギー性気管支肺アスペルギルス症	アレルギー性気管支肺アスペルギルス症
トルーソー症候群	トルソー症候群	トルソー症候群
全身浮腫不変	全身性浮腫	全身性浮腫
周術期喘息発作	気管支喘息発作	気管支喘息発作
巣状分節状糸球体硬化症	巣状糸球体硬化症	巣状糸球体硬化症
口腔乾燥感	口腔乾燥症	口腔乾燥症
アシドーシス進行	アシドーシス	アシドーシス
第５胸椎転移	胸椎転移	胸椎転移
表出性言語発達遅滞	言語発達遅滞	言語発達遅滞
発作性心房細動既往	発作性心房細動	発作性心房細動
左リウマチ性膝関節症	関節リウマチ・膝関節	関節リウマチ・膝関節
倦怠感等	倦怠感	倦怠感
筋攣縮	筋痙縮	筋痙縮
特発性側彎症	特発性側弯症	特発性側弯症
右眼球破裂	眼球破裂	眼球破裂
右葉間胸水	葉間胸水	葉間胸水
子宮内膜症性卵巣嚢胞	卵巣子宮内膜症のう胞	卵巣子宮内膜症のう胞
左硝子体混濁	硝子体混濁	硝子体混濁
統合失調症既往	統合失調症	統合失調症
皮膚潰瘍形成	皮膚潰瘍	皮膚潰瘍
元々不眠症	不眠症	不眠症
左肩甲骨軟骨肉腫	肩甲骨軟骨肉腫	肩甲骨軟骨肉腫
肺血症性ショック	敗血症性ショック	敗血症性ショック
ＡＣＴＨ分泌不全	ＡＣＴＨ分泌低下症	ＡＣＴＨ分泌低下症
時々残尿感	残尿感	残尿感
マルファン症候群合併	マルファン症候群	マルファン症候群
咽喉頭炎	咽頭喉頭炎	咽頭喉頭炎
右下葉肺扁平上皮癌	下葉肺扁平上皮癌	下葉肺扁平上皮癌
潰瘍型間質性膀胱炎	間質性膀胱炎	間質性膀胱炎
遺尿	遺尿症	遺尿症
左中頭蓋窩髄膜腫	中頭蓋窩髄膜腫	中頭蓋窩髄膜腫
含歯性嚢胞	含歯性のう胞	含歯性のう胞
右重症下肢虚血	重症虚血肢	重症虚血肢
重症強迫性障害	強迫性障害	強迫性障害
左椎間板ヘルニア	椎間板ヘルニア	椎間板ヘルニア
左膝関節偽痛風	膝関節偽痛風	膝関節偽痛風
悪性リンハ゜腫	悪性リンパ腫	悪性リンパ腫
胆管腫瘍栓	胆管腫瘍	胆管腫瘍
白内障Ｏ	白内障	白内障
心房細動停止	心房細動	心房細動
帯状疱疹既往	帯状疱疹	帯状疱疹
腫瘤所見	腫瘤	腫瘤
時折血痰	血痰	血痰
糖尿病等	糖尿病	糖尿病
後腹膜腫瘍切除術	後腹膜腫瘍	後腹膜腫瘍
右中咽頭癌	中咽頭癌	中咽頭癌
疲労感等	疲労感	疲労感
前交通動脈未破裂脳動脈瘤	未破裂脳動脈瘤	未破裂脳動脈瘤
夜間低酸素血症	低酸素血症	低酸素血症
薬剤性腎不全	薬剤性腎障害	薬剤性腎障害
気管支狭窄	気管支狭窄症	気管支狭窄症
腫瘍増悪	腫瘍	腫瘍
癌性髄膜腫症	悪性髄膜腫	悪性髄膜腫
化膿性脊椎椎間板炎	化膿性椎間板炎	化膿性椎間板炎
真菌塊	真菌症	真菌症
左横隔膜神経麻痺	横隔神経麻痺	横隔神経麻痺
先天性鼻咽腔閉鎖不全症	先天性鼻咽腔閉鎖不全	先天性鼻咽腔閉鎖不全
縦隔原発Ｂ細胞大細胞型リンパ腫	縦隔原発大細胞型Ｂ細胞性リンパ腫	縦隔原発大細胞型Ｂ細胞性リンパ腫
左半視野障害	視野障害	視野障害
慢性緑膿菌感染	緑膿菌感染症	緑膿菌感染症
虫刺症	蜂刺症	蜂刺症
上歯肉癌	上顎歯肉癌	上顎歯肉癌
超皮質性感覚性失語	皮質下感覚性失語症	皮質下感覚性失語症
肥厚性幽門狭窄	肥厚性幽門狭窄症	肥厚性幽門狭窄症
左眼結膜下出血	結膜下出血	結膜下出血
子宮頸部上皮内腫瘍	子宮頚部上皮内腫瘍	子宮頚部上皮内腫瘍
左腰部有棘細胞癌	腰部有棘細胞癌	腰部有棘細胞癌
糖尿病罹患	糖尿病	糖尿病
気分変動	気分変調症	気分変調症
左鎖骨下動脈起始異常	鎖骨下動脈起始異常	鎖骨下動脈起始異常
腰椎脊柱管狭窄	腰部脊柱管狭窄症	腰部脊柱管狭窄症
左上葉小細胞肺癌	上葉小細胞肺癌	上葉小細胞肺癌
左後縦隔腫瘍	後縦隔腫瘍	後縦隔腫瘍
尿閉気味	尿閉	尿閉
右肘関節骨折	肘関節骨折	肘関節骨折
両耳下腺腫脹	耳下腺腫脹	耳下腺腫脹
両変形性股関節症	変形性股関節症	変形性股関節症
左肺良性腫瘍	肺良性腫瘍	肺良性腫瘍
若年結核性腹膜炎	結核性腹膜炎	結核性腹膜炎
発赤部分	発赤	発赤
急性冠症候群発症	急性冠症候群	急性冠症候群
左化膿性耳下腺炎	化膿性耳下腺炎	化膿性耳下腺炎
痔核症状	痔核	痔核
拘束性心筋症	拘束型心筋症	拘束型心筋症
浮腫軽減	浮腫	浮腫
膠原病外来	膠原病	膠原病
膀胱内尿貯留	後腹膜尿貯留	後腹膜尿貯留
肺結核性腹膜炎	結核性腹膜炎	結核性腹膜炎
ネフローゼ状態	ネフローゼ症候群	ネフローゼ症候群
軽度僧帽弁逆流症	僧帽弁逆流症	僧帽弁逆流症
しびれがきつい	しびれ感	しびれ感
完全右脚ブロック指摘	完全右脚ブロック	完全右脚ブロック
アレルギ—性鼻炎	アレルギー性鼻炎	アレルギー性鼻炎
右顎下リンパ節腫脹	顎下リンパ節腫脹	顎下リンパ節腫脹
左側頭葉海綿状血管腫	側頭葉海綿状血管腫	側頭葉海綿状血管腫
膵炎再燃	膵炎	膵炎
失見当識障害	見当識障害	見当識障害
非定型うつ	非定型うつ病	非定型うつ病
右中指スワンネック変形肩関節	スワンネック変形	スワンネック変形
胸郭運動異常	胸郭異常	胸郭異常
前頭蓋底腫瘍	頭蓋底腫瘍	頭蓋底腫瘍
動脈瘤様骨嚢腫	動脈瘤様骨のう腫	動脈瘤様骨のう腫
軽度間歇性跛行	間欠性跛行	間欠性跛行
尺側神経麻痺	尺骨神経麻痺	尺骨神経麻痺
徐脈等	徐脈	徐脈
サルコイドーシス疑	サルコイドーシス	サルコイドーシス
左片麻痺	片麻痺	片麻痺
関節固縮	関節拘縮	関節拘縮
下顎骨正中部骨折	下顎正中部骨折	下顎正中部骨折
悪心Ｇ１	悪心	悪心
上腹部鈍痛	上腹部痛	上腹部痛
性急性リンパ性白血病	急性リンパ性白血病	急性リンパ性白血病
周囲リンパ節腫大	リンパ節腫大	リンパ節腫大
左外耳道閉鎖	外耳道閉鎖	外耳道閉鎖
醜形恐怖	醜形恐怖症	醜形恐怖症
播種性クリプトコックス症	播種性クリプトコッカス症	播種性クリプトコッカス症
多発嚢胞腎	多発性のう胞腎	多発性のう胞腎
嘔吐１回	嘔吐症	嘔吐症
過敏症状	過敏症	過敏症
右足小指骨折	小指骨折	小指骨折
せん妄発言	せん妄	せん妄
ヒステリー症状	ヒステリー反応	ヒステリー反応
歩行時創部痛	術創部痛	術創部痛
パニック	パニック障害	パニック障害
両肺胸膜肥厚	胸膜肥厚	胸膜肥厚
両眼瞼黄色腫	眼瞼黄色腫	眼瞼黄色腫
正中頚嚢胞	正中頚のう胞	正中頚のう胞
高血圧状態	高血圧症	高血圧症
指発赤	発赤	発赤
左副腎出血	副腎出血	副腎出血
急性前壁中隔梗塞	急性前壁中隔心筋梗塞	急性前壁中隔心筋梗塞
右顔面部帯状疱疹	顔面帯状疱疹	顔面帯状疱疹
びまん性管内増殖性糸球体腎炎	慢性びまん性管内増殖性糸球体腎炎	慢性びまん性管内増殖性糸球体腎炎
左上腕脂肪腫	上腕脂肪腫	上腕脂肪腫
冠動脈狭窄症	冠状動脈狭窄症	冠状動脈狭窄症
膵石灰化	膵石灰化症	膵石灰化症
丘疹様	丘疹	丘疹
肺上葉原発性肺癌	原発性肺癌	原発性肺癌
労作時胸部不快	労作時呼吸困難	労作時呼吸困難
２型＋ステロイド性糖尿病	ステロイド糖尿病	ステロイド糖尿病
水中毒症状	水中毒	水中毒
鼻中隔彎曲	鼻中隔弯曲症	鼻中隔弯曲症
過敏性腸症侯群	過敏性腸症候群	過敏性腸症候群
胆管内結石	胆管結石症	胆管結石症
術後右反回神経麻痺	術後性反回神経麻痺	術後性反回神経麻痺
皮膚軟部組織感染症	皮膚感染症	皮膚感染症
イレウス合併	イレウス	イレウス
肺好酸球性肉芽腫	肺好酸球性肉芽腫症	肺好酸球性肉芽腫症
両側性結核性胸膜炎	結核性胸膜炎	結核性胸膜炎
甲状腺機能亢進症状	甲状腺機能亢進症	甲状腺機能亢進症
薬剤性過敏症候群	薬剤性過敏症症候群	薬剤性過敏症症候群
両側喉頭肉芽腫	喉頭肉芽腫	喉頭肉芽腫
ポリープ数個	ポリープ	ポリープ
右低音障害型感音難聴	急性低音障害型感音難聴	急性低音障害型感音難聴
右聴神経腫瘍	聴神経腫瘍	聴神経腫瘍
多発髄膜腫	多発性髄膜腫	多発性髄膜腫
先天性嚢胞肺	先天性のう胞肺	先天性のう胞肺
手背部疼痛	手背部痛	手背部痛
腹部大動脈嚢状瘤	腹部大動脈瘤	腹部大動脈瘤
葉酸欠乏	葉酸欠乏症	葉酸欠乏症
浮腫残存	浮腫	浮腫
鼻口蓋管嚢胞	鼻口蓋管のう胞	鼻口蓋管のう胞
過形成性ポリープ	胃過形成ポリープ	胃過形成ポリープ
重度三尖弁閉鎖不全症	三尖弁閉鎖不全症	三尖弁閉鎖不全症
第二度房室ブロック	第２度房室ブロック	第２度房室ブロック
白血病化	白血病	白血病
残尿	残尿感	残尿感
ループスアンチコアグラント陰性	ループスアンチコアグラント	ループスアンチコアグラント
右肺胸水貯留	胸水貯留	胸水貯留
両側腓骨神経麻痺	腓骨神経麻痺	腓骨神経麻痺
軽度右室肥大	右室肥大	右室肥大
２型＋ステロイド糖尿病	ステロイド糖尿病	ステロイド糖尿病
左下肢ガス壊疽	ガス壊疽	ガス壊疽
低血糖用	低血糖	低血糖
右足底潰瘍	足底皮膚潰瘍	足底皮膚潰瘍
右網膜静脈分枝閉塞症	網膜静脈分枝閉塞症	網膜静脈分枝閉塞症
腹痛時	腹痛症	腹痛症
多動多弁	多動性障害	多動性障害
食思不振症状	食欲不振	食欲不振
開大代謝性アシドーシス	代謝性アシドーシス	代謝性アシドーシス
心因性過食症	心因性過食	心因性過食
転移性腫瘤	転移性腫瘍	転移性腫瘍
夜間尿意	夜間頻尿症	夜間頻尿症
右下腿腫脹	下腿腫脹	下腿腫脹
背部皮脂欠乏性湿疹	皮脂欠乏性湿疹	皮脂欠乏性湿疹
足爪白鮮	足爪白癬	足爪白癬
末梢循環不全徴候	末梢循環不全	末梢循環不全
眼瞼下垂自覚	眼瞼下垂症	眼瞼下垂症
右上顎洞乳頭腫	上顎洞乳頭腫	上顎洞乳頭腫
帯状疱疹拡大	帯状疱疹	帯状疱疹
胆嚢多発ポリープ	胆のうポリープ	胆のうポリープ
浮腫状	浮腫	浮腫
十二指腸多発びらん	十二指腸びらん	十二指腸びらん
前立性肥大症	前立腺肥大症	前立腺肥大症
嘔気状況	嘔気	嘔気
両側眼球外転障害	眼球運動障害	眼球運動障害
左小脳出血	小脳出血	小脳出血
躁うつ	躁うつ病	躁うつ病
ベージェット病	ベーチェット病	ベーチェット病
両側総腸骨動脈狭窄	総腸骨動脈狭窄	総腸骨動脈狭窄
牽引痛	牽引性頭痛	牽引性頭痛
ダンピング症候群併発	ダンピング症候群	ダンピング症候群
ループスアンチコアグラント陽性	ループスアンチコアグラント	ループスアンチコアグラント
右気管支肺炎	気管支肺炎	気管支肺炎
両難聴	難聴	難聴
左腎細胞癌	腎細胞癌	腎細胞癌
膠原病由来	膠原病	膠原病
悪性リンパ腫既往	悪性リンパ腫	悪性リンパ腫
腎臓疾患	腎疾患	腎疾患
右眼網膜裂孔	網膜裂孔	網膜裂孔
食道圧迫	食道圧迫症	食道圧迫症
両足関節痛	足関節痛	足関節痛
朝低血糖	低血糖	低血糖
子宮筋腫有	子宮筋腫	子宮筋腫
浮腫生	浮腫	浮腫
左自然気胸再発	自然気胸	自然気胸
右大腿骨骨肉腫	大腿骨骨肉腫	大腿骨骨肉腫
左腎盂腎炎治癒後	腎盂腎炎	腎盂腎炎
ウィルス感染症	ウイルス感染症	ウイルス感染症
左手尺骨神経麻痺	尺骨神経麻痺	尺骨神経麻痺
周期性呼吸時折	周期性呼吸	周期性呼吸
糖尿病用	糖尿病	糖尿病
術前心電図異常	心電図異常	心電図異常
中耳炎症状	中耳炎	中耳炎
趾爪囲炎	爪囲炎	爪囲炎
挙上期誤嚥	異物誤嚥	異物誤嚥
腹部膨満増強	腹部膨満	腹部膨満
右副腎腫瘍摘出術	副腎腫瘍	副腎腫瘍
右鎖骨痛	鎖骨痛	鎖骨痛
左歯性上顎洞炎	歯性上顎洞炎	歯性上顎洞炎
骨髄異型性症候群	骨髄異形成症候群	骨髄異形成症候群
光線過敏	光線過敏症	光線過敏症
虚脱病変	虚脱	虚脱
慢性アレルギー性鼻炎	季節性アレルギー性鼻炎	季節性アレルギー性鼻炎
発熱下	発熱	発熱
失見当識発言	見当識障害	見当識障害
右眼内悪性リンパ腫	眼窩悪性リンパ腫	眼窩悪性リンパ腫
右季肋部自発痛	季肋部痛	季肋部痛
右手舟状骨骨折	手舟状骨骨折	手舟状骨骨折
頚椎脊柱管狭窄症	頚部脊柱管狭窄症	頚部脊柱管狭窄症
発赤域	発赤	発赤
左下肢冷感	下肢冷感	下肢冷感
胸骨肋骨転移	肋骨転移	肋骨転移
重症心身障害児	重症心身障害	重症心身障害
腹部軽度膨隆	腹部膨満	腹部膨満
放射線障害	放射線宿酔	放射線宿酔
右下肢深部静脈血栓症	下肢静脈血栓症	下肢静脈血栓症
カテーテル感染	カテーテル感染症	カテーテル感染症
腫瘍多発	腫瘍	腫瘍
しびれてる感	しびれ感	しびれ感
脳腫瘍切除	脳腫瘍	脳腫瘍
高血糖是正	高血糖症	高血糖症
病原性大腸菌	病原性大腸菌感染症	病原性大腸菌感染症
全身性紫斑	全身性紫斑病	全身性紫斑病
微小多発脳梗塞	多発性脳梗塞	多発性脳梗塞
右股関節亜脱臼	股関節亜脱臼	股関節亜脱臼
左橈骨神経麻痺	橈骨神経麻痺	橈骨神経麻痺
全身性間代性痙攣	間代性痙攣	間代性痙攣
右肋間痛	肋間痛	肋間痛
右続発性緑内障	続発性緑内障	続発性緑内障
軟骨腫	骨軟骨腫	骨軟骨腫
軽度しびれ感	しびれ感	しびれ感
中枢性めまい	中枢性めまい症	中枢性めまい症
先天性風疹症侯群	先天性風疹症候群	先天性風疹症候群
椎骨動脈狭窄	椎骨動脈狭窄症	椎骨動脈狭窄症
活動性肺結核症	活動性肺結核	活動性肺結核
痙攣発作再発	痙攣発作	痙攣発作
顔面麻痺１	顔面神経麻痺	顔面神経麻痺
右足関節腫脹	足関節腫脹	足関節腫脹
イレウス発生	イレウス	イレウス
発作性３度房室ブロック	第３度房室ブロック	第３度房室ブロック
右大腿骨骨腫瘍	大腿骨腫瘍	大腿骨腫瘍
骨盤内膜症	骨盤子宮内膜症	骨盤子宮内膜症
右耳下腺腫瘤	耳下腺腫瘤	耳下腺腫瘤
肝形質細胞腫	形質細胞腫	形質細胞腫
易出血傾向	出血傾向	出血傾向
ジューリング疱疹状皮膚炎	ジューリング病	ジューリング病
部分性脂肪萎縮症	部分的脂肪萎縮症	部分的脂肪萎縮症
左卵巣膿瘍	卵巣膿瘍	卵巣膿瘍
サイトメガロウイルス感染	サイトメガロウイルス感染症	サイトメガロウイルス感染症
Ⅱ型糖尿病	２型糖尿病	２型糖尿病
両顎関節痛	顎関節痛	顎関節痛
逆流性胆管炎	逆行性胆管炎	逆行性胆管炎
空気塞栓	空気塞栓症	空気塞栓症
肝膿瘍破裂	肝膿瘍	肝膿瘍
総肺静脈還流異常症	肺静脈還流異常症	肺静脈還流異常症
両下腿痛	下腿痛	下腿痛
肺扁平上皮癌、病期不明	肺扁平上皮癌	肺扁平上皮癌
低血圧自覚症状	低血圧症	低血圧症
倦怠感増	倦怠感	倦怠感
陰茎アポクリン癌	陰茎アポクリン腺癌	陰茎アポクリン腺癌
元来月経痛	月経痛	月経痛
左側頬粘膜癌	頬粘膜癌	頬粘膜癌
アレルギー反応	アレルギー	アレルギー
愁訴	不定愁訴症	不定愁訴症
血腫不変	血腫	血腫
各種膠原病	膠原病	膠原病
亜脱臼傾向	亜脱臼	亜脱臼
自傷痕	自傷	自傷
嘔吐持続	嘔吐症	嘔吐症
左前頭葉神経膠腫	前頭葉神経膠腫	前頭葉神経膠腫
精神運動興奮	精神運動興奮状態	精神運動興奮状態
右尿管結石症	尿管結石症	尿管結石症
瞳孔不同	瞳孔不同症	瞳孔不同症
直腸Ｒａ癌	直腸癌	直腸癌
原発性アルドステロン	原発性アルドステロン症	原発性アルドステロン症
苔癬局面	苔癬	苔癬
僧帽弁狭窄兼逆流症	僧帽弁狭窄症	僧帽弁狭窄症
副甲状腺亢進症	副甲状腺機能亢進症	副甲状腺機能亢進症
右声帯不全麻痺	声帯不全麻痺	声帯不全麻痺
心合併症	心臓合併症	心臓合併症
労作時前胸部痛	前胸部痛	前胸部痛
肺炎等	肺炎	肺炎
新生児一過性多呼	新生児一過性多呼吸	新生児一過性多呼吸
左胸鎖乳突筋炎	胸鎖乳突筋炎	胸鎖乳突筋炎
腫瘍性	腫瘍	腫瘍
右結石性腎盂腎炎	結石性腎盂腎炎	結石性腎盂腎炎
心嚢液貯留	心膜液貯留	心膜液貯留
臓器限局性前立腺癌	限局性前立腺癌	限局性前立腺癌
右間歇性跛行	間欠性跛行	間欠性跛行
右腋窩リンパ節腫脹	腋窩リンパ節腫脹	腋窩リンパ節腫脹
爪甲剥離症	爪剥離症	爪剥離症
再度急性腎不全	急性腎不全	急性腎不全
耳閉塞感	耳閉感	耳閉感
胃小彎側ＬＮ転移	胃周囲リンパ節転移	胃周囲リンパ節転移
右先天性耳瘻孔	先天性耳瘻孔	先天性耳瘻孔
脂肪腫摘出	脂肪腫	脂肪腫
椎間板ヘルニア有	椎間板ヘルニア	椎間板ヘルニア
腸液貯留	体液貯留	体液貯留
両変形性膝関節症	変形性膝関節症	変形性膝関節症
内痔核脱出	内痔核	内痔核
呼気困難	呼吸困難	呼吸困難
重症鬱血性心不全	うっ血性心不全	うっ血性心不全
喘鳴聴取	喘鳴	喘鳴
左乳癌特	乳癌	乳癌
右頬部痛	頬部痛	頬部痛
右肺動静脈瘻	肺動静脈瘻	肺動静脈瘻
問題なし膀胱直腸障害	膀胱直腸障害	膀胱直腸障害
両側卵管留血腫	卵管留血腫	卵管留血腫
脱水注意	脱水症	脱水症
右飛蚊症	飛蚊症	飛蚊症
口腔内炎	口内炎	口内炎
全身倦怠感軽度	全身倦怠感	全身倦怠感
不安大	不安障害	不安障害
多発脳神経障害	多発性脳神経障害	多発性脳神経障害
右腎無形成	腎無形成	腎無形成
全身性細菌感染症	細菌感染症	細菌感染症
水頭症症状	水頭症	水頭症
統合失調症合併	統合失調症	統合失調症
右下肢運動障害	四肢運動障害	四肢運動障害
炎症性脱髄性多発根神経炎	慢性炎症性脱髄性多発神経炎	慢性炎症性脱髄性多発神経炎
過食症状	過食症	過食症
片側副腎腫瘍	副腎腫瘍	副腎腫瘍
胃食道静脈瘤破裂	食道静脈瘤破裂	食道静脈瘤破裂
左足背蜂窩織炎	足背蜂巣炎	足背蜂巣炎
右胸水貯留	胸水貯留	胸水貯留
疲労感生	疲労感	疲労感
両側腎腫大	腎腫大	腎腫大
右坐骨骨折	坐骨骨折	坐骨骨折
右耳下腺腫脹	耳下腺腫脹	耳下腺腫脹
先天性左股関節脱臼	先天性股関節脱臼	先天性股関節脱臼
鮮血痰	血痰	血痰
溶連菌感染	溶連菌感染症	溶連菌感染症
不整脈チーム	不整脈	不整脈
両上肢痛	上肢痛	上肢痛
右上腕骨近位端粉砕骨折	上腕骨近位端粉砕骨折	上腕骨近位端粉砕骨折
膀胱腫瘍再発	膀胱腫瘍	膀胱腫瘍
クッシング徴候	クッシング症候群	クッシング症候群
左下葉肺癌	下葉肺癌	下葉肺癌
腰部腫瘍	腰椎部腫瘍	腰椎部腫瘍
鼠径ヘルニア	鼡径ヘルニア	鼡径ヘルニア
侵襲性肺アスペルギウス症	侵襲性肺アスペルギルス症	侵襲性肺アスペルギルス症
軽度左軸偏位	心電図左軸偏位	心電図左軸偏位
脳室拡大進行	脳室拡大	脳室拡大
腎盂軽度拡張	腎盂拡張	腎盂拡張
腫瘍指摘	腫瘍	腫瘍
心臓原発性悪性リンパ腫	心臓悪性リンパ腫	心臓悪性リンパ腫
左膝窩部痛	膝窩部痛	膝窩部痛
両上肢痺れ	上肢しびれ	上肢しびれ
脳梗塞有	脳梗塞	脳梗塞
痕発赤	発赤	発赤
左上腕骨肉腫	上腕骨骨肉腫	上腕骨骨肉腫
下肢冷感軽度	下肢冷感	下肢冷感
左室内同期不全	左室不全	左室不全
漿液性腺腫	卵巣漿液性腺腫	卵巣漿液性腺腫
日本海裂頭条虫	日本海裂頭条虫症	日本海裂頭条虫症
心室中隔扁平化	心室中隔欠損症	心室中隔欠損症
肝芽腫再発	肝芽腫	肝芽腫
右下腿疼痛	下腿痛	下腿痛
軽度眼球突出	眼球突出症	眼球突出症
肺門部リンパ節腫大	肺門リンパ節腫脹	肺門リンパ節腫脹
心膜播種	腹膜播種	腹膜播種
髄液播種	腹膜播種	腹膜播種
左腎動脈狭窄症	腎動脈狭窄症	腎動脈狭窄症
体動時創部痛	術創部痛	術創部痛
左退形成性星細胞腫	退形成性星細胞腫	退形成性星細胞腫
仮性動脈瘤切除	偽性動脈瘤	偽性動脈瘤
不定愁訴多	不定愁訴症	不定愁訴症
気道狭窄音	気道狭窄	気道狭窄
左視床出血	視床出血	視床出血
左耳後部腫瘤	耳後部腫瘤	耳後部腫瘤
左尿管結石性腎盂腎炎	結石性腎盂腎炎	結石性腎盂腎炎
筋力低下可能性	筋力低下	筋力低下
咽喉頭違和感	咽喉頭異常感症	咽喉頭異常感症
前立腺癌死	前立腺癌	前立腺癌
左肩腱板損傷	肩腱板損傷	肩腱板損傷
左肺動脈狭窄症	肺動脈狭窄症	肺動脈狭窄症
肺動脈弁上狭窄	肺動脈弁上狭窄症	肺動脈弁上狭窄症
偽粘液腫	粘液腫	粘液腫
毛包向性菌状息肉症	菌状息肉症	菌状息肉症
左下肢鬱滞性皮膚炎	うっ滞性皮膚炎	うっ滞性皮膚炎
進行性核上麻痺	進行性核上性麻痺	進行性核上性麻痺
えん下障害	嚥下障害	嚥下障害
左上腕悪性黒色腫	上腕部悪性黒色腫	上腕部悪性黒色腫
足痛い	足痛	足痛
境界性パーソナリティ障害	境界型パーソナリティ障害	境界型パーソナリティ障害
鼻骨折	鼻骨骨折	鼻骨骨折
左低形成腎	低形成腎	低形成腎
広範囲脊柱管狭窄症	広範脊柱管狭窄症	広範脊柱管狭窄症
顔面形成	顔面形成異常	顔面形成異常
急性肺動脈血栓塞栓症	肺動脈血栓塞栓症	肺動脈血栓塞栓症
両下肢深部静脈血栓症	下肢静脈血栓症	下肢静脈血栓症
右上腕骨近位端骨折	上腕骨近位端骨折	上腕骨近位端骨折
せん妄生	せん妄	せん妄
多発縦隔リンパ節転移	縦隔リンパ節転移	縦隔リンパ節転移
尿失禁状態	尿失禁症	尿失禁症
失語正常	失語症	失語症
失語持続	失語症	失語症
多発筋炎	多発性筋炎	多発性筋炎
呼吸促迫症状	呼吸促迫	呼吸促迫
大腿骨骨頭壊死	大腿骨頭壊死	大腿骨頭壊死
サイトメガロ網膜炎	サイトメガロウイルス網膜炎	サイトメガロウイルス網膜炎
緑膿菌腸炎	緑膿菌性腸炎	緑膿菌性腸炎
原発不明癌頸部転移	原発不明癌	原発不明癌
発熱中	発熱	発熱
右錐体路障害	錐体路障害	錐体路障害
両下肢筋痛	下肢筋肉痛	下肢筋肉痛
難治性冠攣縮性狭心症	冠攣縮性狭心症	冠攣縮性狭心症
眼白内障	白内障	白内障
喀痰付着	喀痰	喀痰
心肺停止後蘇生	心肺停止	心肺停止
症候性てんかん発症	症候性てんかん	症候性てんかん
左腎血管腫	腎血管腫	腎血管腫
両側副腎腫瘍	副腎腫瘍	副腎腫瘍
左顔面神経麻痺症状	顔面神経麻痺	顔面神経麻痺
嚥下時疼痛	嚥下痛	嚥下痛
大腸ポリープ後	大腸ポリープ	大腸ポリープ
右下葉扁平上皮癌	下葉肺扁平上皮癌	下葉肺扁平上皮癌
門脈圧亢進	門脈圧亢進症	門脈圧亢進症
ノカルジア	ノカルジア症	ノカルジア症
右人工膝関節感染	人工膝関節感染	人工膝関節感染
左横隔膜弛緩症	横隔膜弛緩症	横隔膜弛緩症
尿管結石有	尿管結石症	尿管結石症
冠攣縮型狭心症	冠攣縮性狭心症	冠攣縮性狭心症
血液凝固障害	血液凝固異常	血液凝固異常
低酸素虚血性脳症	低酸素性脳症	低酸素性脳症
左大葉性肺炎	大葉性肺炎	大葉性肺炎
足底湿疹	足湿疹	足湿疹
多発肝血管腫	多発性肝血管腫	多発性肝血管腫
気管支閉鎖症	気管支閉鎖	気管支閉鎖
夜疼痛	疼痛	疼痛
多発性リンパ節転移	多部位リンパ節転移	多部位リンパ節転移
クリオグロブリン性血管炎	クリオグロブリン血症性血管炎	クリオグロブリン血症性血管炎
右頬部擦過傷	頬部擦過創	頬部擦過創
ＥＢウイルス初感染	ＥＢウイルス感染症	ＥＢウイルス感染症
急性膵臓炎	急性膵炎	急性膵炎
視神経脊髄炎（ＮＭＯ）	視神経脊髄炎	視神経脊髄炎
左下副甲状腺腺腫	副甲状腺腺腫	副甲状腺腺腫
左頬部有棘細胞癌	頬部有棘細胞癌	頬部有棘細胞癌
左踵骨骨折	踵骨骨折	踵骨骨折
小腸静脈瘤破裂	食道静脈瘤破裂	食道静脈瘤破裂
右上肢振戦	一側上肢振戦	一側上肢振戦
右膀胱側壁部膀胱癌	膀胱側壁部膀胱癌	膀胱側壁部膀胱癌
子宮頸部頸管狭窄	子宮頚管狭窄症	子宮頚管狭窄症
脊椎管狭窄症	脊柱管狭窄症	脊柱管狭窄症
左前庭障害	前庭障害	前庭障害
両膝関節症	膝関節症	膝関節症
類もやもや病	もやもや病	もやもや病
左足関節開放性脱臼骨折	足関節開放性脱臼骨折	足関節開放性脱臼骨折
右卵巣奇形腫	卵巣奇形腫	卵巣奇形腫
感冒罹患	感冒	感冒
血腫像	血腫	血腫
慢性血栓性肺高血圧症	慢性血栓塞栓性肺高血圧症	慢性血栓塞栓性肺高血圧症
眼振誘発	眼振	眼振
労作時呼吸困難感軽度	労作時呼吸困難	労作時呼吸困難
逆流性食道炎症状	逆流性食道炎	逆流性食道炎
子宮筋腫大	子宮筋腫	子宮筋腫
肺塞栓既往	肺塞栓症	肺塞栓症
左肺下葉扁平上皮癌	下葉肺扁平上皮癌	下葉肺扁平上皮癌
高度拘束性換気障害	拘束性換気障害	拘束性換気障害
ＭＲＳＡ感染	ＭＲＳＡ感染症	ＭＲＳＡ感染症
肝多発腫瘤	肝腫瘤	肝腫瘤
左大腿骨病的骨折	大腿骨病的骨折	大腿骨病的骨折
耳痛	耳痛症	耳痛症
内頸動脈狭窄	内頚動脈狭窄症	内頚動脈狭窄症
大動脈損傷	上大動脈損傷	上大動脈損傷
脊椎管狭窄	脊柱管狭窄症	脊柱管狭窄症
顔面神経麻痺静的再建	顔面神経麻痺	顔面神経麻痺
腫瘤構造	腫瘤	腫瘤
右大腿部蜂窩織炎	大腿部蜂巣炎	大腿部蜂巣炎
膿性喀痰	膿性痰	膿性痰
胆汁うっ滞型	胆汁うっ滞	胆汁うっ滞
両膝関節疼痛	膝関節痛	膝関節痛
緑内症	緑内障	緑内障
心窩部自発痛	心窩部痛	心窩部痛
リンパ節腫大傾向	リンパ節腫大	リンパ節腫大
右中大脳動脈閉塞症	中大脳動脈閉塞症	中大脳動脈閉塞症
右尿管損傷	尿管損傷	尿管損傷
感染性心内膜症	感染性心内膜炎	感染性心内膜炎
播種性血管内凝固症	播種性血管内凝固	播種性血管内凝固
肺野肺門部異常陰影	肺門部異常陰影	肺門部異常陰影
右下腿コンパートメント症候群	下腿コンパートメント症候群	下腿コンパートメント症候群
右鎖骨上窩リンパ節腫大	鎖骨上リンパ節腫脹	鎖骨上リンパ節腫脹
右鼡径部腫脹	鼡径部腫脹	鼡径部腫脹
両側卵巣チョコレート嚢胞	チョコレートのう胞	チョコレートのう胞
脂質異常	脂質異常症	脂質異常症
２型大腸癌	大腸癌	大腸癌
左大腿骨骨腫瘍	大腿骨腫瘍	大腿骨腫瘍
膵管内乳頭粘液腫瘍	膵管内乳頭粘液性腫瘍	膵管内乳頭粘液性腫瘍
胃癌多発骨転移	胃癌骨転移	胃癌骨転移
左膝窩動脈瘤	膝窩動脈瘤	膝窩動脈瘤
アルコール性ニューロパチー	アルコール性多発ニューロパチー	アルコール性多発ニューロパチー
鎖骨上リンパ節腫大	鎖骨上リンパ節腫脹	鎖骨上リンパ節腫脹
右大腿ヘルニア嵌頓	大腿ヘルニア嵌頓	大腿ヘルニア嵌頓
感染性腹部動脈瘤	感染性腹部大動脈瘤	感染性腹部大動脈瘤
右胸膜播種	胸膜播種	胸膜播種
骨折病変	骨折	骨折
半月体形成糸球体腎炎	半月体形成性糸球体腎炎	半月体形成性糸球体腎炎
筋力低下著明	筋力低下	筋力低下
嘔吐出現	嘔吐症	嘔吐症
低血糖生	低血糖	低血糖
劇症型肺炎球菌性敗血症	肺炎球菌性敗血症	肺炎球菌性敗血症
発熱有	発熱	発熱
不眠考	不眠症	不眠症
全失語	全失語症	全失語症
脳幹部神経膠腫	脳幹神経膠腫	脳幹神経膠腫
気管性喘息	気管支喘息	気管支喘息
骨粗鬆症有	骨粗鬆症	骨粗鬆症
左深部静脈血栓症	深部静脈血栓症	深部静脈血栓症
多発胸膜肥厚斑	胸膜肥厚	胸膜肥厚
左緊張性気胸	緊張性気胸	緊張性気胸
帯状疱疹再燃	帯状疱疹	帯状疱疹
左前胸部腫瘤	前胸部腫瘤	前胸部腫瘤
左鎖骨上リンパ節腫脹	鎖骨上リンパ節腫脹	鎖骨上リンパ節腫脹
左肺原発性肺癌	原発性肺癌	原発性肺癌
両側側脳室軽度拡大	脳室拡大	脳室拡大
脈性右室心筋症	不整脈原性右室心筋症	不整脈原性右室心筋症
縦隔炎併発	縦隔炎	縦隔炎
骨盤圧痛	骨盤痛	骨盤痛
骨巨細胞腫瘍	骨巨細胞腫	骨巨細胞腫
胆管拡張	胆管拡張症	胆管拡張症
好中球浸潤	好中球増加症	好中球増加症
右上肢線状強皮症	線状強皮症	線状強皮症
後頚部脂肪腫	頚部脂肪腫	頚部脂肪腫
時折心窩部痛	心窩部痛	心窩部痛
右足根骨骨折	足根骨骨折	足根骨骨折
右脛骨骨幹部骨折	脛骨骨幹部骨折	脛骨骨幹部骨折
両側腎盂軽度拡張	腎盂拡張	腎盂拡張
左下肺野陰影	下肺野陰影	下肺野陰影
足しびれ	下肢しびれ	下肢しびれ