出現形	正解	予測
副腎原発神経芽腫	副腎神経芽腫	副腎神経芽腫
Ｗｅｎｃｋｅｂａｃｈ型房室ブロック	ウェンケバッハ型第２度房室ブロック	ウェンケバッハ型第２度房室ブロック
痰貯留多	喀痰	胸水貯留
皮膚リンパ腫	菌状息肉症	悪性リンパ腫
個細胞壊死	壊死	腎乳頭壊死
左大腿骨顆上骨折	大腿骨外顆骨折	大腿骨顆上骨折
病原性大腸菌Ｏ−１５７感染性腸炎	病原性大腸菌感染症	病原性大腸菌感染症
口腔粘膜浮腫	浮腫	口腔粘膜下気腫
腟粘膜発赤	発赤	頬粘膜腫瘍
レム睡眠行動異常症	レム睡眠行動障害	レム睡眠行動障害
閉塞性膵炎	膵炎	閉塞性鼻炎
脱髄性疾患	脱髄疾患	脱髄疾患
多発性脾膿瘍	脾膿瘍	多発性肝膿瘍
間質性肺水腫	肺水腫	心原性肺水腫
無動性無言	無動性無言症	無動性無言症
舌扁平上皮癌	舌癌	肺扁平上皮癌
両側肺門部浸潤影	胸部異常陰影	肺門部異常陰影
軽度悪心	悪心	術後悪心
慢性活動性ＥＢウルス感染症	ＥＢウイルス感染症	ＥＢウイルス感染症
蛋白尿減少	蛋白尿	蛋白尿
脳障害	脳症	腎障害
中心性奬液性網脈絡膜症	中心性漿液性網脈絡膜症	中心性漿液性網脈絡膜症
左一側性反回神経麻痺	一側性反回神経麻痺	一側性反回神経麻痺
イレウス様	イレウス	イレウス
膵炎併発	膵炎	膵炎
ｈｅｍｏｐｈａｇｏｃｙｔｉｃ　ｓｙｎｄｒｏｍｅ	血球貪食症候群	Ｅｕｔｈｙｒｏｉｄ　Ｓｉｃｋ症候群
抗癌剤漏出	薬剤漏出性皮膚障害	羊水漏出
水痘帯状疱疹	帯状疱疹	劇症帯状疱疹
ｓｙｓｔｅｍｉｃ　ｍａｓｔｏｃｙｔｏｓｉｓ	肥満細胞腫症	解離性大動脈瘤ＤｅＢａｋｅｙＩＩＩａ
発汗多量	多汗症	発汗障害
早発黄疸	早発性黄疸	早発性黄疸
急性細菌性気管支炎	急性気管支炎	急性反復性気管支炎
右上葉肺小細胞癌	上葉肺大細胞癌	上葉肺大細胞癌
腟癌１期	腟癌	胃癌末期
会陰部発赤	発赤	会陰部血腫
嚥下時痛軽度	嚥下痛	嚥下協調障害
左顔面血管腫	顔面血管腫	顔面血管腫
鼻汁多く	鼻汁	鼻汁
口腔内出血痕	口腔出血	口腔内血腫
ＳＩＡＤ	抗利尿ホルモン不適合分泌症候群	ＳＣＡＤ欠損症
夜両足痛	足痛	足痛
左後頭葉梗塞	脳梗塞	後頭葉腫瘍
左内眼角基底細胞癌	眼角基底細胞癌	眼角基底細胞癌
難治性イレウス	イレウス	絞扼性イレウス
副鼻腔腫瘍	鼻副鼻腔腫瘍	鼻副鼻腔腫瘍
大腸菌菌血症	菌血症	大腸菌感染症
右前頭葉出血	脳出血	前頭葉腫瘍
左膝部痛	膝窩部痛	後頭部痛
仙椎陳旧性骨折	陳旧性骨折	鼻骨陳旧性骨折
乳癌既往	乳癌	乳癌再発
軽度咽頭発赤	咽頭発赤	咽頭発赤
痙攣起	痙攣	痙攣
下肢浮腫圧痕	下肢浮腫	下肢浮腫
左側頬部腫脹	頬部腫脹	側頚部腫脹
心室中隔穿孔	心室中隔欠損症	心室中隔瘤
四肢浮腫軽度	四肢浮腫	四肢浮腫
大腸ポリープ　ポリペク後	大腸ポリープ	大腸ポリープ
腰椎椎体椎間板炎	腰椎椎間板炎	腰椎椎間板炎
左下葉肺炎悪化	大葉性肺炎	沈下性肺炎
ぼんやり感持続	反応性低下	こわばり感
右鼠径部痛	鼡径部痛	鼡径部痛
皮疹不変	発疹	皮下気腫
創部痛	術創部痛	術創部痛
軽度右気胸	気胸	新生児気胸
腸閉塞歴	イレウス	結腸閉塞
左大腿骨骨折	大腿骨骨折	大腿骨骨折
紅斑局面多発	紅斑症	紅斑性天疱瘡
下部進行食道癌	食道癌	下部食道癌
無γグロブリン血症	無ガンマグロブリン血症	低グロブリン血症
子宮頸管ポリープ切除	子宮頚管ポリープ	子宮頚管ポリープ
手首疼痛	疼痛	手背部痛
ｓｐｌｅｎｉｃ　ｍａｒｇｉｎａｌ　ｚｏｎｅ　ｌｙｍｐｈｏｍａ	脾辺縁帯リンパ腫	ＨＨＶ８多中心性キャッスルマン病随伴大細胞型Ｂ細胞性リンパ腫
体動時息ぎれ	労作時呼吸困難	腎動脈過形成
一部浮腫	浮腫	足部浮腫
ふらつき注意	よろめき歩行	さとうきび肺
左中耳炎	中耳炎	中耳炎
胃食道逆流症状	胃食道逆流症	胃食道逆流症
両側卵巣子宮内膜症性嚢胞	卵巣子宮内膜症のう胞	卵巣子宮内膜症のう胞
新出肝転移	転移性肝癌	腎癌骨転移
脊椎カリエス	脊椎結核	肋骨カリエス
行動障害	素行障害	発動性障害
妊娠性糖尿病	妊娠糖尿病	妊娠糖尿病
小豆大紅斑	紅斑症	麻疹様紅斑
ＦＳＧＳ	巣状糸球体硬化症	ＨＤＬＳ
左寛骨臼骨折	寛骨臼骨折	寛骨臼骨折
原発性両眼内悪性リンパ腫	眼窩悪性リンパ腫	原発性滲出性リンパ腫
腹腔鏡補助下子宮筋腫核	子宮筋腫	有茎性漿膜下子宮筋腫
両下肢静脈血栓	下肢静脈血栓症	下肢静脈血栓症
神経根障害	神経根炎	頚髄神経根障害
クモ膜下出血	くも膜下出血	くも膜下出血
後鼻汁症候群	後鼻漏	濃縮胆汁症候群
糖尿病性腎症１期	腎性糖尿	糖尿病性腎症
左臀部慢性膿皮症	慢性膿皮症	潰瘍性慢性膿皮症
メサンギウム増殖性腎炎	メサンギウム増殖性糸球体腎炎	メサンギウム増殖性糸球体腎炎
左前頭葉心原性脳梗塞	心原性脳塞栓症	心原性小脳梗塞
閉塞性尿路感染	尿路感染症	急性尿路感染
顔面蝶形紅斑	ＬＥ蝶形皮疹	顔面表皮母斑
上行結腸癌肝転移	転移性肝癌	上行結腸癌
仙骨部色素沈着	色素異常症	外傷性色素沈着
肥満糖尿病	糖尿病	２型糖尿病
左肩痛み	肩部筋痛	腰筋痛症
ＰＳＶＴ発作	発作性上室頻拍	四肢痙攣発作
顎変形症術後顎変形症	顎変形症	鼓室形成術後後遺症
ＤＭＮ　２期	糖尿病	ＭＮＧＩＥ
労作時胸部絞扼感	胸内苦悶	労作時呼吸困難
右膝変形	変形性膝関節症	内反変形
指趾潰瘍	趾皮膚潰瘍	外陰潰瘍
２型食道癌	食道癌	下部食道癌
骨性腫瘤	腫瘤	骨腫瘤
外傷性脊髄損傷	脊髄損傷	多発性脊髄損傷
下肢結節性紅斑	結節性紅斑	結節性紅斑
左動眼神経麻痺	動眼神経麻痺	動眼神経麻痺
家族性海綿状血管腫	海綿状血管腫	多発性海綿状血管腫
術中直腸損傷	直腸損傷	直腸損傷
下肢動脈瘤	下肢の動脈瘤	下肢の動脈瘤
精神病様症状	精神病	精神神経症
項頸部痛	頚部痛	項部痛
頸部白斑	白斑	黄斑部白斑
左大腿骨転子部粉砕骨折	転子下骨折	大腿骨骨幹部粉砕骨折
最近眠気	非器質性過眠症	湿性脚気
ＶＨＤ	心臓弁膜症	輸血後ＧＶＨＤ
夜頻尿	夜間頻尿症	夜間頻尿症
回盲部炎	回盲部憩室炎	回盲部癌
重症肺血栓塞栓症	肺塞栓症	慢性肺血栓塞栓症
左歯痛	歯痛	歯痛
腹膜播種切除	腹膜播種	腹膜播種
右乳突蜂巣	乳様突起炎	大腿部蜂巣炎
右肺尖部気胸	気胸	外傷性血気胸
骨盤内子宮内膜症	子宮内膜症	骨盤子宮内膜症
左頬部痛	頬部痛	頬部痛
局麻薬アレルギー	薬物過敏症	ダニアレルギー
肺クリプトコックス症	急性肺クリプトコッカス症	骨クリプトコッカス症
右肩関節亜脱臼半横指	肩関節亜脱臼	肩関節亜脱臼
慢性蕁麻疹	慢性じんま疹	慢性湿疹
マラセチア毛嚢炎	マラセチア毛包炎	マラセチア毛包炎
高分化型漿液性腺癌	癌	卵巣漿液性腺癌
腫瘍床	腫瘍	腫瘍
左膀胱尿管逆流症	膀胱尿管逆流	膀胱尿管逆流
外側疼痛	疼痛	急性疼痛
卵巣癌再発卵巣癌	卵巣癌	再発卵巣癌
錐体路病変	錐体外路系疾患	錐体路障害
リンパ球性白血病	リンパ性白血病	前リンパ球性白血病
クラミジア感染	クラミジア感染症	クラミジア感染症
奬液性嚢胞腺腫	膵漿液性のう胞腺腫	膵漿液性のう胞腺腫
夜間倦怠感	倦怠感	下肢倦怠感
脳血栓塞栓症	脳血管閉塞性脳梗塞	肺血栓塞栓症
左リウマチ性肘関節症	関節リウマチ・膝関節	関節リウマチ・肘関節
右下腿潰瘍感染	下腿皮膚潰瘍	妊娠中風疹感染
気分不快時	悪心	腹部不快感
問題なし前立腺肥大	前立腺肥大症	前立腺肥大症
急性パルボウイルスＢ１９感染症	パルボウイルス感染症	パルボウイルス感染症
脂肪性腫瘤	脂肪腫	化膿性腫瘤
ウィルス性肺炎	肺炎	ウイルス性肺炎
類円形紅斑	紅斑症	多形紅斑
書字不能	書痙	書字障害
肺動脈狭窄	肺動脈狭窄症	肺動脈狭窄症
夜間不眠状態	不眠症	不穏状態
熱型	発熱	熱傷
骨盤内充実性腫瘍	骨盤腫瘍	骨盤骨悪性腫瘍
夢遊病	夢遊症	夢遊症
脊髄小脳変性症６型	脊髄小脳変性症	脊髄小脳失調症６型
左内頚動脈閉塞	内頚動脈閉塞症	内頚動脈閉塞症
両側角乾燥性結膜炎	結膜炎	慢性カタル性結膜炎
脳虚血症状	脳虚血症	脳虚血症
微熱持続	微熱	癌性持続痛
夕方浮腫	浮腫	眼瞼浮腫
眼性疲労	眼精疲労	眼精疲労
直腸肛門奇形	鎖肛	仙腸関節奇形
右大腿部腫瘍	大腿悪性軟部腫瘍	大腿軟部腫瘍
頚椎症神経根症	頚椎症性神経根症	頚椎症性神経根症
壊死性遊走性紅斑	遊走性紅斑	慢性遊走性紅斑
睡眠障害招くリスク	睡眠障害	睡眠障害
上大静脈血栓	静脈血栓症	上肢静脈血栓症
骨盤内ＬＮ転移	骨盤内リンパ節転移	骨盤内リンパ節転移
ＰＫＤ	多発性のう胞腎	ＡＩＤＳ
分水嶺脳梗塞	脳梗塞	分水界梗塞
上皮性腫瘍	腫瘤	上肢悪性腫瘍
大球性正色素貧血	大球性貧血	正球性正色素性貧血
挙上空腸穿孔	腸穿孔	挙上空腸狭窄
腸管アメーバ感染症	腸アメーバ症	腸管アメーバ肉芽腫
放射線性皮膚炎	放射線皮膚炎	放射線皮膚炎
肛門周囲びらん	外痔びらん	肛門部びらん
髄膜炎徴候	髄膜炎	髄膜炎
胸部不快	胸内苦悶	胸部不快感
下葉肺炎	肺炎	下葉肺癌
右足根部粉砕骨折	粉砕骨折	上腕骨顆粉砕骨折
蛋白漏出胃腸症	蛋白漏出性胃腸症	蛋白漏出性胃腸症
左大脳陳旧性ラクナ梗塞	陳旧性ラクナ梗塞	陳旧性ラクナ梗塞
出血多量	急性大量出血	出血傾向
腹水多量	腹水症	腹水症
腸間膜リンパ管腫	リンパ管腫	腸間膜リンパ節腫脹
右卵巣悪性腫瘍	卵巣悪性腫瘍	卵巣悪性腫瘍
糖尿病（２型）	２型糖尿病	糖原病１２型
化膿性胸鎖関節炎	化膿性関節炎・胸鎖関節	化膿性顎関節炎
右乳腺線維腫症	線維腫	乳腺線維腫
肺野鬱血像	肺野異常陰影	肺野兎病
児嘔気	嘔気	嘔気
尿閉歴	尿閉	尿閉
陰嚢びらん	陰のうびらん	陰茎びらん
精神的ショック	ショック	疼痛性ショック
右上腕骨外側上顆炎	外側上顆炎	上腕骨外上顆骨折
子宮頚上皮内癌	子宮頚部上皮内癌	子宮頚部上皮内癌
難治性非定型性抗酸菌症	非結核性抗酸菌症	ＨＩＶ非結核性抗酸菌症
軽度腹水	腹水症	異常腹水
湿疹様	湿疹	湿疹
大後頭孔狭窄	軟骨形成不全症	後鼻孔狭窄
熱型変化	発熱	性格変化
右無機能腎	無機能腎	無機能腎
月経痛コントロール不十分	月経痛	アクチバトール不適合
左鎖骨下動脈閉塞	鎖骨下動脈閉塞症	鎖骨下動脈閉塞症
右ＤＶＴ	深部静脈血栓症	右心不全
非特異的胸痛	胸痛	非特異骨髄炎
Ａｅｒｏｍｏｎａｓ　ｈｙｄｒｏｐｈｉｌａ敗血症	敗血症	新生児コアグラーゼ陰性ぶどう球菌敗血症
重症細菌性敗血症	敗血症	髄膜炎菌性敗血症
逆行性健忘	逆向性健忘	逆向性健忘
腹直筋膜下血腫	筋肉内血腫	慢性硬膜下血腫
関連腎臓病	腎疾患	慢性腎臓病
認知症様症状	認知症	認知症
顎骨骨折	下顎骨骨折	上顎骨骨折
高度大動脈弁狭窄	大動脈弁狭窄症	大動脈弁狭窄症
右顔面骨骨折	顔面骨骨折	顔面骨骨折
炎症性粉瘤	粉瘤	炎症性斜頚
左腰部疼痛	腰痛症	陰茎部疼痛
ＨＣＶ重複感染症	Ｃ型肝炎ウイルス感染	ＨＩＶ−２感染症
脂質異常症（＋）	脂質異常症	脂質異常症
上腹部圧痛	腹部圧痛	上腹部痛
両側椎骨動脈瘤	椎骨動脈瘤	椎骨動脈瘤
非ケトン性高血糖	高血糖高浸透圧症候群	ケトン性低血糖症
Ｙｅｒｓｉｎｉａ腸炎	エルシニア腸炎	ロタウイルス性胃腸炎
声帯浮腫	声帯炎	声門浮腫
誤嚥性肺炎併発	誤嚥性肺炎	誤嚥性肺炎
咳嗽持続	咳	癌性持続痛
左側下顎骨嚢胞	顎骨のう胞	上下顎骨骨折
右末梢前庭障害	末梢前庭障害	末梢前庭障害
胆管閉鎖症	胆管閉塞症	気管閉鎖症
閉塞性動脈硬化症　症状	閉塞性動脈硬化症	閉塞性動脈硬化症
洞不全	洞不全症候群	肝不全
特発性リンパ浮腫	リンパ浮腫	遅発性内リンパ水腫
シャント吻合部狭窄	透析シャント狭窄	吻合部狭窄
無気力	無力症	無気肺
胸骨炎	胸骨周囲炎	胸膜炎
ナッツアレルギー	ピーナッツアレルギー	ピーナッツアレルギー
甲状腺乳頭癌術後再発	甲状腺乳頭癌	甲状腺乳頭癌
上肢疼痛	疼痛	上肢痛
Ｔｕｒｎｅｒ症候群	ターナー症候群	ＴｒｉｐｌｅＡ症候群
肝臓機能障害用	肝機能障害	肝機能障害
左心不全徴候	心不全	左心不全
ＩＰＭＮ癌化	膵管内乳頭粘液性腺癌	ＩＰ関節捻挫
後発頚部転移	頚部転移性腫瘍	多発性癌転移
下痢治	下痢症	下痢症
朝方疼痛	疼痛	術後疼痛
蜂窩肺形成	蜂窩織炎	骨髄低形成
右ＩＣＡ高度狭窄	内頚動脈狭窄症	右室流出路狭窄
膵体部嚢胞	膵のう胞	膵体部癌
右気管支狭窄	気管支狭窄症	気管支狭窄症
非ヘルペス性辺縁系脳炎	辺縁系脳炎	自己免疫性辺縁系脳炎
無症候性ＶＴ	心室頻拍	無症候性血尿
好酸球増多	好酸球増加症	好酸球増加症
口腔清掃	個人衛生の著しいレベル低下	口腔底癌
両下腿皮膚潰瘍	下腿皮膚潰瘍	下腿皮膚潰瘍
無石性胆嚢炎	胆のう炎	胆石性胆のう炎
ｓ型ポリープ	ポリープ	鼻腔ポリープ
時折頭痛	頭痛	眼性頭痛
関節リウマチ発症	関節リウマチ	関節リウマチ
残像腫瘍	腫瘍	耳介腫瘍
両顎下腺腫大	顎下腺肥大	顎下腺腫瘍
夜間中途覚醒時	睡眠障害	夜間異常知覚症
今朝頭痛	頭痛	群発頭痛
眼球偏移	眼球偏位	眼球偏位
腹腔内癒着高度	腹膜癒着	腹腔内遺残膿瘍
右母指多指症	多指症	母指三指節症
薬剤性骨髄抑制	骨髄機能低下	薬剤性骨軟化症
肥満	肥満症	肥満症
網膜中心動脈閉塞	網膜中心動脈閉塞症	網膜中心動脈閉塞症
中枢神経悪性リンパ腫再発	悪性リンパ腫	十二指腸悪性リンパ腫
旅行者下痢症	下痢症	細菌性下痢症
右声帯ポリープ	声帯ポリープ	声帯ポリープ
非Ｂ非Ｃ型肝硬変	肝硬変症	Ｂ型肝硬変
頭部皮下結節	皮下結節	頭部皮下異物
足がむくみ	下肢浮腫	足部打撲傷
下肢潰瘍	下肢皮膚潰瘍	下肢皮膚潰瘍
難治性胸腹水	難治性腹水	難治性腹水
幻覚症状	幻覚	幻覚妄想状態
異常腫瘤	腫瘤	陰茎腫瘤
未破裂脳動脈瘤コイル塞栓	未破裂脳動脈瘤	未破裂脳動脈瘤
左下顎骨慢性骨髄炎	慢性顎骨骨髄炎	下腿骨慢性骨髄炎
左側頭葉膠芽腫	側頭葉膠芽腫	側頭葉膠芽腫
脳血管障害性パーキンソニズム	脳血管障害性パーキンソン症候群	脳血管障害性パーキンソン症候群
右後角脳室内出血	脳室内出血	外傷性脳室内出血
難治性浮腫	高度浮腫	一過性浮腫
Ｇｒａｎｕｌｏｍａｔｏｓｉｓ　ｗｉｔｈ　ｐｏｌｙａｎｇｉｉｔｉｓ	多発血管炎性肉芽腫症	ＨＨＶ８多中心性キャッスルマン病随伴大細胞型Ｂ細胞性リンパ腫
再発脊索腫	脊索腫	胸椎脊索腫
Ｃ型肝硬変症	Ｃ型肝硬変	Ｃ型肝硬変
左踵部悪性黒色腫	踵部悪性黒色腫	踵部悪性黒色腫
未分化癌	癌	肺未分化癌
両側副腎悪性リンパ腫	悪性リンパ腫	十二指腸悪性リンパ腫
帯状疱疹無	帯状疱疹	帯状疱疹
左膝痛み	膝関節痛	左旋転位
右下腿痛	下腿痛	下腿痛
気管支喘息症状	気管支喘息	気管支喘息発作
大腿骨内顆骨壊死	特発性大腿骨内顆骨壊死	大腿骨内顆骨折
炎症性貧血	貧血	先天性貧血
両下肢掻痒感	皮膚そう痒症	下肢倦怠感
右後頭葉脳挫傷	脳挫傷	後頭部挫傷
女性化乳房	女性化乳房症	女性化乳房症
ｍａｓｓ　ｌｅｓｉｏｎ	腫瘤	ＴｒｉｐｌｅＡ症候群
右大脳半球多発脳梗塞	多発性脳梗塞	無症候性多発性脳梗塞
大動脈弁膜症	大動脈弁弁膜症	大動脈弁弁膜症
鎮静困難	興奮状態	生歯困難
再発腫瘤近傍	腫瘤	再発性脳梗塞
右下腿麻痺	下肢麻痺	下肢麻痺
切除不能多発性肝転移	転移性肝腫瘍	多発性癌転移
腹腔内膿瘍形成	膿瘍	腹腔内膿瘍
発作性上室性頻拍	発作性上室頻拍	発作性上室頻拍
筋肉痛生	筋肉痛	筋肉痛
腰椎滑り症	腰椎すべり症	腰椎すべり症
淡血性胸水	血性胸水	血性胸水
腎被膜下出血	外傷性腎被膜下血腫	くも膜下出血
仙骨部褥瘡痕	仙骨部褥瘡	仙骨部褥瘡
左肝腫瘍	肝腫瘍	肝腫瘍
非Ｃｌｏｓｔｒｉｄｉｕｍ性ガス壊疽	ガス壊疽	Ｅｕｔｈｙｒｏｉｄ　Ｓｉｃｋ症候群
リンパ腺腫脹	リンパ節腫大	肘リンパ節腫脹
心室二段脈	心室性二段脈	心室性二段脈
鼻腔腫瘍摘出	鼻腔腫瘍	鼻腔腫瘍
疼痛時頓用	疼痛	疼痛性側弯症
多房性膿瘍	膿瘍	多発性肝膿瘍
右耳介後部痛	耳痛症	耳介後部腫瘤
左胸壁腫瘍切除	胸壁腫瘍	胸壁腫瘍
無呼吸症候群	無呼吸発作	無脾症候群
右尿管癌	尿管癌	尿管癌
出血過多	出血	帯下過多
甲状腺嚢腫	甲状腺のう胞	甲状腺腺腫
両側浸出性中耳炎	滲出性中耳炎	急性滲出性中耳炎
覚醒度	麻酔覚醒遅延	覚醒剤中毒
高血糖	高血糖症	高血糖症
有意弁膜症	弁膜炎	心臓弁膜症
胸痛無	胸痛	胸痛
右下肺野無気肺	無気肺	下葉無気肺
小脳性失調	小脳性運動失調症	小脳性歩行失調
好酸球増多症	好酸球増加症	好酸球増加症
右腎明細胞肉腫	腎明細胞肉腫	腎明細胞肉腫
甲状腺左葉濾胞腺腫	濾胞性甲状腺腺腫	甲状腺濾胞癌
下位運動ニューロン徴候	運動ニューロン疾患	運動ニューロン疾患
主幹動脈狭窄	脳動脈狭窄症	腕頭動脈狭窄
創部皮下血腫	外傷性皮下血腫	頭部皮下血腫
掻痒感軽減	そう痒	術後感染症
両肺小結節影	肺野異常陰影	乳房小結節
造影剤アレルギー歴	薬物過敏症	ダニアレルギー
左眼鼻涙管閉塞症	鼻涙管閉鎖症	先天性涙管閉塞症
慢性的な抑うつ気分	うつ状態	混合性不安抑うつ障害
鼻部異物肉芽腫	皮膚異物肉芽腫	皮膚異物肉芽腫
遠隔ＬＮ転移	リンパ節転移	横隔膜転移
子宮がん	子宮癌	子宮萎縮
Ｂｉｃｋｅｒｓｔａｆｆ型脳幹脳炎	ビッカースタッフ脳幹脳炎	ビッカースタッフ脳幹脳炎
睾丸腫脹	精巣腫脹	殿部腫脹
右中皮腫	中皮腫	中皮腫
ジベル薔薇色粃糠疹	ジベルばら色粃糠疹	ジベルばら色粃糠疹
脳実質外腫瘍	腫瘍	脳室悪性腫瘍
抑鬱感	気うつ	蟻走感
扁桃腺腫大	扁桃肥大	扁桃肥大
口内出血	口腔出血	口腔出血
右上方視野欠損	視野欠損	視野欠損
両側臼蓋形成不全症	臼蓋形成不全	臼蓋形成不全
進行肝癌	肝癌	進行乳癌
噴門部狭窄	胃狭窄	噴門狭窄
突発性腎出血	腎出血	特発性腎出血
前股関節症	股関節症	股関節症
多発肝嚢胞	多発性肝のう胞	多発性肝のう胞
過換気状態	過換気症	過換気症
傍大動脈ＬＮ	大動脈周囲リンパ節転移	上大動脈損傷
左椎骨動脈低形成	骨髄低形成	椎骨動脈塞栓症
左房拡張	心拡大	腎盂拡張
サルモネラ菌感染症	サルモネラ感染症	サルモネラ感染症
両側性多発性嚢胞腎	多発性のう胞腎	両側性続発性膝関節症
化学物質アレルギー	アレルギー	食物アレルギー
右手指腫脹	手指腫脹	手指腫脹
右足背発赤	発赤	足背膿瘍
脊柱管高度狭窄	脊柱管狭窄症	脊柱管狭窄症
右急性網膜壊死	急性網膜壊死	急性網膜壊死
皮膚硬化がまだかなり	新生児皮膚硬化症	皮膚ブラストミセス症
口腔内乾燥軽度	口腔乾燥症	口腔乾燥症
下肢筋痛	下肢筋肉痛	下肢筋肉痛
蠕動不良	異常腸音	蠕動亢進
四肢腱反射亢進	反射亢進	反射亢進
黒色丘疹	丘疹	紅色丘疹
胸部陰影	胸部異常陰影	胸部異常陰影
クモ膜下嚢胞	くも膜のう胞	頬粘膜のう胞
２次性糖尿病	二次性糖尿病	二次性糖尿病
Ｈａｅｍｏｐｈｉｌｕｓ　ｉｎｆｌｕｅｎｚａｅ敗血症	敗血症	大動脈弁閉鎖不全症兼僧帽弁狭窄症兼三尖弁閉鎖不全症
慢性期疼痛	慢性疼痛	慢性疼痛
右上葉原発肺小細胞癌	小細胞肺癌	上葉肺大細胞癌
出血源不詳	出血	出血性鼻茸
一般細菌感染	細菌感染症	肛門淋菌感染
急性小脳失調症	急性小脳性失調症	急性小脳性失調症
浸潤癌化所見	癌	浸潤性乳管癌
痔核脱出	痔核	臍帯脱出
重症膵炎	膵炎	重症急性膵炎
痛みアリ	疼痛	痛風発作
左心室内血栓症	心室内血栓症	心室内血栓症
右足疼痛	疼痛	術後疼痛
増殖前網膜症	網膜症	増殖性網膜症
傍神経節腫瘍	傍神経節腫	傍神経節腫
小腸膀胱瘻	膀胱皮膚瘻	直腸膀胱瘻
左小細胞肺癌	小細胞肺癌	非小細胞肺癌
少量左胸水	胸水貯留	漏出性胸水
多発ＨＣＣ再発	肝細胞癌	多発性表在損傷
結核性嚢腫	結核	結核性空洞
右大腿骨外顆骨折	大腿骨外顆骨折	大腿骨外顆骨折
巨大膵仮性嚢胞	仮性膵のう胞	巨大気腫性肺のう胞
大腿腫脹	下腿腫脹	大腿部腫脹
全身性ＣＭＶ感染症	サイトメガロウイルス感染症	新生児ＨＩＶ感染症
多発肝内転移	転移性肝腫瘍	多発性癌転移
右外耳道炎	外耳炎	外耳道痛
両下肢圧痕性浮腫	クインケ浮腫	上下肢リンパ浮腫
下部腸間膜動脈出血	動脈性出血	下腸間膜動脈瘤
ＩｇＭ型Ｍ蛋白	単クローン性免疫グロブリン血症	ＩｇＭ欠損症
喘息発作様症状	気管支喘息発作	部分発作重延状態
分食道癌	食道癌	食道癌
多少便秘気味	便秘症	重症便秘症
ポリープ状病変	ポリープ	ポリープ様声帯
既往高血圧	高血圧症	白衣高血圧
右リウマチ性膝関節症	関節リウマチ・膝関節	関節リウマチ・膝関節
急性骨髄性白血病（ＡＭＬ）	急性骨髄性白血病	急性骨髄性白血病
腹水大量	腹水症	腹水症
全身皮膚発赤	発赤	全身痙攣発作
多発肺嚢胞	肺のう胞	多発性拘縮
右小脳橋角部腫瘍	小脳橋角部腫瘍	小脳橋角部腫瘍
右眼網膜静脈分枝閉塞症	網膜静脈分枝閉塞症	網膜静脈分枝閉塞症
右脛骨腓骨開放骨折	脛骨腓骨開放骨折	脛骨腓骨開放骨折
左側卵巣腫瘍	卵巣腫瘍	卵巣腫瘍
口腔内びらん	口唇びらん	鼻腔内びらん
紅斑熱群リケッチア症	リケッチア感染症	腺熱リケッチア症
ＩＴＰ	特発性血小板減少性紫斑病	Ｉ細胞病
気管支喘息小発作	気管支喘息発作	気管支喘息発作
解離性動脈瘤破裂	解離性動脈瘤	解離性動脈瘤
左眼窩内腫瘍	眼窩腫瘍	眼窩偽腫瘍
肺外小細胞癌	小細胞肺癌	肺門部小細胞癌
高度大動脈弁狭窄症	大動脈弁狭窄症	大動脈弁狭窄症
ｂｒｅａｋｔｈｒｏｕｇｈ　ｈｅｐａｔｉｔｉｓ	肝炎	Ｅｕｔｈｙｒｏｉｄ　Ｓｉｃｋ症候群
左室圧排	右室肥大	左室不全
両側声帯外転障害	声帯外転筋麻痺	外側膝窩神経障害
一部水疱形成	水疱症	中隔部肉芽形成
糖尿病潰瘍	糖尿病性潰瘍	糖尿病足潰瘍
飲みこみにくさ	嚥下障害	閉じこめ症候群
左腎低形成	低形成腎	骨髄低形成
左母趾疼痛	母趾痛	母趾痛
副腎ヒストプラズマ感染症	真菌症	マイコプラズマ感染症
右眼糖尿病網膜症	糖尿病網膜症	糖尿病網膜症
下肢浮腫左	下肢浮腫	下肢浮腫
両松葉杖歩行	歩行障害	よろめき歩行
冠動脈狭窄３枝病変	狭心症３枝病変	狭心症３枝病変
遺伝性低尿酸血症	低尿酸血症	腎性低尿酸血症
低アルドステロン血症	低アルドステロン症	低アルドステロン症
小腸皮膚瘻	皮膚瘻	直腸皮膚瘻
重度僧帽弁狭窄症	僧帽弁狭窄症	僧帽弁狭窄症
非細菌性血栓性疣贅	疣贅	大腸菌性先天性肺炎
特発性腸間膜血腫	血腫	多発性腸間膜膿瘍
脳原発性悪性リンパ腫	脳悪性リンパ腫	原発性滲出性リンパ腫
抜管後両側反回神経麻痺	両側性反回神経麻痺	両側性反回神経麻痺
肝骨転移	骨転移癌	肝癌骨転移
乳腺線維腫症	線維腫	乳腺線維腫
術後左反回神経麻痺	反回神経麻痺	術後性反回神経麻痺
無症候性髄膜腫	髄膜腫	無症候性骨髄腫
左肺下葉肺癌	下葉肺癌	下葉肺癌
アルコール離脱症候群	アルコール離脱状態	アルコール性脳症候群
左腸骨骨肉腫	腸骨軟骨肉腫	頭蓋骨骨肉腫
脳梁低形成	脳梁形成不全	乳頭低形成
表皮内水疱形成	先天性表皮水疱症	副甲状腺過形成
後頚部圧痛	圧痛	後頚部腫瘤
不定愁訴様	不定愁訴症	不定愁訴症
良性胆道狭窄	胆管狭窄症	腐食性食道狭窄
左下葉非小細胞肺癌	下葉非小細胞肺癌	下葉非小細胞肺癌
ＣＫＤ　腎硬化症	腎硬化症	糖尿病性腎硬化症
前頭葉出血	出血	前頭葉腫瘍
有茎性乳頭状腫瘍	腫瘍	充実性偽乳頭状腫瘍
理解困難	言語理解障害	歩行困難
スメア異常	腟スメア細胞診陽性	下咽頭異常
腹腔内敗血症	敗血症	腹腔内出血
膵尾部腫大	膵腫大	膵体尾部腫瘍
過呼吸状態	過換気症	無呼吸発作
右肺門部原発肺小細胞癌	小細胞肺癌	肺門部非小細胞癌
胃癌骨髄癌腫症	骨髄転移	滑膜骨軟骨腫症
眼乾燥感	ドライアイ	咽喉乾燥感
内側縦束症候群	核間性眼筋麻痺	側頭葉症候群
両足関節炎	足関節炎	足関節炎
夜低血糖	低血糖	低血糖
左上下肢軽度麻痺	四肢麻痺	上下肢筋不全麻痺
下肢痙性	痙性対麻痺	下肢痙攣
皮疹状況	発疹	丘疹状湿疹
不適応	適応障害	Ｄ不適合
陰茎部痛	陰茎部疼痛	陰茎部疼痛
髄外形質細胞腫	骨外性形質細胞腫	骨外性形質細胞腫
ｍａｌｉｇｎａｎｔ　ｌｙｍｐｈｏｍａ	悪性リンパ腫	解離性大動脈瘤ＤｅＢａｋｅｙＩＩＩａ
重症ＡＧＨＤ	重症成人成長ホルモン分泌不全	輸血後ＧＶＨＤ
両白内障	白内障	白内障
腎結石	腎結石症	腎結石症
湿疹性病変	湿疹	湿疹性眼瞼炎
穿刺部発赤	発赤	下腿発赤
時々背部痛	背部痛	胸背部痛
手内筋萎縮	筋萎縮症	上肢筋萎縮
腎機能悪化	腎機能低下	腎機能低下
尾てい骨骨折	尾骨骨折	尾骨骨折
高度視力障害	視力障害	急性視力障害
周期性クッシング症候群	クッシング症候群	クッシング症候群
昨夜微熱	微熱	慢性微熱
腓腹筋痙攣	痙攣	四肢筋痙攣
左肋骨打撲	肋骨部打撲	肋骨部打撲
破壊性脊椎症	脊椎症	破壊性脊椎関節症
胆嚢破裂	胆のう管破裂	腹壁破裂
独歩不可	歩行障害	調節不全
骨破壊進行	関節リウマチ	骨壊死
下肢白癬	白癬	四肢白癬
左鼓膜発赤	発赤	下腿発赤
潜在結核	結核	精巣結核
熱苦症状	発熱	熱中症
シャイドレジャー症候群	シャイ・ドレーガー症候群	シャイ・ドレーガー症候群
肺動脈弁閉鎖症	肺動脈弁閉鎖	大動脈弁閉鎖症
脾摘施行Ｃ型肝炎	Ｃ型肝炎	先天性Ａ型肝炎
胸水セルブロック	胸水貯留	左脚前枝ブロック
右肺上葉すりガラス影	胸部異常陰影	肺エキノコックス症
Ｆｏｌｌｉｃｕｌａｒ　ｌｙｍｐｈｏｍａ	濾胞性リンパ腫	急性大動脈解離ＤｅＢａｋｅｙＩＩＩａ
腫瘍性ＤＩＣ	線溶亢進	分娩後ＤＩＣ
右精巣上体炎	精巣上体炎	精巣上体炎
左肘関節亜脱臼	亜脱臼	仙腸関節亜脱臼
左聴神経腫瘍	聴神経腫瘍	聴神経腫瘍
左肺感染性嚢胞	肺のう胞	慢性感染性貧血
母体出血	出血	硝子体出血
右足趾壊疽	下肢壊疽	足壊疽
胃腸障害	急性胃腸障害	直腸障害
残遺癌	癌	残胃癌
不安大きく	不安障害	不安神経症
ＭＳ再発	多発性硬化症	乳癌再発
強直間代性痙攣発作	間代性痙攣	強直間代発作
一過性意識消失発作	一過性脳虚血発作	一過性脳虚血発作
乳児白血病	白血病	乳児偽白血病
筋委縮	筋萎縮症	筋痙縮
水腎再燃	水腎症	水腎症
しびれていない	しびれ感	しびれ感
時々血痰	血痰	血痰
左鼠経ヘルニア	鼡径ヘルニア	閉鎖孔ヘルニア
遺伝性腎性尿崩症	先天性腎性尿崩症	先天性腎性尿崩症
尿管結石	尿管結石症	腎尿管結石
体幹掻痒感	そう痒	体幹血管腫
右大腿部骨幹部骨折	大腿骨骨幹部骨折	大腿骨骨幹部骨折
糖尿病神経症	糖尿病性神経痛	糖尿病性神経痛
古典的肝細胞癌再発	肝細胞癌	肝細胞癌破裂
左室低形成	左心低形成症候群	右室低形成
劇症肝炎亜急性型	劇症肝炎	劇症肝炎
分岐部動脈瘤	内頚動脈後交通動脈分岐部動脈瘤	胸腹部大動脈瘤
腫瘍感染	腫瘍	尿管感染
悪性腫瘍スクリーニング	悪性腫瘍	オーラルスクリーン破損
外陰部炎	外陰炎	外陰部痛
軽度骨髄抑制	骨髄機能低下	軽度知的障害
右踵骨折	骨折	不全骨折
ＰＰＨ	肺高血圧症	ＰＣＷＨ
頭痛時折	頭痛	頭頂骨骨折
血腫貯留	血腫	胸水貯留
不整脈発作	不整脈	徐脈発作
静脈炎症状	静脈炎	静脈炎
子宮間質肉腫	肉腫	子宮内膜間質肉腫
右主気管支膜様部壊死	壊死	主気管支の悪性腫瘍
右下肺野スリガラス影	胸部異常陰影	慢性肺ブラストミセス症
時々頭痛	頭痛	眼性頭痛
胆嚢腺扁平上皮癌	癌	肺腺扁平上皮癌
上行結腸早期癌	上行結腸癌	上行結腸癌
突発性血小板減少性紫斑病	血小板減少性紫斑病	続発性血小板減少性紫斑病
意識変動	意識障害	意識消失
左閉鎖リンパ節転移	リンパ節転移	胸骨傍リンパ節転移
両側小脳梗塞	小脳梗塞	小脳梗塞
胃癌多発肝転移	転移性肝癌	胃癌骨転移
左前腕浮腫	浮腫	上腕浮腫
赤紫斑	紫斑病	紫斑病
偽腔閉塞型大動脈解離	解離性大動脈瘤	早期血栓閉鎖型大動脈解離
高度感音性難聴	感音難聴	騒音性難聴
左耳介欠損	耳介欠損	耳介欠損
尿路感染	尿路感染症	尿路感染症
縦隔炎再発	縦隔炎	縦隔炎
前立腺肥大有	前立腺肥大症	前立腺肥大症
胆嚢腫瘍	胆のう腫瘍	胆管腫瘍
胃がん	胃癌	胃びらん
左中大脳動脈梗塞	中大脳動脈塞栓症	中大脳動脈閉塞症
Ｓｏｔｏｓ症候群	ソトス症候群	ＳＡＰＨＯ症候群
必要認知症	認知症	皮質認知症
肝腫瘤性病変	肝腫瘤	根分岐部病変
大動脈瘤解離	解離性大動脈瘤	脾動脈解離
挿入部出血	出血	黄斑部出血
眠前発熱	発熱	術後発熱
肺炎反復	肺炎	肺炎結核
子宮内発育不全	子宮発育不全	子宮発育不全
左眼窩内腫瘤	眼窩腫瘤	眼窩腫瘤
多発性腎梗塞	腎梗塞	多発性脳梗塞
多臓器不全状態	多臓器不全	多臓器不全
再度痙攣発作	痙攣発作	四肢痙攣発作
変動一過性徐脈	徐脈	外傷性一過性麻痺
四肢色素沈着	皮膚色素沈着	歯の色素沈着
良性発作性頭位めまい	良性発作性頭位めまい症	良性発作性頭位めまい症
三角圧痛	肩部筋痛	三角頭蓋
両側声帯不全麻痺	声帯不全麻痺	声帯不全麻痺
舌痛	舌痛症	舌痛症
肺動脈弁下狭窄	肺動脈弁下狭窄症	肺動脈弁下狭窄症
乳癌局所再発	乳癌	乳癌再発
頚椎症性神経根炎	頚椎症性神経根症	頚椎症性神経根症
痛みきつい	疼痛	ひきつけ
両側顎下腺腫大	顎下腺肥大	顎下腺腫瘍
中等度咽頭期嚥下障害	嚥下障害	中等度知的障害
ビタミンＤ不足	ビタミンＤ欠乏症	ビタミンＤ過剰症
日中下痢便	下痢症	慢性下痢症
胸郭低形成	胸郭異常	骨髄低形成
肺スリガラス陰影	胸部異常陰影	ヒストプラスマ腫
頻脈傾向変	頻脈症	出血傾向
口蓋腫瘤	腫瘤	口蓋腫瘍
パーキンソン病関連疾患	パーキンソン病	パーキンソン病の認知症
グラム陰性桿菌菌血症	グラム陰性桿菌敗血症	グラム陰性桿菌敗血症
右上肢腫脹	上肢腫脹	上肢腫脹
左肩甲骨部痛	肩甲骨痛	肩甲部痛
開腹子宮筋腫核	子宮筋腫	巨大子宮筋腫
白内障手術	白内障	白内障術後
腫瘤残存	腫瘤	腫瘤
直腸癌Ｒａ	直腸癌	直腸癌穿孔
カルボプラチンアレルギー	薬物過敏症	ペニシリンアレルギー
肺原発ホジキンリンパ腫	ホジキンリンパ腫	古典的ホジキンリンパ腫
循環障害	末梢循環障害	網膜循環障害
原発性空腸癌	空腸癌	原発性肝癌
右卵巣チョコレート嚢腫	チョコレートのう胞	チョコレートのう胞
重度精神運動発達遅滞	混合性特異的発達障害	運動発達遅滞
左腎梗塞	腎梗塞	副腎梗塞
筋緊張高く	筋強直	筋緊張性障害
母指潰瘍治癒遅延	皮膚潰瘍	母指屈筋腱癒着
歩行時呼吸困難感	労作時呼吸困難	労作時呼吸困難
滑液貯留	体液貯留	体液貯留
痰症状	喀痰	銅症
腸管血流障害	末梢循環障害	腸管運動障害
発赤強い	発赤	発赤
全身性単純ヘルペスウイルス感染症	ヘルペスウイルス感染症	先天性ヘルペスウイルス感染症
冠動脈高度石灰化	冠動脈石灰化	冠動脈石灰化
劇症型腸アメーバ症	腸アメーバ症	慢性腸アメーバ症
慢性痛	慢性疼痛	慢性疼痛
不適応行動	適応障害	適応障害
心室内血栓	心室内血栓症	心室内血栓症
腹膜播種結節摘出	腹膜播種	腹膜播種
緑色痰	喀痰	緑色便
冠動脈硬化	冠状動脈硬化症	冠状動脈硬化症
右中葉肺癌	中葉肺癌	中葉肺癌
ポンプポケット内血腫	血腫	ポンプポケット感染
血管免疫芽球型Ｔ細胞リンパ腫	血管免疫芽球性Ｔ細胞リンパ腫	血管免疫芽球性Ｔ細胞リンパ腫
腹部緊満	腹部膨満	腹部膨満
舌骨喉頭下垂	喉頭下垂症	喉頭下垂症
尿量低下	乏尿	１秒量低下
脳梗塞症	脳梗塞	脳梗塞
左非浸潤性乳管癌	非浸潤性乳管癌	非浸潤性乳管癌
むつかぶれ	おむつ皮膚炎	つかえ感
水平亜脱臼	亜脱臼	水晶体亜脱臼
右反復性膝蓋骨脱臼	反復性膝蓋骨脱臼	反復性膝蓋骨脱臼
早期癌	癌	早期胃癌
吻合部出血	出血	外陰部出血
子宮頸がん	子宮頚癌	子宮頚延長
腺扁平上皮癌	癌	肺腺扁平上皮癌
喉頭蓋サルコイドーシス	サルコイドーシス	鼻腔サルコイドーシス
結核性	結核	結核腫
声門部狭窄	喉頭狭窄症	縫合部狭窄
両側急性硬膜外血腫	急性硬膜外血腫	急性硬膜外血腫
高レニン高血圧	高レニン性高血圧症	高レニン性高血圧症
頭蓋底髄膜腫	髄膜腫	後頭蓋窩髄膜腫
右前胸部痛	前胸部痛	前胸部痛
膵全体癌	膵癌	膵頭部癌
両側血気胸	血気胸	血気胸
穿刺部位出血	出血	黄斑部出血
手掌黄色腫	黄色腫症	偽性黄色腫
皮膚湿疹	湿疹	肛門湿疹
唾石	唾石症	唾石症
非吻合部多発胆管狭窄	胆管狭窄症	吻合部狭窄
軽度肥満歴	肥満症	病的肥満症
左腎嚢胞不変	腎のう胞	腎移植不全
軽度発赤腫脹	発赤	軽度認知障害
左手関節変形	変形性手関節症	股関節変形
蛋白尿（３＋）	蛋白尿	蛋白欠乏性貧血
左手首痛	手部痛	手部痛
びまん性肺胞出血	肺胞出血	びまん性肺胞傷害
続発性赤芽球癆	赤芽球ろう	続発性赤血球増加症
インフルエンザ菌	インフルエンザ	インフルエンザ
左舌区小細胞癌	小細胞肺癌	肺門部小細胞癌
左足背疼痛	足背痛	足背痛
成人発症Ｓｔｉｌｌ病（ＡＯＳＤ）	成人スチル病	成人発症ＩＩ型シトルリン血症
大球性正色素性貧血	正色素性貧血	正球性正色素性貧血
双極Ⅱ型障害	２型双極性障害	双極性感情障害
限局型全身性強皮症	全身性強皮症	限局性強皮症
右水晶体脱臼	水晶体脱臼	水晶体脱臼
心サルコイト゛ーシス	心サルコイドーシス	心サルコイドーシス
Ｓ状結腸高分化腺癌	Ｓ状結腸癌	Ｓ状結腸腺腫
右側頬部腫脹	頬部腫脹	側頚部腫脹
右上背部痛	背部痛	胸背部痛
両下肢痛み	疼痛	下肢痛
多発海綿状血管腫	多発性海綿状血管腫	多発性海綿状血管腫
結核歴	結核	結核腫
ＳＭＡ浸潤	膵癌	髄膜浸潤
微小癌	癌	微小斜視
慢性疼痛性障害	慢性疼痛	性同一性障害
高Ｃｌ血症	高クロール血症	高乳酸血症
乳頭状腺癌	癌	乳頭状汗腺腫
帯状疱疹ウイルス脊髄炎	ウイルス脊髄炎	エンテロウイルス脊髄炎
内臓播種性ＶＺＶ感染症	汎発性帯状疱疹	腸管出血性大腸菌感染症
様皮疹	発疹	ＬＥ皮疹
左帯状疱疹	帯状疱疹	耳帯状疱疹
骨形成不全症Ⅲ型	骨形成不全症	骨形成不全症３型
高度肥満症	病的肥満症	病的肥満症
右前頭葉脳内血腫	血腫	外傷性脳内血腫
マルチミニコア病	マルチコア病	マルチコア病
四肢関節腫脹	関節炎	足関節腫脹
右腸骨静脈血栓症	腸骨静脈圧迫症候群	腸骨動脈血栓症
脳底動脈閉塞	脳底動脈閉塞症	脳底動脈閉塞症
胸背部圧迫感	背部圧迫感	背部圧迫感
眼瞼結膜軽度貧血	貧血	眼瞼結膜出血
子宮頸癌Ⅲｂ期	子宮頚癌	子宮癌骨転移
傍卵巣嚢胞	傍卵巣のう胞	傍卵巣のう胞
肝内腫瘤性病変	腫瘤	頭蓋内占拠性病変
血管性紫斑病	症候性紫斑病	単純性紫斑病
時々右股関節痛	股関節痛	偽性股関節痛
ＡＳＤ	心房中隔欠損症	ＡＩＤＳ
緑膿菌肺感染症	緑膿菌肺炎	緑膿菌感染症
母子感染歴	母子感染	母子感染
ふらつきあり転倒リスク高い	めまい	抑うつ性パーソナリティ障害
頸腕症候群	頚肩腕症候群	頚肩腕症候群
食道癌術後リンパ節転移	リンパ節転移	大動脈周囲リンパ節転移
亜急性期小脳梗塞	小脳梗塞	多発性小脳梗塞
喘息コントロール	咳喘息	扁平コンジローマ
右膝違和感	全身違和感	全身違和感
腓骨神経麻痺徴候	腓骨神経麻痺	腓骨神経麻痺
中高分化型腺癌	癌	中葉肺腺癌
軽度脳梗塞	脳梗塞	小脳梗塞
身体外傷	外傷	心臓外傷
心源性塞栓症	心原性脳塞栓症	心原性脳塞栓症
左上腕骨近位端骨折	上腕骨近位端骨折	上腕骨近位端骨折
神経根性痛	疼痛	神経痛性歯痛
白色壊死組織付着	壊死	急性壊死性虫垂炎
夜間中途覚醒	睡眠障害	夜間異常知覚症
軽度肺動脈弁狭窄	肺動脈弁狭窄症	肺動脈弁狭窄症
転移性肝癌術後再発	転移性肝癌	直腸癌術後再発
無涙症	涙液分泌不全	無歯症
劇症Ａ型肝炎	Ａ型劇症肝炎	劇症肝炎
ｃｒｉｔｉｃａｌ　ｉｌｌｎｅｓｓ　ｐｏｌｙｎｅｕｒｏｐａｔｈｙ	多発ニューロパチー	ＨＨＶ８多中心性キャッスルマン病随伴大細胞型Ｂ細胞性リンパ腫
右眼増殖性糖尿病網膜症	増殖性糖尿病性網膜症	増殖性糖尿病性網膜症
右上腕腫脹	上腕部腫脹	上腕部腫脹
右側胸水貯留	胸水貯留	胸水貯留
水疱瘡	水疱症	水疱症
軽度高Ｋ血症	高カリウム血症	高銅血症
肝性脳症再発	肝性脳症	肝性脳症
水様便流出	下痢症	水様性鼻漏
二絨毛膜二羊膜性双胎第	二絨毛膜二羊膜性双胎	二絨毛膜二羊膜性双胎
浮腫傾向	浮腫	妄想傾向
骨Ｐａｇｅｔ病	骨パジェット病	骨パジェット病
Ｅｎｔａｍｏｅｂａ　ｈｉｓｔｏｌｙｔｉｃａ	アメーバ赤痢	Ｅｕｔｈｙｒｏｉｄ　Ｓｉｃｋ症候群
左頚部内頸動脈狭窄	内頚動脈狭窄症	頚部内頚動脈瘤
大腿筋横紋筋肉腫	横紋筋肉腫	大腿横紋筋肉腫
腸炎性関節炎	関節炎	若年性関節炎
ＰＭＳ	月経前症候群	ＨＤＬＳ
腓腹部圧痛	腹部圧痛	腹部圧痛
非チフス性Ｓａｌｍｏｎｅｌｌａ菌血症	菌血症	常染色体性劣性無ガンマグロブリン血症
微小多発肝膿瘍	肝膿瘍	多発性肝膿瘍
卵管狭窄	卵管狭窄症	卵管狭窄症
胸部大動脈解離	急性大動脈解離	急性大動脈解離
蜂窩織炎発症	蜂窩織炎	蜂窩織炎
輪状披裂関節炎	関節炎	輪状披裂関節捻挫
左下肢蜂窩織炎	下肢蜂巣炎	胃蜂窩織炎
肺塞栓	肺塞栓症	肺塞栓症
咽頭残留	嚥下障害	咽頭結核
低髄圧症状	低髄液圧症	低髄液圧症
左腓骨開放骨折	腓骨開放骨折	腓骨開放骨折
大量水様下痢	下痢症	大理石様皮膚
処方右乳癌	乳癌	乳輪部乳癌
症候性けいれん	症候性てんかん	症候性てんかん
低血糖回避	低血糖	低血糖昏睡
左慢性閉塞隅角緑内障	慢性閉塞隅角緑内障	慢性閉塞隅角緑内障
弧発性古典的ＣＪＤ	孤発性クロイツフェルト・ヤコブ病	突発性発疹関連脳症
呼吸機能低下	呼吸機能検査異常	耳管機能低下
右大腿リンパ節転移	リンパ節転移	後腹膜リンパ節転移
左第３趾潰瘍	趾皮膚潰瘍	第３脳室腫瘍
足変形	足部変形	足部変形
膝関節水腫	膝関節水症	肘関節水腫
腹部瘢痕ヘルニア	腹壁瘢痕ヘルニア	腹壁瘢痕ヘルニア
月経困難	月経困難症	月経困難症
左局所進行乳癌	進行乳癌	進行乳癌
好酸球性胆嚢炎	胆のう炎	好酸球性中耳炎
左下腿骨幹部骨折	骨折	上腕骨骨幹部骨折
即時型アレルギー	アレルギー	牛乳アレルギー
ふらつき有	めまい	みずかき趾
ループス腎炎Ｖ型	ループス腎炎	ループス腎炎
閉塞性睡眠時無呼吸症侯群	睡眠時無呼吸症候群	閉塞性睡眠時無呼吸
右下肢しびれ	下肢しびれ	下肢しびれ
頭部脂漏性皮膚炎	脂漏性皮膚炎	脂漏性皮膚炎
結核性ブドウ膜炎	結核性ぶどう膜炎	結核性脈絡網膜炎
左真珠腫性中耳炎再発	真珠腫性中耳炎	真珠腫性中耳炎
傍大動脈ＬＮ転移	大動脈周囲リンパ節転移	大動脈肺動脈窓
痙直型四肢麻痺	四肢麻痺	痙性四肢麻痺
角化性紅斑散在	紅斑症	遊走性紅斑
労作時呼吸苦自覚	労作時呼吸困難	労作時呼吸困難
慢性腎炎	慢性腎炎症候群	慢性腸炎
間質性肺炎像	間質性肺炎	間質性肺炎
嘔気様	嘔気	嘔気
左側頭葉皮質化出血	出血	頭部皮下出血
左上腕骨開放骨折	上腕骨開放骨折	上腕骨開放骨折
腹部膨満継続	腹部膨満	腹部膨満
右足底腱膜炎	足底筋膜炎	足底筋膜炎
両側顎関節症	顎関節症	顎関節症
出血性黄体	出血性黄体のう胞	出血性鼻茸
右鼡径部疼痛	鼡径部痛	鼡径部痛
高～中分化型管状腺癌	癌	膵管内管状腺癌
Ｌａｍｉｖｕｄｉｎｅ耐性Ｂ型肝硬変	Ｂ型肝硬変	無症候性原発性胆汁性肝硬変
遺伝性腎炎	家族性腎炎	遺伝性膵炎
湿疹化	湿疹	湿疹
左大腿部蜂窩織炎	大腿部蜂巣炎	大腿部蜂巣炎
下肢対麻痺	対麻痺	下肢単麻痺
成長発達遅滞	発達遅滞	運動発達遅滞
下腿点状出血	点状出血	点状出血
脈管奇形	奇形	神経管奇形
手指欠損	手指欠損症	手指欠損症
咽頭粘膜軽度発赤	咽頭発赤	咽頭発赤
可動時痛	疼痛	睡眠時頭痛
下垂手	垂れ手	下垂足
左陰嚢内容腫大	陰のう腫大	陰のう腫大
痰がからみ	喀痰	あから顔
朝出血	出血	橋出血
右鼠経ヘルニア修復術	鼡径ヘルニア	閉鎖孔ヘルニア嵌頓
ステロイド骨粗鬆症	ステロイド性骨粗鬆症	ステロイド性骨粗鬆症
足趾冷感	下肢冷感	下肢冷感
不整腫瘤	腫瘤	頬部腫瘤
腎前性脱水	脱水症	混合性脱水
左肩部痛	肩部痛	肩部痛
頸部皮下膿瘍	皮膚膿瘍	頭部皮下腫瘍
ウイルス性感冒	感冒	ウイルス性脳炎
多発腫大リンパ節	リンパ節腫大	腋窩急性リンパ節炎
腹部自発痛	腹痛症	腹部圧痛
中分化型前立腺癌	前立腺癌	進行性前立腺癌
左一側性形成不全性股関節症	一側性形成不全性股関節症	一側性形成不全性股関節症
好酸球性気道炎症	好酸球性気管支炎	好酸球性食道炎
腸管蠕動障害	腸管運動障害	腸管運動障害
褥瘡形成リスク高い	褥瘡	褥瘡・ステージＩＩ
腰椎変性辷り症	腰椎変性すべり症	腰椎変性すべり症
手術高血圧	高血圧症	白衣高血圧
嚥下下困難	嚥下障害	嚥下困難
てんかん脳波	異常脳波	てんかん
巨大血腫	血腫	巨大産道血腫
十二指腸原発神経内分泌腫瘍	十二指腸神経内分泌腫瘍	十二指腸神経内分泌腫瘍
腹水多量貯留	腹水症	胸水貯留
内腸骨リンパ節転移	腸骨リンパ節転移	腸骨リンパ節転移
ＣＭＶ胃腸炎	サイトメガロウイルス腸炎	神経性胃腸炎
瘢痕痙性	瘢痕	瘢痕拘縮
両Ｔ字杖歩行	歩行障害	よろめき歩行
便性状変化	便異常	性格変化
右血栓閉塞	血栓塞栓症	喉頭閉塞
出血付着程度	出血	出血性中耳炎
右海綿静脈洞髄膜腫	髄膜腫	海綿静脈洞症候群
虚血性心疾患合併	虚血性心疾患	虚血性心疾患
壊死性筋炎	筋炎	壊死性筋膜炎
全肺腫瘍	肺腫瘍	肺腫瘍
軽度構音障害	構音障害	軽度知的障害
両下腿紅斑	紅斑症	下腿母斑
低Ｃａ血症	低カルシウム血症	低補体血症
二次性副腎不全	副腎クリーゼ	急性腎不全
一週間程度眠気	非器質性過眠症	会陰第３度熱傷
子宮内腔癒着	子宮内膜症	子宮頚部癒着
項部硬直軽度	項部硬直	項部硬直
下熱	発熱	高熱
右母指陳旧性尺側側副靱帯損傷	靱帯損傷	母指ＩＰ関節尺側側副靱帯損傷
左気管支狭窄	気管支狭窄症	気管支狭窄症
皮膚型ＰＮ	結節性多発動脈炎	皮膚移植後
肺線維化	肺線維症	肺線維症
副鼻腔軽度粘膜肥厚	副鼻腔炎	副鼻腔内反性乳頭腫
味覚異常Ｇｒ１	味覚異常	味覚異常
中心視野欠損	視野欠損	視野欠損
昨晩低血糖	低血糖	低血糖
両水腎症	両側水腎症	両側水腎症
前回貧血	貧血	癌性貧血
骨粗鬆症性圧迫骨折	骨粗鬆症・病的骨折あり	腰椎陳旧性圧迫骨折
右肺原発肺腺癌	肺腺癌	胃原発絨毛癌
脊髄原発悪性リンパ腫	悪性リンパ腫	十二指腸悪性リンパ腫
手指浮腫	浮腫	手指腫脹
口内炎再発	口内炎	口内炎
皮質性認知症	皮質下認知症	皮質下認知症
足背発赤	発赤	咽頭発赤
後縦隔腫瘤	縦隔腫瘍	後縦隔腫瘍
頚椎症性脊椎症	脊椎症	頚椎症性脊髄症
中部延髄右外側脳梗塞	脳梗塞	無症候性多発性脳梗塞
仙骨部瘻孔	難治性瘻孔	仙骨部挫創
軽鎖沈着症	単クローン性軽鎖重鎖沈着症	結膜沈着症
右傍気管リンパ節転移	リンパ節転移	気管支リンパ節転移
ｓｍａｌｌ　ｃｅｌｌ　ｃａｒｃｉｎｏｍａ	癌	解離性大動脈瘤ＤｅＢａｋｅｙＩＩＩａ
遺伝性出血性毛細血管拡張症	オスラー病	特発性傍中心窩毛細血管拡張症
胸椎後縦靭帯骨化症	胸椎後縦靱帯骨化症	胸椎後縦靱帯骨化症
重症敗血症性ショック	敗血症性ショック	敗血症性ショック
間質性肺炎評価	間質性肺炎	間質性肺炎
右腎損傷	腎損傷	副腎損傷
右肺門部原発	原発性肺癌	肺門部肺癌
再発食道癌	食道癌	上部食道癌
不定愁訴多い	不定愁訴症	不定愁訴症
発熱再燃	発熱	発熱発疹
左肩関節痛	肩関節痛症	肩関節痛風
瘢痕様変化	瘢痕	性格変化
元々頻尿	頻尿症	夜間頻尿症
浮腫対策	浮腫	浮腫
核下性顔面神経麻痺	顔面神経麻痺	中枢性顔面神経麻痺
皮膚原発悪性リンパ腫	悪性リンパ腫	十二指腸悪性リンパ腫
市中感染型ＭＲＳＡ	ＭＲＳＡ感染症	急性感染症性精神病
左尿管結石	尿管結石症	腎尿管結石
乾性咳嗽頻回	乾性咳	慢性咳嗽
首痛	頚部痛	胸痛
右側頭部紫斑	紫斑病	側頭部母斑
薬剤過敏性症候群	薬物過敏症	薬剤性過敏症症候群
延長症候群	ＱＴ延長症候群	ＱＴ延長症候群
紫斑形成軽度	紫斑病	脊椎形成異常
両側肺動脈狭窄症	肺動脈狭窄症	肺動脈狭窄症
子宮筋腫核出後妊娠	妊娠	子宮筋腫摘出後後遺症
ＡＲＤＳ合併	急性呼吸窮迫症候群	ＡＩＤＳ
胆道系閉塞	胆道閉塞	胆道閉塞
軟骨損傷	肋軟骨損傷	肋軟骨損傷
右副腎原発	副腎腫瘍	副腎異常
ｋｌｅｂｓｉｅｌｌａ　ｐｎｅｕｍｏｎｉａｅ感染症	クレブシェラ属感染	アデニンホスホリボシルトランスフェラーゼ欠損症
パ−キンソン症候群	パーキンソン症候群	パーキンソン症候群
右原発性肺癌	原発性肺癌	原発性肺癌
敗血症性ショック状態	敗血症性ショック	敗血症性ショック
時々発疹	発疹	全身発疹
めまい軽度	めまい	めまい発作
右横隔膜筋欠損	筋欠損	横隔膜欠損
脳症後遺症	脳症	脳炎後遺症
胸膜悪性中皮腫	悪性胸膜中皮腫	悪性中皮腫
漿膜損傷	損傷	硬膜損傷
頸椎症性	頚椎症	半椎症
多発外傷	多発性外傷	多発性外傷
皮膚損傷起	皮膚損傷	皮膚損傷
ふらつき目立	めまい	よろめき歩行
近位筋痛	筋肉痛	肩部筋痛
採血上脱水	脱水症	混合性脱水
脳血管芽腫	小脳血管芽腫	小脳血管芽腫
右慢性中耳炎	慢性中耳炎	慢性中耳炎
アレルギー様	アレルギー	アレルギー
ノカルジア脳膿瘍	ノカルジア症	ノカルジア症
大腸ポリープ有	大腸ポリープ	大腸ポリープ
右後頭部帯状疱疹	後頭部帯状疱疹	後頭部帯状疱疹
右頚部結核性リンパ節炎	結核性リンパ節炎	頚部化膿性リンパ節炎
陳旧性多発アテローム血栓性脳梗塞	陳旧性アテローム血栓性脳梗塞	陳旧性アテローム血栓性脳梗塞
誤嚥徴候	異物誤嚥	誤嚥性肺炎
右前腕皮疹	発疹	前腕皮膚癌
多発肺腫瘤	肺腫瘤	多発性皮下腫瘤
後腹膜浸潤	後腹膜悪性腫瘍	後腹膜気腫
網状紫斑	紫斑病	網状皮斑
胚細胞腫瘍	腫瘍	脳胚細胞腫瘍
ゲノタイプ１ｂ型Ｃ型肝硬変	Ｃ型肝硬変	無症候性原発性胆汁性肝硬変
類円形腫大	リンパ節腫大	陰のう腫大
中枢性気管支拡張像	気管支拡張症	結核性気管支拡張症
小股歩行	歩行異常	小刻み歩行
脳血管傷害	脳血管障害	脳血管障害
糖尿病末梢神経障害	糖尿病性単ニューロパチー	糖尿病性末梢神経障害
ルンバール後頭痛	腰椎穿刺後頭痛	慢性外傷後頭痛
急性重症Ｂ型肝炎	Ｂ型肝炎	急性薬物性肝炎
下垂時疼痛	疼痛	下垂体腺腫
頚部蜂窩織炎	頚部蜂巣炎	頚部蜂巣炎
腹満不変	腹部膨満	腹部不快感
一過性心筋虚血	心筋虚血	一過性脊髄虚血
日勤帯発熱	発熱	産褥性発熱
結核性喉頭狭窄	喉頭狭窄症	先天性喉頭狭窄症
両側鼻内ポリープ	鼻茸	副鼻腔ポリープ
手掌潮紅	紅潮	手掌腫瘤
低血糖歴何年	低血糖	低血糖性脳症
離床時眩暈	めまい	起立性眩暈
高齢者Ｃ型慢性肝炎	Ｃ型慢性肝炎	Ｃ型慢性肝炎
ＳＬＥ発症	全身性エリテマトーデス	ＳＬＥ眼底
軽度咽頭違和感	咽頭異常感症	肛門部違和感
体熱感	不明熱	体幹熱傷
悪性腫瘍評価	悪性腫瘍	悪性腫瘍
発赤領域	発赤	発赤
閉塞性大腸癌	大腸癌	閉塞性大腸炎
子宮頚部ポリープ	子宮頚管ポリープ	子宮頚管ポリープ
両側大腰筋血腫	血腫	巨大産道血腫
ＰＳＬＮ転移	大動脈周囲リンパ節転移	子宮癌骨転移
咽頭部疼痛	咽頭痛	陰茎部疼痛
肺腫瘍塞栓症	肺腫瘍	肺血栓塞栓症
羊水過多	羊水過多症	羊水過多症
筋肉痛症状	筋肉痛	筋肉痛
心外膜石灰化	心膜石灰化	心膜石灰化
右下肢急性動脈閉塞症	下肢急性動脈閉塞症	下肢急性動脈閉塞症
４型進行胃癌	胃進行癌	胃進行癌
圧迫性脊髄症	脊髄症	圧迫性脊髄炎
出血源不明	出血	出血性腸炎
貧血性網膜症	貧血網膜症	貧血網膜症
椎間板突出	椎間板症	椎間板変形
カルチノイド腫瘍	カルチノイド	カルチノイド
心臓内腫瘤	腫瘤	骨盤内腫瘤
日中気分不快	悪心	肺換気不全
多発性嚢胞肝	多発性肝のう胞	多発性のう胞腎
仙骨奇形	仙骨部奇形	仙骨部奇形
けいれん再発	痙攣	腸重積症再発
遊走性静脈炎	遊走性血栓性静脈炎	遊走性胸膜炎
左胸膜炎	胸膜炎	胸膜炎
直腸癌術後異時性肝転移	転移性肝癌	直腸癌術後再発
手指痺れ	しびれ感	手指腫脹
左卵管水腫	卵管留水症	卵管筋腫
歩行時呼吸困難	労作時呼吸困難	労作時呼吸困難
ガーゼ出血	出血	網膜下出血
老人性紅皮症	紅皮症	老人性乾皮症
右被殻脳梗塞	被殻出血	出血性脳梗塞
自律神経ニューロパチー	自律神経性ニューロパチー	自律神経性ニューロパチー
子宮頚部嚢胞	子宮頚部腫瘍	子宮頚部癒着
右原発閉塞隅角緑内障	原発閉塞隅角緑内障	原発閉塞隅角緑内障
腺腫内癌	癌	大腸腺腫内癌
両下肢浮腫軽度	下肢浮腫	下肢浮腫
右化膿性肩関節炎	化膿性関節炎・肩関節	化膿性顎関節炎
膣転移	腟癌	骨盤転移
体力低下著明	体力低下	体力低下
左小脳陳旧性梗塞	陳旧性脳梗塞	陳旧性脳梗塞
淡黄色粘稠痰	喀痰	黄色線維腫
外傷所見	外傷	外傷性健忘
発赤局面	発赤	発赤
膀胱癌既往	膀胱癌	膀胱癌検診
左末梢性肺動脈狭窄	肺動脈狭窄症	末梢性肺動脈狭窄症
骨代謝異常	代謝障害	脂質代謝異常
心陰影拡大	胸部異常陰影	心拡大
腎動脈下腹部大動脈瘤	腹部大動脈瘤	破裂性胸腹部大動脈瘤
腸管壁内気腫	皮下気腫	血管内皮腫
慢性活動性ＥＢＶ感染症	ＥＢウイルス感染症	慢性特発性偽性腸閉塞症
足関節圧痛	関節痛	足関節痛
夕方発熱	発熱	悪寒発熱
顔面紅班	紅斑症	顔面紅潮
排便痛	排便障害	排卵痛
左水腎	水腎症	融合腎
代謝異常	代謝障害	脂質代謝異常
両下肢リンハ゜浮腫	下肢リンパ浮腫	上下肢リンパ浮腫
左頸部ＬＮ腫脹	肘リンパ節腫脹	大腿部腫脹
肺門部リンパ節腫脹	リンパ節腫大	肺門リンパ節腫脹
呼吸困難感軽度	呼吸麻痺	呼吸困難発作
左膝窩動脈血栓症	動脈血栓症	腋窩動脈血栓症
左股関節脱臼	股関節脱臼	股関節脱臼
ルーフ゜ス腎炎	ループス腎炎	ループス腎炎
鼠径部腫脹	鼡径部腫脹	鼡径部腫脹
内鼠径ヘルニア	内鼡径ヘルニア	内鼡径ヘルニア
左頬部血管腫	頬部血管腫	頬部血管腫
開口制限	開口不全	開排制限
変形性関節炎	変形性関節症	変形性関節症
初回歩行時ふらつき	よろめき歩行	緩徐進行１型糖尿病
洞性頻脈	洞頻脈	洞頻脈
腹膜播種巣	腹膜播種	腹膜播種
アレルギ—性結膜炎	アレルギー性結膜炎	アレルギー性結膜炎
鼠径部血腫	血腫	会陰部血腫
暗赤色嘔吐	嘔吐症	機能性嘔吐
直腸癌ＯＰ	直腸癌	直腸癌穿孔
左増殖性糖尿病網膜症	糖尿病網膜症	増殖性糖尿病性網膜症
レム睡眠行動異常	異常行動	レム睡眠行動障害
左大腿有棘細胞癌	大腿有棘細胞癌	大腿有棘細胞癌
声帯癌	声門癌	仮声帯癌
左大腿部疼痛	大腿痛	大腿神経痛
右顎関節症	顎関節症	顎関節症
骨頭壊死	骨壊死	喉頭壊死
中枢神経浸潤	中枢神経系損傷	中枢神経系損傷
直腸皮下瘻孔	難治性瘻孔	直腸皮膚瘻
胆嚢腫大	胆のう肥大	胆管腫瘍
Ｈｅｅｒｆｏｒｄｔ症候群	ぶどう膜耳下腺熱	ＴｒｉｐｌｅＡ症候群
前立腺癌既往	前立腺癌	前立腺癌検診
ダグラス窩腹水	腹水症	ダグラス窩結核
失見当障害	見当識障害	見当識障害
ツツガムシ感染症	つつが虫病	ＭＲＣＮＳ感染症
特発性血小板減少症紫斑病	特発性血小板減少性紫斑病	特発性血小板減少性紫斑病
前立腺浮腫	浮腫	前立腺肉腫
胞性腫瘤	腫瘤	化膿性腫瘤
右鼠径リンパ節腫脹	鼡径部リンパ節腫脹	後頭部リンパ節腫脹
ＡＡＡ破裂	腹部大動脈瘤	網脈膜破裂
夜間覚醒	不眠症	夜間多尿
初発癌	癌	多発乳癌
右迷走神経鞘腫	神経鞘腫	眼窩内神経鞘腫
痙攣様	痙攣	痙攣
機会誤嚥	嚥下障害	異物誤嚥
大腿静脈血栓	静脈血栓症	大腿静脈血栓症
股関節部骨折	股関節骨折	股関節骨折
吸収不全症侯群	吸収不良症候群	吸収不良症候群
新生血管緑内障	緑内障	新生児緑内障
甲状腺低下症	甲状腺機能低下症	甲状腺機能低下症
アメーバ肝膿瘍	肝アメーバ症	アメーバ性肝膿瘍
先天性真珠腫	真珠腫	先天性がま腫
頭部皮膚欠損	頭部皮膚欠損創	頭部皮膚欠損創
右肺門部浸潤影	胸部異常陰影	肺門部異常陰影
食道悪性腫瘍	食道癌	食道良性腫瘍
傍大動脈リンパ節転移	大動脈周囲リンパ節転移	大動脈周囲リンパ節転移
ビタミンＤ欠乏	ビタミンＤ欠乏症	ビタミンＤ欠乏症
レントゲン異常	胸部異常陰影	インスリン異常症
器質的心疾患	心疾患	先天性心疾患
温痛覚	温痛覚過敏	温痛覚過敏
両側内反足	内反足	扁平内反足
低酸素症状	低酸素性脳症	低酸素血症
粘稠痰少量	喀痰	粘液脂肪腫
ダンベル型腫瘍	腫瘍	テント下脳腫瘍
催不整脈作用	不整脈	抗不整脈剤副作用
左腋窩汗腺癌	汗腺癌	腋窩部乳癌
感染性仮性嚢胞	仮性膵のう胞	感染性精巣水瘤
乳房熱感	ほてり	乳房熱傷
大腸穿孔	腸穿孔	結腸穿孔
腎瘢痕	瘢痕	瘢痕
孤立性左室緻密化障害	孤立性心筋緻密化障害	孤立性心筋緻密化障害
進行性顔面片側萎縮症	顔面痙攣症	顔面半側萎縮症
左手関節痛	手関節痛	手関節痛
右鼠径部腫脹	鼡径部腫脹	鼡径部腫脹
びりびりしたしびれ	しびれ感	四肢端しびれ
発赤軽減	発赤	発赤
悪寒等	悪寒	悪寒
非逆流性食道炎	食道炎	逆流性食道炎
甲状腺萎縮	後天性甲状腺萎縮	甲状腺疾患
呼吸苦自覚症状	呼吸困難	呼吸性嗅覚障害
多発単神経障害	多発性単ニューロパチー	多発性神経障害
中毒性	中毒	中毒疹
右肺上葉結節影	胸部異常陰影	精巣上体結核
骨膜肥厚	肥厚性皮膚骨膜症	滑膜肥厚
リステリア感染症	リステリア症	リステリア症
アルコール性脂肪性肝炎	アルコール性脂肪肝	非アルコール性脂肪性肝炎
脳室穿破	脳出血	脳室拡大
鼠径部リンパ節腫大	鼡径部リンパ節腫脹	鼡径部リンパ節腫脹
吐気治	嘔気	無気肺
右鼡径部リンパ節腫脹	鼡径部リンパ節腫脹	鼡径部リンパ節腫脹
多発肺塞栓	肺塞栓症	多発性腐蝕
右腋窩リンパ節転位	腋窩リンパ節転移	腋窩リンパ節転移
重度右片麻痺	片麻痺	交代性片麻痺
両側乳房腫瘤	乳房腫瘤	乳房腫瘤
原発不明癌頸部リンパ節転移	頚部リンパ節転移	鼡径部リンパ節転移
後腹膜脂胞肉腫	後腹膜脂肪肉腫	後腹膜脂肪肉腫
胆管閉塞機転	胆管閉塞症	胆管閉塞症
右下葉原発扁平上皮癌	下葉肺扁平上皮癌	下葉肺扁平上皮癌
腰椎圧迫骨折既往	腰椎圧迫骨折	腰椎圧迫骨折
便秘悪化	便秘症	便秘症
潜血３	顕微鏡的血尿	多血症
アレルギー性血管浮腫	浮腫	アレルギー性血管炎
肺動脈分岐部狭窄	肺動脈分岐部狭窄症	肺動脈分岐部狭窄症
顕微的血尿	血尿	顕微鏡的血尿
右鼡径リンパ節腫脹	鼡径部リンパ節腫脹	鼡径部リンパ節腫脹
左足多趾症	多趾症	多趾症
日中痛み	疼痛	趾骨痛症
不安感	不安障害	不安障害
眼球運動痛	疼痛	眼球運動痙攣
腰椎変性側弯症	腰椎側弯症	変性側弯症
右腎低形成	低形成腎	右室低形成
Ｙｅｒｓｉｎｉａ　ｅｎｔｅｒｏｃｏｌｉｔｉｃａ感染症	エルシニア菌食中毒	大動脈弁狭窄症兼僧帽弁閉鎖不全症兼三尖弁閉鎖不全症
膿胸合併肺放線菌症	肺放線菌症	肺放線菌症
チクチク痛む	チクチク感	チクチク感
左水尿管症	水尿管症	水尿管症
多発肺内転移	転移性肺癌	多発性癌転移
左下葉肺癌断端再発	下葉肺癌	下葉肺扁平上皮癌
右大腿部発赤	下腿発赤	大腿部膿瘍
右顔面打撲	顔面打撲傷	顔面打撲傷
糖尿病性自律神経障害	糖尿病性自律神経ニューロパチー	糖尿病性末梢神経障害
分破水	破水	破水
重症マイコプラズマ肺炎	マイコプラズマ肺炎	マイコプラズマ肺炎
卵巣嚢腫破裂	卵巣のう腫破裂	卵巣のう腫破裂
抗原血症	サイトメガロウイルス感染症	高脂血症
褥瘡発症	褥瘡	褥瘡感染
甲状軟骨浸潤	甲状軟骨の悪性腫瘍	甲状軟骨骨折
潜在性副腎皮質機能低下症	副腎皮質機能低下症	続発性副腎皮質機能低下症
眼球陷凹	眼球陥没	眼球斜位
両足趾潰瘍	趾皮膚潰瘍	吻合部潰瘍
過換気症状	過換気症	過換気症
左鎖骨下リンパ節転移	リンパ節転移	鎖骨上リンパ節転移
上右卵管留血腫	卵管留血腫	卵管留血腫
濾胞性リンパ腫再発	濾胞性リンパ腫	濾胞性リンパ腫
両眼糖尿病性網膜症	糖尿病網膜症	１型糖尿病性網膜症
左外傷性大腿骨頭壊死	外傷性大腿骨頭壊死	外傷性大腿骨頭壊死
肝臓病変	肝疾患	肝臓紫斑病
右第１趾潰瘍	趾皮膚潰瘍	手部皮膚潰瘍
腋窩痛	腋窩部痛	腋窩部痛
踵部発赤	発赤	咽頭発赤
両側ぶどう膜炎	ぶどう膜炎	汎ぶどう膜炎
右アスペルギルス肺炎	肺アスペルギルス症	肺アスペルギルス症
痔疾患	痔核	肝疾患
無疱疹帯状疱疹	帯状疱疹	外陰部帯状疱疹
吐き気軽度	嘔気	う蝕第２度
非結核性抗酸菌性人工関節感染症	非結核性抗酸菌症	非結核性抗酸菌性股関節炎
両下肢不随意運動	不随意運動症	異常不随意運動
前胸痛	胸痛	前胸部痛
洞結節不全症候群	洞不全症候群	洞不全症候群
結腸皮膚瘻	皮膚瘻	直腸皮膚瘻
患肢熱感	ほてり	四肢熱傷
両側腎膿瘍	腎膿瘍	腎膿瘍
右喉頭腫瘍	喉頭腫瘍	喉頭腫瘍
潜血	顕微鏡的血尿	便潜血
細菌性脳動脈瘤破裂	脳動脈瘤破裂	先天性脳動脈瘤破裂
右鼡径部皮下出血	皮下出血	眼周囲部皮下出血
右下腿筋肉内出血	筋肉内血腫	下腿筋肉内異物残留
痒感	そう痒	痒疹
大動脈リンパ節転移	大動脈周囲リンパ節転移	大動脈周囲リンパ節転移
心内血栓	心内血栓症	心内血栓症
術後出血	後出血	術後貧血
気分悪	悪心	気分異常
腰部脊椎管狭窄症	腰部脊柱管狭窄症	腰部脊柱管狭窄症
遠位弓部嚢状動脈瘤	動脈瘤	弓部大動脈瘤
左総腸骨動脈狭窄	総腸骨動脈狭窄	総腸骨動脈狭窄
尿潜血遷延	顕微鏡的血尿	便潜血
夜間悪寒	悪寒	夜間遺尿
造骨性骨転移	骨転移癌	膵臓癌骨転移
腫瘍制御	腫瘍	腫瘍
失調性構音障害	構音障害	痙縮性構音障害
右上腕骨頸部骨折	上腕骨頚部骨折	上腕骨頚部骨折
リンハ゜節腫大	リンパ節腫大	リンパ節腫大
皮疹拡大傾向	発疹	妄想傾向
依然浮腫	浮腫	高度浮腫
右足底部蜂窩織炎	足蜂巣炎	胃蜂窩織炎
血栓閉塞型大動脈解離	早期血栓閉鎖型大動脈解離	早期血栓閉鎖型大動脈解離
急性期脳血管障害	脳血管障害	閉塞性脳血管障害
朝方痰	喀痰	膿性痰
進行性直腸癌	直腸癌	進行性前立腺癌
小腸型クローン病	小腸クローン病	小腸クローン病
軽度すりガラス影	胸部異常陰影	軽度栄養失調症
二次性血小板増多症	血小板増加症	二次性血小板増加症
胃膵嚢胞	膵のう胞	胃のう胞
最近浮腫	浮腫	顔面浮腫
右顔面疼痛	顔面痛	顔面痛
便失禁多量	便失禁	便失禁
労作時頻脈	頻脈症	労作性失神
両下肢結節性紅斑	結節性紅斑	らい性結節性紅斑
重症胆管炎	胆管炎	慢性胆管炎
右側胸部痛	胸痛	側胸部痛
右小指基節骨骨折	小指基節骨骨折	小指基節骨骨折
右足背腫脹	足背腫脹	足背腫脹
右上肢発赤	発赤	四肢発疹
呂律のまわりにくさ	構音障害	結膜のう酸化学熱傷
アミオダロン誘発性甲状腺中毒症	薬剤性甲状腺機能障害	人為的甲状腺中毒症
左胸部痛	胸痛	前胸部痛
右大腿痛	大腿痛	大腿痛
左下腿ＤＶＴ	下腿静脈血栓症	下腿類乾癬
動悸等症状	動悸	卵巣欠落症状
紫斑	紫斑病	紫斑病
致死性不整脈出現	不整脈	心因性不整脈
顆粒膜細胞腫	卵巣顆粒膜細胞腫	卵巣顆粒膜細胞腫
一瞬痛み	疼痛	落ち込み
意識障害患者	意識障害	意識障害
切迫早産腹緊	切迫早産	切迫早産
難治性皮膚非定型抗酸菌症	非結核性抗酸菌症	皮膚非結核性抗酸菌症
頚部鈍痛	鈍痛	頚部痛
発赤範囲	発赤	発赤
左腕腫脹	前腕腫脹	前腕腫脹
右肺上葉陰影	胸部異常陰影	肺腫瘤陰影
右上葉肺結節	結節性肺結核	上葉肺腺癌
空腹時高血糖	高血糖症	新生児低血糖
右麻痺	片麻痺	片麻痺
味覚変化	味覚障害	味覚障害
器質化肺炎	特発性器質化肺炎	間質性肺炎
浮腫悪化	浮腫	浮腫
凝固異常症	血液凝固異常	感覚異常症
右側頭葉脳梗塞	脳梗塞	血栓性小脳梗塞
両側下顎骨折	下顎骨骨折	両側下肢多発骨折
左頭頂葉神経膠腫	頭頂葉神経膠腫	頭頂葉神経膠腫
骨盤内多発リンパ節転移	骨盤内リンパ節転移	骨盤内リンパ節転移
直腸閉塞	直腸閉鎖	結腸閉塞
運動ニューロン病	運動ニューロン疾患	運動ニューロン疾患
肺犬糸状虫症	犬糸状虫症	犬糸状虫症
軽度骨棘	骨棘	軽度難聴
疲労感少	疲労感	疲労感
多発性肝腫瘤	肝腫瘍	多発性皮下腫瘤
意味性錯語	文意失語症	流暢性失語
ｃｏａｒｓｅ　ｃｒａｃｋｌｅｓ	湿性ラ音	Ｅｕｔｈｙｒｏｉｄ　Ｓｉｃｋ症候群
緑色下痢便	下痢症	緑色便
皮膚損傷リスク	皮膚損傷	皮膚損傷
左母指痛	母指痛	母指痛
ＡＶブロック	房室ブロック	二枝ブロック
前縦隔ＬＮ転移	縦隔リンパ節転移	前縦隔脂肪肉腫
間質性肺炎発症	間質性肺炎	間質性肺炎
外側脱臼	脱臼	胸椎脱臼
右環指基節骨骨折	環指基節骨骨折	環指基節骨骨折
左殿部疼痛	殿部痛	陰茎部疼痛
両側錐体路障害	錐体路障害	錐体路障害
両足しびれ	下肢しびれ	半身しびれ
膜性増殖性	膜性増殖性糸球体腎炎	膜性咽頭炎
頻脈性心房粗動	心房粗動	頻脈性心房細動
下肢血流障害	下肢血行障害	下肢血行障害
左肺上葉大細胞癌	上葉肺大細胞癌	肺門部大細胞癌
結核性肋膜炎	結核性胸膜炎	結核性胸膜炎
疼痛有	疼痛	疼痛
実質外腫瘤	腫瘤	後頭部腫瘤
骨盤部リンパ節転移	骨盤内リンパ節転移	骨盤内リンパ節転移
左三叉神経帯状疱疹	三叉神経帯状疱疹	三叉神経帯状疱疹
間質性肺炎悪化	間質性肺炎	間質性肺炎
仙骨部骨折	仙骨骨折	仙骨骨折
重症低体温症	低体温	新生児低体温症
関節炎悪化	関節炎	関節炎
右尖足	尖足	尖足
両手指浮腫	浮腫	下眼瞼浮腫
左主気管支狭窄	気管支狭窄症	気管支狭窄症
浸潤癌化	癌	性格変化
就寝後呼吸困難	呼吸困難	心臓性呼吸困難
仮性膵嚢胞	仮性膵のう胞	仮性膵のう胞
右肺上葉癌	上葉肺癌	肺上皮内癌
訪室時疼痛	疼痛	心因性疼痛
膠原病様症状	膠原病	膠原病性心膜炎
軽度黄染	黄疸	軽度近視
転移性膵癌	膵癌	転移性乳癌
除皮質硬直様	除皮質硬直	除皮質硬直
間歇跛行	間欠性跛行	間欠性跛行
動脈瘤コイル塞栓術	動脈瘤	動脈瘤様骨のう腫
紅斑散在	紅斑症	紅斑症
右膝疼痛	膝関節痛	術後疼痛
食思不振傾向	食欲不振	食欲不振
皮内腫瘍	腫瘍	皮膚腫瘍
左前床突起部髄膜腫	髄膜腫	小脳円蓋部髄膜腫
右脳梗塞	脳梗塞	小脳梗塞
軽度腹部痛	腹痛症	腓腹部痛
多発毛細血管拡張	オスラー病	脳毛細血管拡張症
不整脈誘発	不整脈	不整脈
左肺動脈ＰＥ	肺動脈血栓塞栓症	左胃動脈瘤
胃潰瘍再発	胃潰瘍瘢痕	胃潰瘍瘢痕
境界域精神発達遅滞	知的障害	自閉性精神発達遅滞
胆石膵炎	胆石性膵炎	胆石性膵炎
右腕頭動脈瘤	腕頭動脈瘤	腕頭動脈瘤
外陰部ｐａｇｅｔ癌	外陰部パジェット病	外陰部有棘細胞癌
リウマチ様症状	関節リウマチ	リウマチ様関節炎
肺癌性リンパ管症	癌性リンパ管症	癌性リンパ管症
左上腕骨顆部骨折	上腕骨顆部骨折	上腕骨顆部骨折
骨盤位妊娠	骨盤位	骨盤位分娩
大腿骨骨折後	大腿骨骨折	大腿骨骨折
左椎間孔狭窄	結合組織性椎間孔狭窄症	骨性椎間孔狭窄症
前立腺軽度腫大	前立腺肥大症	前立腺良性腫瘍
下顎腫脹	下顎部腫脹	下顎部腫脹
鼻中隔弯曲	鼻中隔弯曲症	鼻中隔弯曲症
大腸憩室症	多発性大腸憩室症	結腸憩室症
逆流性食道炎無	逆流性食道炎	逆流性食道炎
致死性偽膜性腸炎	偽膜性腸炎	偽膜性腸炎
眼窩蜂窩織炎	眼窩蜂巣炎	眼窩蜂巣炎
排尿後痛	排尿痛	排尿痛
右腹痛	腹痛症	腰腹痛
嚥下耳痛	耳痛症	嚥下痛
茶色出血	出血	尿道出血
左下葉扁平上皮癌	下葉肺扁平上皮癌	下葉肺扁平上皮癌
右腎梗塞	腎梗塞	副腎梗塞
原発性ヘモクロマトーシス	ヘモクロマトーシス	続発性ヘモクロマトーシス
右前頭葉膠芽腫	前頭葉膠芽腫	前頭葉膠芽腫
急性水頭症	水頭症	耳性水頭症
活動性肺結核所見	活動性肺結核	活動性肺結核
右眼白内障	白内障	核性白内障
本日胸痛	胸痛	胸痛
直腸膀膀胱窩	直腸膀胱瘻	直腸膀胱瘻
頚部結核性リンパ節炎	結核性リンパ節炎	頚部化膿性リンパ節炎
左橈骨遠位骨折	橈骨遠位端骨折	橈骨遠位端骨折
逆行性Ｐ波	心電図異常	逆行性射精症
しびれない	しびれ感	しびれ感
臀部圧痛	圧痛	腹部圧痛
咽頭血腫	咽頭部血腫	咽頭血管腫
膀胱癌再発	膀胱癌	子宮癌再発
多発皮下転移	皮下腫瘍	多発性癌転移
両側肺動脈血栓塞栓症	肺動脈血栓塞栓症	肺動脈血栓塞栓症
副鼻腔病変	副鼻	副鼻腔異物
安静時呼吸苦	呼吸困難	安静時狭心症
左胸膜播種	胸膜播種	胸膜播種
陰嚢疼痛	陰のう痛	陰茎部疼痛
上眼瞼腫脹	眼瞼浮腫	上眼瞼母斑
右下肢複雑骨折	開放骨折	下肢多発骨折
可動性良好腫瘤	腫瘤	多発性皮下腫瘤
両頬部発赤	発赤	両果部骨折
感染性肝嚢胞	肝のう胞	感染性白癬症
左鼡径部腫脹	鼡径部腫脹	鼡径部腫脹
突然呼吸困難	呼吸困難	夜間呼吸困難
皮下出血斑	皮下出血	皮下出血
右下腿骨髄炎	大腿骨骨髄炎	下腿骨骨髄炎
平行機能障害	平衡異常	膀胱機能障害
元々杖歩行	歩行障害	そとわ歩行
両下肢腫脹	下肢腫脹	下肢腫脹
左傍矢状洞髄膜腫	傍矢状洞髄膜腫	傍矢状洞髄膜腫
限局性皮膚硬化型全身性強皮症	全身性強皮症	特発性後天性全身性無汗症
毎回失禁	尿失禁症	便失禁
右小脳腫瘍	小脳腫瘍	小脳腫瘍
続発性サルコペニア	サルコペニア	サルコペニア
非医原性左尿管狭窄	尿管狭窄	先天性尿管狭窄症
下腿血腫	血腫	下腿血管腫
逆流性膀胱炎	膀胱尿管逆流	単純性膀胱炎
覚醒時疼痛	疼痛	心因性疼痛
左大転子部発赤	発赤	大転子部挫創
卵巣原発腫瘍	卵巣腫瘍	卵巣悪性腫瘍
リンパ腫再発	悪性リンパ腫	リンパ腫
重度運動障害性構音障害	構音障害	運動障害性構音障害
右肩周囲炎	肩周囲炎	肩周囲炎
軽度動悸	動悸	軽度難聴
左ポスナーシュロスマン症候群	ポスナーシュロスマン症候群	ポスナーシュロスマン症候群
液体貯留	体液貯留	胸水貯留
低張性低ナトリウム血症	低ナトリウム血症	本態性低ナトリウム血症
癌性胸腹膜炎	癌性腹膜炎	癌性腹膜炎
心臓内腫瘍	心臓腫瘍	心臓腫瘍
左坐骨神経麻痺	坐骨神経麻痺	坐骨神経麻痺
リステリア髄膜脳炎	リステリア性髄膜脳炎	リステリア性髄膜脳炎
点圧痛	圧痛	圧痛
帯状疱疹ウイルス脳炎	帯状疱疹性脳炎	エンテロウイルス脳炎
齲蝕	う蝕	腐蝕
腎性急性腎障害	腎障害	薬物性腎障害
喉頭嚢胞	喉頭のう胞	喉頭のう胞
甲状腺乳頭腺癌	甲状腺乳頭癌	甲状腺乳頭癌
左上下肢しびれ	半身しびれ	下肢しびれ
心筋傷害	心筋疾患	心筋不全
圧迫性骨折	圧迫骨折	圧迫骨折
胆嚢胆石	胆泥	胆道結石
縱隔リンパ節転移	縦隔リンパ節転移	縦隔リンパ節転移
悪性細胞	癌	悪性貧血
Ｌｉｓｔｅｒｉａ　ｍｏｎｏｃｙｔｏｇｅｎｅｓ敗血症	敗血症	大動脈弁閉鎖不全症兼僧帽弁狭窄症兼三尖弁閉鎖不全症
パニック症侯群	パニック障害	ズデック症候群
アレルギー性肺アスペルギルス症	アレルギー性気管支肺アスペルギルス症	アレルギー性気管支肺アスペルギルス症
左下肢原発性リンパ浮腫	リンパ浮腫	上下肢リンパ浮腫
呼気時喘鳴	喘鳴	先天性喘鳴
落ち着かない	多動性障害	落ち込み
苦悶症状	胸内苦悶	尿毒症肺
トルーソー症候群	トルソー症候群	トルソー症候群
全身浮腫不変	全身性浮腫	全身性浮腫
左側頭円蓋部髄膜腫	円蓋部髄膜腫	小脳円蓋部髄膜腫
周術期喘息発作	気管支喘息発作	気管支喘息発作
薬剤性副腎不全	副腎皮質機能低下症	薬剤性腎障害
乳がん	乳癌	乳び胸
巣状分節状糸球体硬化症	巣状糸球体硬化症	巣状糸球体硬化症
口腔乾燥感	口腔乾燥症	口腔乾燥症
右手関節尺側部痛	手関節痛	手関節掌側部挫創
右上顎洞真菌症	上顎洞炎	深在性真菌症
鮮血便	血便	粘血便
心配症	心配	心身症
アシドーシス進行	アシドーシス	アシドーシス
右足滑液包炎	滑液包炎	肘頭滑液包炎
第５胸椎転移	胸椎転移	胸椎転移
表出性言語発達遅滞	言語発達遅滞	言語発達遅滞
発作性心房細動既往	発作性心房細動	発作性心房細動
左リウマチ性膝関節症	関節リウマチ・膝関節	関節リウマチ・膝関節
左大腿部痛	大腿痛	大腿筋痛
隆起性病変	胃ポリープ症	萎縮性肝硬変
腫瘤状構造	腫瘤	充填物粗造
細菌性赤痢感染症	赤痢	細菌性下痢症
多数骨折	骨折	多発骨折
門脈右枝血栓	門脈血栓症	門脈ガス血症
３型進行癌	癌	胃進行癌
倦怠感等	倦怠感	倦怠感
全頭脱毛症	脱毛症	全身性脱毛症
筋攣縮	筋痙縮	筋痙縮
元々徐脈	徐脈	胎児徐脈
特発性側彎症	特発性側弯症	特発性側弯症
回盲部放線菌症	放線菌症	回盲部腸重積症
ｆａｎ症候群	マルファン症候群	梨状筋症候群
脊椎椎間板炎	椎間板炎	頚椎椎間板炎
起始異常	冠動脈起始異常	副腎異常
右眼球破裂	眼球破裂	眼球破裂
介助　疼痛	疼痛	抜歯後疼痛
前失神	失神	咳失神
ふらつき感自覚	よろめき歩行	よろめき感
低分化型肝細胞癌	肝細胞癌	仙骨部基底細胞癌
右葉間胸水	葉間胸水	葉間胸水
子宮内膜症性卵巣嚢胞	卵巣子宮内膜症のう胞	卵巣子宮内膜症のう胞
腎嚢胞出血	傍腎盂のう胞	腎周囲出血
無症候性キャリア	ＨＴＬＶ−１キャリア	無症候性神経梅毒
中等度腹水	腹水症	中等度近視
受容体脳炎	抗ＮＭＤＡ受容体脳炎	糸球体腎炎
肛門部軽度発赤	肛門部周囲炎	肛門第２度熱傷
側方リンパ節転移	リンパ節転移	頚部リンパ節転移
左硝子体混濁	硝子体混濁	硝子体混濁
統合失調症既往	統合失調症	統合失調症
平衡機能障害	平衡障害	卵巣機能障害
肺腫瘤影	胸部異常陰影	肺腫瘤陰影
複雑型異型子宮内膜増殖症	腺腫性子宮内膜増殖症	複雑型子宮内膜増殖症
皮膚潰瘍形成	皮膚潰瘍	皮膚潰瘍
肝肥大	肝型糖原病	心肥大
紅斑腫脹	紅斑症	副乳腫脹
腰部圧痛	腰痛症	腹部圧痛
元々不眠症	不眠症	不眠症
左肩甲骨軟骨肉腫	肩甲骨軟骨肉腫	肩甲骨軟骨肉腫
肺血症性ショック	敗血症性ショック	敗血症性ショック
凝固線溶系異常	血液凝固異常	先天性神経系異常
異所性静脈瘤	静脈瘤	先天性静脈瘤
腫瘍崩壊	腫瘍	腫瘍崩壊症候群
破壊性甲状腺炎	甲状腺炎	亜急性甲状腺炎
右腸骨ＬＮ転移	腸骨リンパ節転移	直腸癌骨転移
右腎被膜下血腫	血腫	肝被膜下血腫
全身性サルコイドーシス	サルコイドーシス	全身性アミロイドーシス
脱分化型脂肪肉腫	脂肪肉腫	陰のう内脂肪肉腫
非機能性下垂体腫瘍	下垂体腫瘍	非機能性下垂体腺腫
ＡＣＴＨ分泌不全	ＡＣＴＨ分泌低下症	ＡＣＴＨ分泌低下症
時々残尿感	残尿感	残尿感
小人症	低身長症	小口症
右臼蓋転移	骨盤転移	肝癌骨転移
右頭頂葉脳梗塞	脳梗塞	片頭痛性脳梗塞
マルファン症候群合併	マルファン症候群	マルファン症候群
右眼網膜症	網膜症	星状網膜症
咽喉頭炎	咽頭喉頭炎	咽頭喉頭炎
右下葉肺扁平上皮癌	下葉肺扁平上皮癌	下葉肺扁平上皮癌
足趾壊疽	趾壊死	足壊疽
左肺尖部腺癌	肺腺癌	肺門部腺癌
潰瘍型間質性膀胱炎	間質性膀胱炎	間質性膀胱炎
紅色皮疹	発疹	紅色汗疹
遺尿	遺尿症	遺尿症
頚管狭窄	子宮頚管狭窄症	根管狭窄
右腎門部腹側脂肪肉腫	腎周囲脂肪肉腫	巨大後腹膜脂肪肉腫
左中頭蓋窩髄膜腫	中頭蓋窩髄膜腫	中頭蓋窩髄膜腫
脳梗塞後後遺症	脳梗塞	脳梗塞後遺症
含歯性嚢胞	含歯性のう胞	含歯性のう胞
紅斑熱	日本紅斑熱	紅斑症
多発頭蓋骨転移	骨転移癌	多発性癌転移
Ｄａｎｌｏｓ症候群	エーラス・ダンロス症候群	ＴｒｉｐｌｅＡ症候群
運動低下性構音障害	構音障害	運動障害性構音障害
右重症下肢虚血	重症虚血肢	重症虚血肢
両側腸腰筋血腫	血腫	腸腰筋膿瘍
亀頭部発赤	発赤	亀頭部潰瘍
肝嚢胞感染	肝のう胞	ＨＩＶ感染
重症強迫性障害	強迫性障害	強迫性障害
顔面骨圧痛	圧痛	顔面骨腫瘍
左椎間板ヘルニア	椎間板ヘルニア	椎間板ヘルニア
会陰部疼痛	外陰部痛	会陰部血腫
咀嚼時痛	咀嚼筋痛障害	咀嚼障害
左膝関節偽痛風	膝関節偽痛風	膝関節偽痛風
２次性副甲状腺機能亢進症	副甲状腺機能亢進症	原発性副甲状腺機能亢進症
右上腕蜂窩織炎	上腕蜂巣炎	胃蜂窩織炎
右前大脳動脈未破裂動脈瘤	前大脳動脈瘤	大腿動脈仮性動脈瘤
リウマチ性胸水	リウマチ性肺疾患	リウマチ性胸膜炎
右眼白内障手術	白内障	褐色白内障
悪性リンハ゜腫	悪性リンパ腫	悪性リンパ腫
胆管腫瘍栓	胆管腫瘍	胆管腫瘍
右基底核梗塞	脳梗塞	出血性脳梗塞
境界型耐糖能障害	耐糖能異常	境界型糖尿病
リウマチ疾患	関節リウマチ	リウマチ性心疾患
白内障Ｏ	白内障	白内障
心房細動停止	心房細動	心房細動
帯状疱疹既往	帯状疱疹	帯状疱疹
腫瘤所見	腫瘤	腫瘤
ＶＨＬ病	フォンヒッペル・リンダウ病	デゴス病
時折血痰	血痰	血痰
陰嚢部腫脹	陰のう腫大	鼡径部腫脹
帰室時疲労感	疲労感	易疲労感
高分化型腺癌	癌	肝のう胞腺癌
糖尿病等	糖尿病	糖尿病
Ｍｙｃｏｂａｃｔｅｒｉｕｍ　ｓｈｉｇａｅｎｓｅ感染症	非結核性抗酸菌症	大動脈弁閉鎖不全症兼僧帽弁狭窄症兼三尖弁閉鎖不全症
後腹膜腫瘍切除術	後腹膜腫瘍	後腹膜腫瘍
肺転移発覚	転移性肺腫瘍	肺移植後
右中咽頭癌	中咽頭癌	中咽頭癌
両側肺動脈血栓塞栓	動脈血栓症	肺動脈血栓塞栓症
臀部炎症性粉瘤	粉瘤	乳房炎症性疾患
左耳耳鳴	耳鳴症	頚性耳鳴
鼠経ヘルニア	鼡径ヘルニア	骨盤ヘルニア
鼻閉塞	鼻閉	鼻閉感
疲労感等	疲労感	疲労感
日中掻痒感	そう痒	亜急性痒疹
前交通動脈未破裂脳動脈瘤	未破裂脳動脈瘤	未破裂脳動脈瘤
夜間低酸素血症	低酸素血症	低酸素血症
薬剤性腎不全	薬剤性腎障害	薬剤性腎障害
気管支狭窄	気管支狭窄症	気管支狭窄症
腫瘍増悪	腫瘍	腫瘍
急性軸索障害	びまん性軸索損傷	急性視力障害
完全型ベーチェット病	ベーチェット病	不全型ベーチェット病
筋肉痙攣	痙攣	幽門痙攣
癌性髄膜腫症	悪性髄膜腫	悪性髄膜腫
化膿性脊椎椎間板炎	化膿性椎間板炎	化膿性椎間板炎
呼吸性雑音	胸部音異常	連続性雑音
真菌塊	真菌症	真菌症
両肩関節圧痛	圧痛	肩関節偽痛風
多発肝細胞癌	肝腫瘍	肝細胞癌
右腎小嚢胞	傍腎盂のう胞	副腎のう胞
左横隔膜神経麻痺	横隔神経麻痺	横隔神経麻痺
右高度水腎症	水腎症	後天性水腎症
創傷治癒遅延	創傷	臍帯脱落遅延
上腫瘍	腫瘍	上顎腫瘍
進行性食道癌	食道癌	進行性前立腺癌
複雑性熱性痙攣	熱性痙攣	無熱性痙攣
先天性鼻咽腔閉鎖不全症	先天性鼻咽腔閉鎖不全	先天性鼻咽腔閉鎖不全
右眼鼻涙管閉塞症	鼻涙管閉鎖症	先天性涙管閉塞症
縦隔原発Ｂ細胞大細胞型リンパ腫	縦隔原発大細胞型Ｂ細胞性リンパ腫	縦隔原発大細胞型Ｂ細胞性リンパ腫
左半視野障害	視野障害	視野障害
大腿骨近位部骨折	大腿骨骨折	大腿骨近位部骨腫瘍
左踵部痛	踵痛	耳下部痛
ポリープ様隆起	ポリープ	ポリープ様声帯
刺激性皮膚炎	皮膚炎	剥離性皮膚炎
慢性緑膿菌感染	緑膿菌感染症	緑膿菌感染症
回腸閉塞	回腸狭窄	結腸閉塞
尾部嚢胞	膵のう胞	尾骨部挫傷
虫刺症	蜂刺症	蜂刺症
第二趾爪囲炎	爪囲炎	化膿性爪囲炎
膵仮性嚢胞破裂	仮性膵のう胞	特発性食道破裂
シェーンラインヘノッホ紫斑病	ＩｇＡ血管炎	良性高グロブリン血症性紫斑病
記銘障害	記銘力低下	記憶障害
上歯肉癌	上顎歯肉癌	上顎歯肉癌
チャーグ－ストラウス症候群	好酸球性多発血管炎性肉芽腫症	ハラーマン・ストライフ症候群
低ＡＴⅢ血症	アンチトロンビン欠乏症	低浸透圧血症
超皮質性感覚性失語	皮質下感覚性失語症	皮質下感覚性失語症
ＮＯＭＩ	腸壊死	ＡＶＭ
肥厚性幽門狭窄	肥厚性幽門狭窄症	肥厚性幽門狭窄症
問題なし脊柱管狭窄症	脊柱管狭窄症	腰部脊柱管狭窄症
左踵骨裂離骨折	踵骨骨折	中手骨裂離骨折
慢性糸球体炎	糸球体腎炎	慢性糸球体腎炎
左眼結膜下出血	結膜下出血	結膜下出血
子宮頸部上皮内腫瘍	子宮頚部上皮内腫瘍	子宮頚部上皮内腫瘍
左腰部有棘細胞癌	腰部有棘細胞癌	腰部有棘細胞癌
糖尿病罹患	糖尿病	糖尿病
四肢圧痛	圧痛	四肢痛
関節変形	関節奇形	股関節変形
気分変動	気分変調症	気分変調症
左鎖骨下動脈起始異常	鎖骨下動脈起始異常	鎖骨下動脈起始異常
立位バランス練習重症筋無力症	重症筋無力症	胸腺摘出後重症筋無力症
腰椎脊柱管狭窄	腰部脊柱管狭窄症	腰部脊柱管狭窄症
左上葉小細胞肺癌	上葉小細胞肺癌	上葉小細胞肺癌
左後縦隔腫瘍	後縦隔腫瘍	後縦隔腫瘍
食道カンジタ症合併ＨＩＶ感染症	ＨＩＶカンジダ病	新生児ＨＩＶ感染症
固縮無動	こわばり	純粋無動症
小体認知症	認知症	皮質認知症
突然腹痛	腹痛症	持続腹痛
尿閉気味	尿閉	尿閉
生検部感染徴候	創傷感染症	生検後感染
痛風症状	痛風	痛風発作
脳転移新出	転移性脳腫瘍	骨転移癌
両側肩関節痛	肩関節痛症	偽性股関節痛
右眼下鼻側視野異常	視野障害	鎖骨下動脈起始異常
右肺Ｓ４原発腺癌	肺腺癌	直腸Ｓ状部結腸癌
右肘関節骨折	肘関節骨折	肘関節骨折
両耳下腺腫脹	耳下腺腫脹	耳下腺腫脹
再下血	下血	吐下血
両変形性股関節症	変形性股関節症	変形性股関節症
喘息コントロール不良	咳喘息	尖圭コンジローマ
腹部大動脈狭窄症	大腿動脈狭窄症	腹部大動脈閉塞症
左肺良性腫瘍	肺良性腫瘍	肺良性腫瘍
頸動脈狭窄症	内頚動脈狭窄症	腎動脈狭窄症
若年結核性腹膜炎	結核性腹膜炎	結核性腹膜炎
発赤部分	発赤	発赤
大腸疾患	腸疾患	胃腸疾患
頚部血腫	頚部表在損傷	頚部血管腫
肺雑聴取	胸部音異常	肺吸虫症
急性冠症候群発症	急性冠症候群	急性冠症候群
皮下浮腫	浮腫	皮下気腫
低活動型せん妄	せん妄	夜間せん妄
左化膿性耳下腺炎	化膿性耳下腺炎	化膿性耳下腺炎
痔核症状	痔核	痔核
拘束性心筋症	拘束型心筋症	拘束型心筋症
右内頸動脈血栓閉塞	動脈血栓症	内頚動脈血栓症
肝うっ血	うっ血肝	胃うっ血
ＣＮＩ腎症	薬剤性腎障害	ＩｇＡ腎症
浮腫軽減	浮腫	浮腫
胃液様	嘔吐症	胃液欠乏
右鼡径部出血	出血	鼡径部腫脹
右肺上葉肺炎	肺炎	上葉肺癌
膠原病外来	膠原病	膠原病
門亢症	門脈圧亢進症	多趾症
在型食道癌	食道癌	中部食道癌
創内異物	外傷性異物	心内異物
膀胱内尿貯留	後腹膜尿貯留	後腹膜尿貯留
肢痛	疼痛	下肢痛
肺結核性腹膜炎	結核性腹膜炎	結核性腹膜炎
腸管内血腫	血腫	筋肉内血腫
ネフローゼ状態	ネフローゼ症候群	ネフローゼ症候群
軽度僧帽弁逆流症	僧帽弁逆流症	僧帽弁逆流症
前胸部粉瘤	粉瘤	前胸部腫瘤
左室中部閉塞性肥大型心筋症	閉塞性肥大型心筋症	心室中部閉塞性心筋症
しびれがきつい	しびれ感	しびれ感
両側内耳奇形	内耳先天奇形	先天性外耳奇形
完全右脚ブロック指摘	完全右脚ブロック	完全右脚ブロック
肛門部潰瘍	肛門潰瘍	噴門部潰瘍
臀部紅斑	紅斑症	鼻部母斑
アレルギ—性鼻炎	アレルギー性鼻炎	アレルギー性鼻炎
末節骨骨折	骨折	趾末節骨骨折
脊椎症性変化	脊椎症	脊椎悪性腫瘍
腸閉塞気味	イレウス	結腸閉塞
浅呼吸	呼吸困難	多呼吸
無症候性狭心症	狭心症	無症候性脳梗塞
右顎下リンパ節腫脹	顎下リンパ節腫脹	顎下リンパ節腫脹
左側頭葉海綿状血管腫	側頭葉海綿状血管腫	側頭葉海綿状血管腫
直腸癌術後直腸癌	直腸癌	直腸癌術後再発
痛覚消失	異常知覚	味覚消失
膵炎再燃	膵炎	膵炎
肘頭部潰瘍	前腕皮膚潰瘍	亀頭部潰瘍
反復性腸閉塞	イレウス	反復性うつ病
胎児腹水	胎児水腫	胎児胸水
失見当識障害	見当識障害	見当識障害
皮膚ツルゴール低下	脱水症	皮膚ムコール症
右肩悪性軟部腫瘍	悪性軟部腫瘍	手部悪性軟部腫瘍
非定型うつ	非定型うつ病	非定型うつ病
右中指スワンネック変形肩関節	スワンネック変形	スワンネック変形
胸郭運動異常	胸郭異常	胸郭異常
前頭蓋底腫瘍	頭蓋底腫瘍	頭蓋底腫瘍
腹部肥満	肥満症	腹部膨満
Ｓ状結腸粘膜下腫瘤	腫瘤	Ｓ状結腸粘膜下腫瘍
両側下腿圧痕性浮腫	下腿浮腫	上下肢リンパ浮腫
動脈瘤様骨嚢腫	動脈瘤様骨のう腫	動脈瘤様骨のう腫
軟性腫瘤	腫瘤	化膿性腫瘤
本日疼痛	疼痛	慢性疼痛
出血軽度	出血	出血傾向
軽度間歇性跛行	間欠性跛行	間欠性跛行
蛋白血症	異常蛋白血症	低蛋白血症
不眠時２錠	不眠症	睡眠時頭痛
後縦隔膿瘍	縦隔膿瘍	後縦隔腫瘍
胸水排出	胸水貯留	羊水漏出
ＡＩＤＳ非定型抗酸菌症	非結核性抗酸菌症	ＨＩＶ非結核性抗酸菌症
尺側神経麻痺	尺骨神経麻痺	尺骨神経麻痺
徐脈等	徐脈	徐脈
てんかんの発作	てんかん	てんかん様発作
腹部大動脈石灰化	大動脈石灰化症	腹部大動脈瘤破裂
サルコイドーシス疑	サルコイドーシス	サルコイドーシス
左片麻痺	片麻痺	片麻痺
足部冷感	下肢冷感	足部丹毒
下痢〜水様便	下痢症	下顎下部腫瘤
コレステロールポリープ	ポリープ	胆のうコレステロールポリープ
１型糖尿除	糖尿	１型糖尿病
関節固縮	関節拘縮	関節拘縮
肺多型癌	癌	肺絨毛癌
慢性アレルギ—性鼻炎	アレルギー性鼻炎	慢性アレルギー性中耳炎
下顎骨正中部骨折	下顎正中部骨折	下顎正中部骨折
後嘔吐	嘔吐症	脳性嘔吐
気分不快出現	悪心	縫合不全出血
劇症Ａ群溶連菌感染症	劇症型Ａ群連鎖球菌感染症	Ｂ群溶連菌感染症
内腸骨静脈血栓症	静脈血栓症	腸骨動脈血栓症
軽度咽頭期嚥下障害	嚥下障害	術後嚥下障害
舌根扁桃炎	扁桃炎	舌扁桃炎
右肺上葉小細胞癌	上葉小細胞肺癌	肺門部小細胞癌
ＣＭＶ網膜症	サイトメガロウイルス網膜炎	ＨＩＶ網膜症
脊椎側弯症	脊柱側弯症	胸椎側弯症
悪心Ｇ１	悪心	悪心
上腹部鈍痛	上腹部痛	上腹部痛
脊髄視神経炎	視神経炎	軸性視神経炎
本日血尿	血尿	腎性血尿
クラミジア頸管炎	クラミジア頚管炎	クラミジア卵管炎
性急性リンパ性白血病	急性リンパ性白血病	急性リンパ性白血病
周囲リンパ節腫大	リンパ節腫大	リンパ節腫大
印環細胞癌	癌	基底細胞癌
６月肝転移	転移性肝腫瘍	腎癌骨転移
左内頸動脈中等度狭窄	頚動脈硬化症	前大脳動脈狭窄
左外耳道閉鎖	外耳道閉鎖	外耳道閉鎖
右鼡径部ヘルニア	鼡径ヘルニア	内鼡径ヘルニア
ＭＬＦ症候群	核間性眼筋麻痺	ＭＥＬＡＳ症候群
醜形恐怖	醜形恐怖症	醜形恐怖症
肩関節疼痛	肩関節痛症	肩関節偽痛風
右手痺れ	上肢しびれ	副手根骨
逆流感	胃食道逆流症	脱力感
播種性クリプトコックス症	播種性クリプトコッカス症	播種性クリプトコッカス症
左尿管導管吻合部狭窄	吻合部狭窄	尿管回腸導管吻合部狭窄
口唇落屑	皮膚落屑	口唇下疳
時折不整	不整脈	瞳孔不整
僧帽弁狭窄症兼閉鎖不全症	僧帽弁狭窄症	僧帽弁狭窄兼閉鎖不全症
伸筋腱脱臼	脱臼	総指伸筋腱脱臼
両下腿潰瘍	下腿皮膚潰瘍	下腿膿瘍
内転障害	眼球運動痙攣	内分泌障害
びまん性リンパ腫	リンパ腫	精巣悪性リンパ腫
多発嚢胞腎	多発性のう胞腎	多発性のう胞腎
足首骨折	足関節骨折	足背骨折
右目白内障	白内障	初発白内障
嘔吐１回	嘔吐症	嘔吐症
深夜低血糖	夜間低血糖症	低血糖
過敏症状	過敏症	過敏症
高Ｂｉｌ血症	高ビリルビン血症	高レニン血症
右足小指骨折	小指骨折	小指骨折
第一腰椎破裂骨折	腰椎破裂骨折	第７頚椎破裂骨折
せん妄発言	せん妄	せん妄
ヒステリー症状	ヒステリー反応	ヒステリー反応
歩行時創部痛	術創部痛	術創部痛
パニック	パニック障害	パニック障害
正色素性正球性貧血	正球性正色素性貧血	正色素性貧血
右足腫脹	足部腫脹	項部腫脹
両肺胸膜肥厚	胸膜肥厚	胸膜肥厚
ＡＰＳ	抗リン脂質抗体症候群	ＡＩＤＳ
脳圧亢進症状	頭蓋内圧亢進症	門脈圧亢進症
眼鏡　近視	近視	一過性近視
二次性ヘモクロマトーシス	ヘモクロマトーシス	続発性ヘモクロマトーシス
潜在性副甲状腺機能低下症	副甲状腺機能低下症	続発性副甲状腺機能低下症
両眼瞼黄色腫	眼瞼黄色腫	眼瞼黄色腫
右内腸骨動脈狭窄	動脈狭窄	外腸骨動脈狭窄
正中頚嚢胞	正中頚のう胞	正中頚のう胞
両側尿管結石	尿管結石症	腎尿管結石
高血圧状態	高血圧症	高血圧症
喀血症状	喀血	多血症
指発赤	発赤	発赤
Ⅱａ型高脂血症	高脂血症	混合型高脂質血症
右手橈骨骨折	橈骨骨折	手根骨骨折
右睾丸痛	精巣痛	心窩部痛
本日血便	血便	粘血便
回腸出血	腸出血	小腸出血
左副腎出血	副腎出血	副腎出血
後頭蓋下髄膜腫	髄膜腫	後頭蓋窩髄膜腫
急性前壁中隔梗塞	急性前壁中隔心筋梗塞	急性前壁中隔心筋梗塞
右顔面部帯状疱疹	顔面帯状疱疹	顔面帯状疱疹
びまん性管内増殖性糸球体腎炎	慢性びまん性管内増殖性糸球体腎炎	慢性びまん性管内増殖性糸球体腎炎
傍腹部大動脈リンパ節腫大	リンパ節腫大	限局性リンパ節腫大
左上腕脂肪腫	上腕脂肪腫	上腕脂肪腫
尿道口発赤	発赤	尿道口膿瘍
冠動脈狭窄症	冠状動脈狭窄症	冠状動脈狭窄症
膵石灰化	膵石灰化症	膵石灰化症
丘疹様	丘疹	丘疹
肺上葉原発性肺癌	原発性肺癌	原発性肺癌
労作時胸部不快	労作時呼吸困難	労作時呼吸困難
２型＋ステロイド性糖尿病	ステロイド糖尿病	ステロイド糖尿病
腫瘤縮小	腫瘤	眼瞼縮小
Ｓａｌｍｏｎｅｌｌａ　ｅｎｔｅｒｉｔｉｄｉｓ敗血症	サルモネラ敗血症	大動脈弁狭窄症兼僧帽弁閉鎖不全症兼三尖弁閉鎖不全症
グル音異常	異常腸音	胸部音異常
鉄吸収障害	鉄欠乏症	鉄代謝障害
水中毒症状	水中毒	水中毒
鼻中隔彎曲	鼻中隔弯曲症	鼻中隔弯曲症
本日右眼白内障	白内障	糖尿病性白内障
過敏性腸症侯群	過敏性腸症候群	過敏性腸症候群
会話性幻聴	幻聴	混合性難聴
筋疲労感	筋疲労	易疲労感
水疱後びらん	水疱症	尿道口びらん
胆管内結石	胆管結石症	胆管結石症
時々せん妄	せん妄	疲憊せん妄
処置後膵炎	膵炎	術後膵炎
術後右反回神経麻痺	術後性反回神経麻痺	術後性反回神経麻痺
反復性細菌感染	細菌感染症	反復性尿路感染症
ｗｉｄｅ　ＱＲＳ頻拍	頻拍症	非持続性心室頻拍
両側性末梢性顔面神経麻痺	末梢性顔面神経麻痺	特発性末梢性顔面神経麻痺
皮膚軟部組織感染症	皮膚感染症	皮膚感染症
腰痛ヘルニア	椎間板ヘルニア性腰痛症	腰ヘルニア
イレウス合併	イレウス	イレウス
息苦しく	呼吸困難	歯ぎしり
肺好酸球性肉芽腫	肺好酸球性肉芽腫症	肺好酸球性肉芽腫症
無菌性腸炎	非感染性腸炎	細菌性腸炎
骨盤内リンパ嚢腫	骨盤部感染性リンパのう胞	骨盤内リンパ節転移
両側眼瞼下垂症	眼瞼下垂症	偽性眼瞼下垂症
両側性結核性胸膜炎	結核性胸膜炎	結核性胸膜炎
甲状腺機能亢進症状	甲状腺機能亢進症	甲状腺機能亢進症
平坦Ｔ波	心電図異常	平衡障害
ペーシング不全	両室ペーシング機能付き植込型除細動器不全	ペースメーカ不全
後頭部打撲	頭部打撲	後頭部打撲傷
薬剤性過敏症候群	薬剤性過敏症症候群	薬剤性過敏症症候群
両側喉頭肉芽腫	喉頭肉芽腫	喉頭肉芽腫
ふらつきあり	めまい	さとうきび肺
右鼡径ヘルニア	鼡径ヘルニア	内鼡径ヘルニア
職業性ストレス	急性ストレス反応	胎児ジストレス
卵管水腫	卵管留水症	卵管筋腫
左下葉原発性肺扁平上皮癌	肺扁平上皮癌	下葉肺扁平上皮癌
外気胸	気胸	血気胸
ポリープ数個	ポリープ	ポリープ
右低音障害型感音難聴	急性低音障害型感音難聴	急性低音障害型感音難聴
外陰部血腫	外陰血腫	外陰部血管腫
左乳突蜂巣炎	乳様突起炎	鼡径部蜂巣炎
未破裂左内頸動脈瘤	内頚動脈瘤	未破裂脳動脈瘤
中咽頭側壁扁平上皮癌	癌	中葉肺扁平上皮癌
ＥＶＡＮＳ症候群	エバンス症候群	ＭＥＬＡＳ症候群
右聴神経腫瘍	聴神経腫瘍	聴神経腫瘍
両肺多発結節性陰影	胸部異常陰影	らい性結節性紅斑
左血腫	血腫	腟血腫
早期乳癌	乳癌	早期胃癌
脾臓腫瘤	腫瘤	胸壁腫瘤
多発髄膜腫	多発性髄膜腫	多発性髄膜腫
術中出血多	多量出血	術中低血圧
先天性嚢胞肺	先天性のう胞肺	先天性のう胞肺
手背部疼痛	手背部痛	手背部痛
腹部大動脈嚢状瘤	腹部大動脈瘤	腹部大動脈瘤
腫瘍感染合併	腫瘍	重症感染症
ＩＰ合併	間質性肺炎	ＩＰ関節炎
左腫瘤	腫瘤	肝腫瘤
ゾメタ骨髄炎	骨髄炎	上顎骨骨髄炎
葉酸欠乏	葉酸欠乏症	葉酸欠乏症
右胸膜原発血管肉腫	血管肉腫	後腹膜血管肉腫
拘縮気味	筋拘縮症	人工気胸
手関節圧痛	圧痛	手関節痛
浮腫残存	浮腫	浮腫
非てんかん性心因性発作	てんかん	てんかん複雑部分発作
鼻口蓋管嚢胞	鼻口蓋管のう胞	鼻口蓋管のう胞
下腸間膜動脈閉塞	腸間膜動脈塞栓症	下腸間膜動脈瘤
右中大脳動脈領域梗塞	中大脳動脈閉塞症	中大脳動脈塞栓症
消化管腫瘤	腫瘤	消化管出血
脛骨前面圧痕性浮腫	浮腫	脛骨近位部悪性骨腫瘍
多少眠気	非器質性過眠症	多胎妊娠
高濃度腫瘤	腫瘤	耳介部腫瘤
ＤＧＥ症状	消化管術後後遺症	ＬＧＬ症候群
過形成性ポリープ	胃過形成ポリープ	胃過形成ポリープ
日光アレルギー	光線過敏症	ダニアレルギー
両膝痛	膝関節痛	母趾痛
こわばりあり	こわばり	こわばり感
慢性炎症性腸疾患	腸炎	炎症性腸疾患
尺骨頭脱臼	脱臼	橈骨頭脱臼
けいれん症状	痙攣	卵巣欠落症状
重度三尖弁閉鎖不全症	三尖弁閉鎖不全症	三尖弁閉鎖不全症
肺炎併発	肺炎	肺炎結核
右下肢感覚鈍麻	感覚異常症	片側感覚鈍麻
第二度房室ブロック	第２度房室ブロック	第２度房室ブロック
慢性進行性肺アスペルギルス症	肺アスペルギルス症	慢性壊死性肺アスペルギルス症
点状発赤	発赤	点状出血
白血病化	白血病	白血病
消退性発赤	発赤	心因性発熱
ヒステリー	ヒステリー反応	ヒステリー球
手指皮疹	発疹	手指湿疹
残尿	残尿感	残尿感
腫脹圧痛	圧痛	腹部圧痛
ループスアンチコアグラント陰性	ループスアンチコアグラント	ループスアンチコアグラント
両肺気胸	気胸	人工気胸
右肺胸水貯留	胸水貯留	胸水貯留
血性吐物	吐血	血性乳汁
両側腓骨神経麻痺	腓骨神経麻痺	腓骨神経麻痺
廃用	廃用症候群	不器用
浮動感	めまい	蟻走感
軽度右室肥大	右室肥大	右室肥大
右膝蜂窩織炎	膝部蜂巣炎	胃蜂窩織炎
強制換気	人工呼吸器装着状態	強膜潰瘍
２型＋ステロイド糖尿病	ステロイド糖尿病	ステロイド糖尿病
左下肢ガス壊疽	ガス壊疽	ガス壊疽
低血糖用	低血糖	低血糖
喚語障害	不全失語症	構語障害
右足底潰瘍	足底皮膚潰瘍	足底皮膚潰瘍
右網膜静脈分枝閉塞症	網膜静脈分枝閉塞症	網膜静脈分枝閉塞症
腹痛時	腹痛症	腹痛症
多動多弁	多動性障害	多動性障害
右手背浮腫	限局性浮腫	麻痺側浮腫
足趾しびれ	下肢しびれ	四肢しびれ
突然意識障害	意識障害	急性意識障害
足底痺れ	しびれ感	足底熱傷
角膜ヘルペス	ヘルペス角膜炎	陰茎ヘルペス
食思不振症状	食欲不振	食欲不振
細菌性食道炎	食道炎	細菌性食中毒
開大代謝性アシドーシス	代謝性アシドーシス	代謝性アシドーシス
心因性過食症	心因性過食	心因性過食
術後肺転移	転移性肺腫瘍	術後肺炎
転移性腫瘤	転移性腫瘍	転移性腫瘍
夜間尿意	夜間頻尿症	夜間頻尿症
右下腿腫脹	下腿腫脹	下腿腫脹
背部皮脂欠乏性湿疹	皮脂欠乏性湿疹	皮脂欠乏性湿疹
足爪白鮮	足爪白癬	足爪白癬
神経性疼痛	神経痛	神経性耳痛
房室接合部調律	異所性調律	接合部調律
末梢循環不全徴候	末梢循環不全	末梢循環不全
眼瞼下垂自覚	眼瞼下垂症	眼瞼下垂症
右上顎洞乳頭腫	上顎洞乳頭腫	上顎洞乳頭腫
帯状疱疹拡大	帯状疱疹	帯状疱疹
左尾状核ラクナ硬塞	ラクナ梗塞	無症候性ラクナ梗塞
ＳＭＡ閉塞	急性上腸間膜動脈閉塞症	結腸閉塞
めまいの発作	めまい	めまい発作
呼吸切迫	急性呼吸窮迫症候群	呼吸促迫
劇症型連鎖球菌感染症	連鎖球菌感染症	劇症型Ａ群連鎖球菌感染症
腹部疝痛	仙痛	腹部圧痛
胆嚢多発ポリープ	胆のうポリープ	胆のうポリープ
柑皮症	カロチン血症	紅皮症
浮腫状	浮腫	浮腫
陰部掻痒	外陰部そう痒症	陰部切創
十二指腸多発びらん	十二指腸びらん	十二指腸びらん
前立性肥大症	前立腺肥大症	前立腺肥大症
嘔気状況	嘔気	嘔気
両側眼球外転障害	眼球運動障害	眼球運動障害
元々浮腫	浮腫	熱性浮腫
左小脳出血	小脳出血	小脳出血
躁うつ	躁うつ病	躁うつ病
夜間失禁	尿失禁症	夜間遺尿
ベージェット病	ベーチェット病	ベーチェット病
元来頭痛	頭痛	頚性頭痛
褥瘡発生リスク低い	褥瘡	褥瘡・ステージＩＩ
下部直腸癌	直腸癌	下行結腸癌
両側総腸骨動脈狭窄	総腸骨動脈狭窄	総腸骨動脈狭窄
牽引痛	牽引性頭痛	牽引性頭痛
Ⅱ度熱傷	熱傷	第３度熱傷
重度感覚障害	体感異常	重度知的障害
両側肺尖部進行性胸膜肥厚	胸膜肥厚	石綿関連びまん性胸膜肥厚
婦人入院脳梗塞	脳梗塞	多発性小脳梗塞
炎症性ポリープ多発	ポリープ	若年性ポリープ
右坐骨結節転移再発	転移性腫瘍	坐骨結節部打撲傷
ダンピング症候群併発	ダンピング症候群	ダンピング症候群
右上肢痺れ	しびれ感	上肢しびれ
ＭＣＴＤ	混合性結合組織病	ＭＣＡＤ欠損症
ループスアンチコアグラント陽性	ループスアンチコアグラント	ループスアンチコアグラント
昨日水様便	下痢症	両側水腎症
気分不快増強	悪心	気分変調症
拡張期高血圧	高血圧症	収縮期高血圧症
右気管支肺炎	気管支肺炎	気管支肺炎
左頸部リンパ節腫大	薬剤性自己免疫性溶血性貧血	限局性リンパ節腫大
右低音部感音難聴	感音難聴	急性低音障害型感音難聴
ＰＨＴ	肺高血圧症	ＰＣＷＨ
夜間失見当	見当識障害	夜間頻尿症
劇症型髄膜炎菌感染症	髄膜炎菌感染症	侵襲性髄膜炎菌感染症
物忘れ気	健忘症	湿性脚気
両難聴	難聴	難聴
左腎細胞癌	腎細胞癌	腎細胞癌
多発膵転移	転移性膵腫瘍	多発性癌転移
両眼白内障手	白内障	核性白内障
右手関節滑膜炎	滑膜炎	膝関節滑膜炎
膠原病由来	膠原病	膠原病
声門上喉頭癌	喉頭癌	声門上癌
右膝メルケル細胞癌	メルケル細胞癌	上腕メルケル細胞癌
右椎骨動脈起始部狭窄	椎骨動脈狭窄症	外腸骨動脈狭窄
加害妄想	妄想反応	被害妄想
嚢胞性胸腺腫	胸腺腫	悪性胸腺腫
急性乳突洞炎	急性中耳炎	急性乳様突起炎
舌内リンパ節転移	リンパ節転移	骨盤内リンパ節転移
悪性リンパ腫既往	悪性リンパ腫	悪性リンパ腫
左肺下葉腫瘤影	肺腫瘤	下顎下部腫瘤
Ｌ３圧迫骨折	圧迫骨折	椎体圧迫骨折
左感音性難聴	感音難聴	騒音性難聴
腎臓疾患	腎疾患	腎疾患
ＣＯＰＤＩ期	慢性閉塞性肺疾患	ＣＡＰＤ腹膜炎
転倒歴多数	よろめき歩行	転子間骨折
ＤＩＨＳ	薬疹	ＡＩＤＳ
夜勤帯下血	下血	臍帯下垂
インスリン依存性糖尿病	１型糖尿病	インスリン抵抗性糖尿病
頸部椎間板ヘルニア	頚椎椎間板ヘルニア	腰仙部椎間板ヘルニア
右眼網膜裂孔	網膜裂孔	網膜裂孔
拍動性疼痛	疼痛	難治性疼痛
下血増悪	下血	下腿血管腫
ＤＭ性腎不全	糖尿病性腎不全	急性腎不全
膝関節軽度屈曲拘縮	屈曲拘縮	膝関節屈曲拘縮
ＡＴＬ	成人Ｔ細胞白血病リンパ腫	ＡＶＭ
肺動脈弁閉鎖不全	肺動脈弁閉鎖	肺動脈弁閉鎖不全症
熱感軽度	ほてり	無感覚症
重度不眠	不眠症	軽度遠視
咀嚼困難感	咀嚼障害	透析困難症
食道圧迫	食道圧迫症	食道圧迫症
両足関節痛	足関節痛	足関節痛
術後肝転移	転移性肝癌	術後肝障害
朝低血糖	低血糖	低血糖
喘息疑い	咳喘息	船酔い
顔皮疹	発疹	斑状皮疹
子宮筋腫有	子宮筋腫	子宮筋腫
淡明細胞型腎細胞癌	腎細胞癌	毛様細胞性星細胞腫
浮腫生	浮腫	浮腫
再出血徴候	出血	鼻出血症
アシネトバクター敗血症	敗血症	多剤耐性アシネトバクター感染症
左自然気胸再発	自然気胸	自然気胸
高度肥満２型糖尿病	２型糖尿病	若年２型糖尿病
右大腿骨骨肉腫	大腿骨骨肉腫	大腿骨骨肉腫
左腎盂腎炎治癒後	腎盂腎炎	腎盂腎炎
二次性水頭症	外傷後水頭症	先天性水頭症
ダグラス窩播種	腹膜播種	ダグラス窩結核
左室拡張能低下	左室不全	松果体機能低下
ウィルス感染症	ウイルス感染症	ウイルス感染症
左手尺骨神経麻痺	尺骨神経麻痺	尺骨神経麻痺
周期性呼吸時折	周期性呼吸	周期性呼吸
異常帯下	帯下	異常嚥下癖
多発性大腸ポリープ	大腸ポリープ	多発性胆のうポリープ
糖尿病用	糖尿病	糖尿病
術前心電図異常	心電図異常	心電図異常
中耳炎症状	中耳炎	中耳炎
脱力症状	脱力感	脱力発作
上半身掻痒感	そう痒	上半身熱傷
動揺性めまい	めまい	器質性めまい
褥瘡発生歴	褥瘡	褥瘡性潰瘍
水分摂取困難	嚥下障害	経口摂取困難
趾爪囲炎	爪囲炎	爪囲炎
右下葉原発低分化腺癌	癌	下葉肺扁平上皮癌
挙上期誤嚥	異物誤嚥	異物誤嚥
腹部膨満増強	腹部膨満	腹部膨満
右副腎腫瘍摘出術	副腎腫瘍	副腎腫瘍
右鎖骨痛	鎖骨痛	鎖骨痛
細菌性扁桃炎	扁桃炎	細菌性内耳炎
左歯性上顎洞炎	歯性上顎洞炎	歯性上顎洞炎
重度歯周病	歯周症	慢性歯周炎
正常圧緑内障	緑内障	正常眼圧緑内障
梗塞後出血	出血性脳梗塞	閉経後出血
骨髄異型性症候群	骨髄異形成症候群	骨髄異形成症候群
光線過敏	光線過敏症	光線過敏症
副睾丸炎	精巣炎	副鼻腔炎
虚脱病変	虚脱	虚脱
慢性アレルギー性鼻炎	季節性アレルギー性鼻炎	季節性アレルギー性鼻炎
肘痛	肘関節痛	足痛
夕食前低血糖	低血糖	新生児低血糖
先天性代謝異常症	代謝障害	先天性糖代謝異常
単頸双角子宮	双角子宮	単頚双角子宮
原発性肺高血圧症	肺高血圧症	二次性肺高血圧症
左眼加齢性黄斑変性症	加齢黄斑変性	家族性黄斑変性症
左鎖骨リンパ節転移	リンパ節転移	鎖骨上リンパ節転移
殿部色素沈着	色素異常症	ひ素色素沈着
舌浮腫	浮腫	脳浮腫
ストレス性潰瘍	ストレス潰瘍	ストレス性胃潰瘍
舌損傷	損傷	肝損傷
発熱下	発熱	発熱
失見当識発言	見当識障害	見当識障害
右眼内悪性リンパ腫	眼窩悪性リンパ腫	眼窩悪性リンパ腫
腹部大動脈狭窄	大動脈狭窄症	腹部大動脈拡張
右季肋部自発痛	季肋部痛	季肋部痛
軽度痺れ	しびれ感	軽度難聴
星芒状血管腫	血管腫	くも状血管腫
右房内腫瘤	腫瘤	胸腔内腫瘤
Ｓ状結腸転移	転移性消化器腫瘍	Ｓ状結腸腫瘍
全身掻痒感	そう痒	全身違和感
右手舟状骨骨折	手舟状骨骨折	手舟状骨骨折
肉芽腫性腸疾患	腸疾患	肉芽腫性口唇炎
両足圧痕性浮腫	浮腫	栄養失調性浮腫
発作後精神病	精神病	周期性精神病
虫垂粘液嚢胞腺腫	虫垂粘液のう胞	卵巣粘液性腺腫
四肢水疱	水疱症	四肢痙攣
右足趾骨髄炎	趾骨髄炎	母趾骨髄炎
若年性リウマチ	関節リウマチ	若年性関節リウマチ
体陽性脳炎	脳炎	流行性脳炎
境界域ＤＭ	糖尿病	境界母斑
結節性不整脈	不整脈	頻脈性不整脈
劇症敗血症	敗血症	産褥敗血症
慢性血腫	血腫	慢性肺気腫
骨破壊病変	関節リウマチ	根分岐部病変
眼窩部痛	眼痛	腋窩部痛
昨日不眠	不眠症	免疫不全
頚椎脊柱管狭窄症	頚部脊柱管狭窄症	頚部脊柱管狭窄症
発赤域	発赤	発赤
膵頭部転移	転移性膵腫瘍	膵頭部腫瘤
高度肝障害	肝障害	術後肝障害
右肺下葉腫瘍	肺腫瘍	視床下部腫瘍
口腔内発赤腫脹	発赤	口腔外傷性腫脹
中咽頭再発腫瘍	咽頭腫瘍	中咽頭良性腫瘍
左下肢冷感	下肢冷感	下肢冷感
大腫瘍	腫瘍	大腸腫瘍
胸骨肋骨転移	肋骨転移	肋骨転移
重症心身障害児	重症心身障害	重症心身障害
腹部軽度膨隆	腹部膨満	腹部膨満
リンパ管症	癌性リンパ管症	リンパ管腫症
遷延性抑うつ状態	うつ状態	遷延性抑うつ反応
結核性強膜炎	結核性胸膜炎	結核性網膜炎
下腿筋萎縮	筋萎縮症	下肢筋萎縮
膵頭癌	癌	膵頭部癌
ＶＡＨＳ	ウイルス関連血球貪食症候群	ＨＣＡＨＣ
圧痛自発痛	圧痛	痛風発作
痰中等量引ける	喀痰	中等度難聴
放射線障害	放射線宿酔	放射線宿酔
浅眠	不眠症	嗜眠
反射異常	異常反射	心拍異常
慢性間質性腎炎	慢性尿細管間質性腎炎	急性間質性肺炎
脳溢血	脳卒中	脳出血
右下肢深部静脈血栓症	下肢静脈血栓症	下肢静脈血栓症
カテーテル感染	カテーテル感染症	カテーテル感染症
腫瘍多発	腫瘍	腫瘍
背部筋緊張高い	筋強直	背部筋肉痛
全身紅斑	紅斑症	多形紅斑
しびれてる感	しびれ感	しびれ感
少量尿失禁	尿失禁症	切迫性尿失禁
脳腫瘍切除	脳腫瘍	脳腫瘍
右側下顎骨体部骨折	下顎骨骨折	上下顎骨開放骨折
高血糖是正	高血糖症	高血糖症
腫瘤拡大	腫瘤	頭囲拡大
病原性大腸菌	病原性大腸菌感染症	病原性大腸菌感染症
耳小骨奇形	耳小骨の先天奇形	耳小骨融合
全身性紫斑	全身性紫斑病	全身性紫斑病
微小多発脳梗塞	多発性脳梗塞	多発性脳梗塞
右股関節亜脱臼	股関節亜脱臼	股関節亜脱臼
糸球体血尿	血尿	糸球体性血尿
左橈骨神経麻痺	橈骨神経麻痺	橈骨神経麻痺
全身性間代性痙攣	間代性痙攣	間代性痙攣
右肋間痛	肋間痛	肋間痛
右続発性緑内障	続発性緑内障	続発性緑内障
軟骨腫	骨軟骨腫	骨軟骨腫
開大性代謝性アシドーシス	代謝性アシドーシス	代償性代謝性アシドーシス
パニック様症状	全般性不安障害	パニック発作
胆嚢充満結石	胆のう結石症	胆道結石
左上葉肺転移	転移性肺腫瘍	上葉肺腺癌
軽度しびれ感	しびれ感	しびれ感
意識レベル低	意識障害	意識消失
爪囲紅斑	爪囲炎	手掌紅斑
子宮頸癌Ｉｂ１期	子宮頚癌	子宮癌骨転移
感覚性運動失調	運動失調	脊髄性運動失調
両側鎖骨上窩リンパ節腫大	リンパ節腫大	鎖骨上リンパ節腫脹
中枢性めまい	中枢性めまい症	中枢性めまい症
関節滑膜炎	滑膜炎	膝関節滑膜炎
続発性膜性腎症	膜性腎症	続発性男性不妊症
立位保持困難	四肢筋力低下	夜間呼吸困難
先天性風疹症侯群	先天性風疹症候群	先天性風疹症候群
左足痺れ	しびれ感	中足部痛
Ｒｉｅｄｅｌ甲状腺炎	線維性甲状腺腫	急性化膿性甲状腺炎
椎骨動脈狭窄	椎骨動脈狭窄症	椎骨動脈狭窄症
活動性肺結核症	活動性肺結核	活動性肺結核
鼻腔化膿性肉芽腫	細菌性肉芽腫症	結膜化膿性肉芽腫
痙攣発作再発	痙攣発作	痙攣発作
右脛骨内果骨折	足関節内果骨折	大腿骨内顆骨折
左胸膜転移	胸膜播種	横隔膜転移
卵巣腫瘍再発	卵巣腫瘍	卵巣腫瘍破裂
右肺中葉転移	転移性肺癌	肺癌骨転移
下腿筋痛	下肢筋肉痛	大腿筋痛
右大腰筋血腫	血腫	傍大脳鎌血腫
十二指腸潰瘍再発	慢性十二指腸潰瘍	十二指腸潰瘍瘢痕
Ａｆ不変	心室細動	瞳孔不整
左下腿部帯状疱疹	帯状疱疹	腰殿部帯状疱疹
顔面麻痺１	顔面神経麻痺	顔面神経麻痺
巨大腫瘤	腫瘤	巨大尿管
右足関節腫脹	足関節腫脹	足関節腫脹
外陰部湿疹	湿疹	外陰部膿痂疹
両肺副雑音	胸部音異常	顎関節雑音
腎機能異常	腎機能検査異常	膵機能異常
姿勢障害	姿勢異常	成長障害
左肘頭開放骨折	開放骨折	尺骨肘頭開放骨折
イレウス発生	イレウス	イレウス
若干硬結	硬結	肛囲硬結
左骨盤内リンパ嚢胞	骨盤部感染性リンパのう胞	骨盤内リンパ節転移
発作性３度房室ブロック	第３度房室ブロック	第３度房室ブロック
身体損傷	損傷	気道損傷
右大腿骨骨腫瘍	大腿骨腫瘍	大腿骨腫瘍
慢性胆嚢炎	慢性胆のう炎	慢性胆管炎
偽性高Ｋ血症	高カリウム血症	本態性高脂血症
反応性胸水	胸水貯留	漏出性胸水
元々痛み	疼痛	くしゃみ
骨盤内膜症	骨盤子宮内膜症	骨盤子宮内膜症
右耳下腺腫瘤	耳下腺腫瘤	耳下腺腫瘤
肝形質細胞腫	形質細胞腫	形質細胞腫
躁病相	躁状態	躁病発作
易出血傾向	出血傾向	出血傾向
ジューリング疱疹状皮膚炎	ジューリング病	ジューリング病
末梢発赤	発赤	末梢壊死
部分性脂肪萎縮症	部分的脂肪萎縮症	部分的脂肪萎縮症
亜急性脊髄連合変性症	亜急性連合性脊髄変性症	亜急性小脳変性症
副腎偶発腫	良性副腎皮質腫瘍	副腎のう腫
右下腿紅斑	紅斑症	下腿母斑
腸管通過障害	消化管狭窄	尿管通過障害
努力様呼吸	起坐呼吸	努力性呼吸
膿疱形成	膿疱	眼異形成
左卵巣膿瘍	卵巣膿瘍	卵巣膿瘍
発赤皮疹	発疹	発熱発疹
赤痢アメーバ大腸炎	アメーバ赤痢	腸管アメーバ肉芽腫
サイトメガロウイルス感染	サイトメガロウイルス感染症	サイトメガロウイルス感染症
Ｇｒａｄｅ　３肝障害	肝障害	アルコール性肝障害
低ＡＬＢ血症	低アルブミン血症	低レニン血症
Ⅱ型糖尿病	２型糖尿病	２型糖尿病
両顎関節痛	顎関節痛	顎関節痛
逆流性胆管炎	逆行性胆管炎	逆行性胆管炎
関節痛症状	関節痛	肩関節痛症
空気塞栓	空気塞栓症	空気塞栓症
肝膿瘍破裂	肝膿瘍	肝膿瘍
総肺静脈還流異常症	肺静脈還流異常症	肺静脈還流異常症
両下腿痛	下腿痛	下腿痛
左橈骨頭脱臼骨折	脱臼骨折	橈骨頭開放骨折
正中創感染	創傷感染症	刺創感染
左網膜分枝動脈閉塞症	動脈閉塞症	網膜中心動脈閉塞症
頸部浮腫	浮腫	足部浮腫
肺扁平上皮癌、病期不明	肺扁平上皮癌	肺扁平上皮癌
低血圧自覚症状	低血圧症	低血圧症
常時痛み	疼痛	いれずみ
倦怠感増	倦怠感	倦怠感
脾臓腫瘍	脾腫瘍	心臓腫瘍
多発肝転移増大	転移性肝癌	多発性癌転移
頸部食道狭窄	食道狭窄	気管食道狭窄
陰茎アポクリン癌	陰茎アポクリン腺癌	陰茎アポクリン腺癌
元来月経痛	月経痛	月経痛
胆嚢十二指腸瘻	胆のう十二指腸瘻	総胆管十二指腸瘻
特発性肺胞出血	肺胞出血	特発性脳内出血
左鼠径部疼痛	鼡径部痛	陰茎部疼痛
左側頬粘膜癌	頬粘膜癌	頬粘膜癌
円盤状皮疹	円板状エリテマトーデス	斑状皮疹
左手首疼痛	手部痛	難治性疼痛
アレルギー反応	アレルギー	アレルギー
夜間痙攣	痙攣	乳児痙攣
膵体部小嚢胞	腫瘍性膵のう胞	膵体部癌
耳介脂漏性湿疹少	脂漏性皮膚炎	耳介周囲湿疹
両側急性硬膜下出血	急性硬膜下血腫	乳児急性硬膜下血腫
毎回尿失禁	尿失禁症	切迫性尿失禁
喉頭蓋腫脹	喉頭蓋炎	喉頭蓋腫瘍
愁訴	不定愁訴症	不定愁訴症
血腫不変	血腫	血腫
各種膠原病	膠原病	膠原病
肺気胸	気胸	肺気腫
深部感覚鈍麻	感覚異常症	片側感覚鈍麻
脊柱圧痛	圧痛	腹部圧痛
亜脱臼傾向	亜脱臼	亜脱臼
自傷痕	自傷	自傷
嘔吐持続	嘔吐症	嘔吐症
痙攣重積後脳症	痙攣重積型二相性急性脳症	痙攣重積型急性脳症
小腸大腸型	小腸大腸クローン病	急性大腸炎
薬剤肝障害	薬物性肝障害	薬剤性腎障害
転移性膵体部癌	膵体部癌	転移性上顎洞癌
左前頭葉神経膠腫	前頭葉神経膠腫	前頭葉神経膠腫
精神運動興奮	精神運動興奮状態	精神運動興奮状態
インフルエンザＡ型感染症	インフルエンザＡ型	インフルエンザ菌ｂ型感染症
紅斑反応	紅斑症	悲嘆反応
右尿管結石症	尿管結石症	尿管結石症
瞳孔不同	瞳孔不同症	瞳孔不同症
多発肝転移巣	転移性肝腫瘍	多発性癌転移
顕微鏡的大腸炎	大腸炎	顕微鏡的血尿
直腸Ｒａ癌	直腸癌	直腸癌
原発性アルドステロン	原発性アルドステロン症	原発性アルドステロン症
苔癬局面	苔癬	苔癬
足趾爪混濁肥厚	ころもじらみ寄生症	爪甲肥厚
ＣＭＶ肺炎	サイトメガロウイルス肺炎	過敏性肺炎
右ＩＣＡ狭窄	内頚動脈狭窄症	右室漏斗部狭窄
痰貯留	喀痰	体液貯留
足趾蜂窩織炎	足蜂巣炎	胃蜂窩織炎
僧帽弁狭窄兼逆流症	僧帽弁狭窄症	僧帽弁狭窄症
中背部悪性黒色腫	背部悪性黒色腫	手背部悪性黒色腫
歯槽膿漏	歯周炎	歯槽膿瘍
左肘関節破壊	関節リウマチ・肘関節	肘関節強直
副甲状腺亢進症	副甲状腺機能亢進症	副甲状腺機能亢進症
右声帯不全麻痺	声帯不全麻痺	声帯不全麻痺
心合併症	心臓合併症	心臓合併症
皮下石灰化	皮膚石灰沈着症	胸膜石灰化
薬剤性発熱	発熱	薬剤性膵炎
労作時前胸部痛	前胸部痛	前胸部痛
肺炎等	肺炎	肺炎
軽度ＡＤＨＤ	注意欠陥多動障害	軽度認知障害
新生児一過性多呼	新生児一過性多呼吸	新生児一過性多呼吸
両心房拡大	心肥大	心拡大
上転障害	眼球運動障害	歩行障害
不眠状態	不眠症	不穏状態
プレクリニカルクッシング症候群	クッシング症候群	薬物誘発性クッシング症候群
左胸鎖乳突筋炎	胸鎖乳突筋炎	胸鎖乳突筋炎
腫瘍性	腫瘍	腫瘍
時々関節痛	関節痛	手指関節痛
嫌悪感	悪寒	鼻閉感
二次性僧帽弁閉鎖不全症	僧帽弁閉鎖不全症	先天性僧帽弁閉鎖不全症
急性大動脈弁閉鎖不全	大動脈弁閉鎖不全症	先天性大動脈弁閉鎖不全症
左心肥大	心肥大	左室肥大
腹痛嘔気	嘔気	腹痛症
前頭部打撲	頭部打撲	前頭部打撲傷
左大腿部骨外性粘液型軟骨肉腫	軟骨肉腫	大腿骨軟骨肉腫
高度異形成相当	子宮頚部高度異形成	軟骨異形成症
腹緊なし	腹部膨満	腹壁創し開
右頚部ＬＮ腫大	リンパ節腫大	頚部皮下腫瘤
側卵巣嚢腫	卵巣のう腫	卵巣肉腫
哺乳後嘔吐	嘔吐症	妊娠後期嘔吐
右結石性腎盂腎炎	結石性腎盂腎炎	結石性腎盂腎炎
Ｃｒｏｎｋｈｉｔｅ−Ｃａｎａｄａ症候群	クロンカイト・カナダ症候群	Ｅｕｔｈｙｒｏｉｄ　Ｓｉｃｋ症候群
心嚢液貯留	心膜液貯留	心膜液貯留
臓器限局性前立腺癌	限局性前立腺癌	限局性前立腺癌
貧血傾向	貧血	出血傾向
右中大脳動脈梗塞	内頚動脈塞栓症	中大脳動脈閉塞症
日中傾眠	傾眠症	尿中円柱
脾臓結核	結核	尿道結核
食後高血糖	高血糖症	産後高血圧症
高浸透圧血症	高血糖高浸透圧症候群	低浸透圧血症
両下肢軽度浮腫	下肢浮腫	上下肢リンパ浮腫
右間歇性跛行	間欠性跛行	間欠性跛行
陰嚢ヘルニア	陰のうヘルニア	陰唇ヘルニア
多形紅斑型薬疹	薬疹	紫斑型薬疹
右腋窩リンパ節腫脹	腋窩リンパ節腫脹	腋窩リンパ節腫脹
静脈内腫瘍栓	腫瘍	脳室内腫瘍
爪甲剥離症	爪剥離症	爪剥離症
再度急性腎不全	急性腎不全	急性腎不全
進行再発大腸癌	大腸癌	進行性前立腺癌
胃接合部癌	胃癌	食道胃接合部癌
耳閉塞感	耳閉感	耳閉感
手足しびれ	しびれ感	手指先しびれ
内膜損傷	損傷	胸膜損傷
胃小彎側ＬＮ転移	胃周囲リンパ節転移	胃周囲リンパ節転移
軽度発達遅滞	発達遅滞	運動発達遅滞
非浸潤性膀胱癌	膀胱癌	非浸潤性小葉癌
右先天性耳瘻孔	先天性耳瘻孔	先天性耳瘻孔
脂肪腫摘出	脂肪腫	脂肪腫
椎間板ヘルニア有	椎間板ヘルニア	椎間板ヘルニア
扁平ポリープ	ポリープ	小腸ポリープ
咽頭知覚障害	咽頭異常感症	皮膚知覚障害
腸液貯留	体液貯留	体液貯留
両変形性膝関節症	変形性膝関節症	変形性膝関節症
急性胆嚢胆管炎	胆管炎	急性胆細管炎
扁平上皮癌	癌	肺扁平上皮癌
内痔核脱出	内痔核	内痔核
びまん性脳浮腫	脳浮腫	びまん性中皮腫
呼気困難	呼吸困難	呼吸困難
重症鬱血性心不全	うっ血性心不全	うっ血性心不全
大腸早期癌	大腸癌	大腸粘液癌
喘鳴聴取	喘鳴	喘鳴
左乳癌特	乳癌	乳癌
Ａ型溶連菌感染症	溶連菌感染症	Ｂ群溶連菌感染症
悪性副腎外褐色細胞腫	褐色細胞腫	悪性褐色細胞腫
傍隔壁型肺気腫	肺気腫	汎小葉性肺気腫
角膜糜爛	角膜びらん	角膜挫傷
骨盤内播種新生	骨盤転移	骨盤内臓器損傷
急性非代償性心不全	心不全	慢性うっ血性心不全
最近便秘	便秘症	術後便秘
右頬部痛	頬部痛	頬部痛
右肺動静脈瘻	肺動静脈瘻	肺動静脈瘻
１型高ウイルスＣ型慢性肝炎	Ｃ型慢性肝炎	急性ウイルス性肝炎
問題なし膀胱直腸障害	膀胱直腸障害	膀胱直腸障害
Ｌｉｓｔｅｒｉａ腸炎	細菌性腸炎	抗生物質起因性大腸炎
右膿胸	膿胸	全膿胸
ヒリヒリ感	疼痛	ピリピリ感
時折胸痛	胸痛	呼吸時の胸痛
大動脈弁下心室中隔欠損	心室中隔欠損症	室上稜上部心室中隔欠損
右傍矢状静脈洞髄膜腫	髄膜腫	傍矢状洞髄膜腫
無自覚性低血糖	低血糖	ケトン性低血糖症
両側卵管留血腫	卵管留血腫	卵管留血腫
脱水注意	脱水症	脱水症
心尖部型肥大型心筋症	肥大型心筋症	心尖部肥大型心筋症
右飛蚊症	飛蚊症	飛蚊症
腎不全保存期	腎不全	洞不全症候群
口腔内炎	口内炎	口内炎
びまん性大細胞	びまん性大細胞型Ｂ細胞性リンパ腫	びまん性星細胞腫
大うつ病	単極性うつ病	躁うつ病
肝門部悪性リンパ腫	肝門部リンパ節転移	頚部悪性リンパ腫
精神病性うつ病	うつ病	反復性精神病性うつ病
水疱性類天疱	水疱症	水疱性類天疱瘡
中枢性低換気	換気量減少	心因性過換気
右膝ＡＣＬ損傷	前十字靱帯損傷	膝窩動脈損傷
全身倦怠感軽度	全身倦怠感	全身倦怠感
混合難聴	難聴	混合性難聴
毛孔一致性丘疹	丘疹	ピンタ性丘疹
先天性巨大色素性母斑	巨大母斑細胞母斑	先天性色素異常症
不安大	不安障害	不安障害
胸骨下液体貯留	体液貯留	心膜液貯留
新出肺転移	転移性肺腫瘍	腎癌骨転移
左聴器癌	癌	男性性器癌
多発脳神経障害	多発性脳神経障害	多発性脳神経障害
上腹部リンパ節転移	リンパ節転移	脾門部リンパ節転移
被殻梗塞	被殻出血	延髄梗塞
直腸Ｒａｂ癌	直腸癌	直腸上皮内癌
軽度高血糖	高血糖症	白衣高血圧
本日硬便少量	便異常	血小板減少症
２型腫瘤	腫瘤	陰茎腫瘤
右腎無形成	腎無形成	腎無形成
リンパ節圧痛	圧痛	リンパ節腫瘍
全身性細菌感染症	細菌感染症	細菌感染症
脳髄膜瘤	髄膜脳瘤	水髄膜瘤
水頭症症状	水頭症	水頭症
小血栓	血液凝固異常	脳血栓症
右耳失聴	聴覚消失	右眼失明
統合失調症合併	統合失調症	統合失調症
胃痛症状	胃痛	舌痛症
急性期ＨＩＶ感染症	ＨＩＶ感染症	急性ＨＩＶ感染症候群
右下肢運動障害	四肢運動障害	四肢運動障害
炎症性脱髄性多発根神経炎	慢性炎症性脱髄性多発神経炎	慢性炎症性脱髄性多発神経炎
上行結腸腫瘤	腫瘤	上行結腸腫瘍
過食症状	過食症	過食症
疾病不安	不安障害	疾病逃避
肺癌手術	肺癌	肺癌肉腫
色素脱失	炎症後色素脱失	嗅覚脱失
膿貯留	膿瘍	胸水貯留
片側副腎腫瘍	副腎腫瘍	副腎腫瘍
リンパ節腫脹	リンパ節腫大	肘リンパ節腫脹
右椎骨動脈巨大血栓化動脈瘤	椎骨動脈瘤	内頚動脈眼動脈分岐部動脈瘤
カテ感染	カテーテル感染症	褥瘡感染
安心感	心気症	蟻走感
左鼡径ヘルニア再発	鼡径ヘルニア	鼡径ヘルニア嵌頓
胃食道静脈瘤破裂	食道静脈瘤破裂	食道静脈瘤破裂
左足背蜂窩織炎	足背蜂巣炎	足背蜂巣炎
右胸水貯留	胸水貯留	胸水貯留
暗青色斑	青色母斑	足青色母斑
ＨＣＶ陽性	Ｃ型肝炎ウイルス感染	ＨＩＶ検査陽性
疲労感生	疲労感	疲労感
感染性静脈血栓症	静脈血栓症	妊娠性静脈血栓症
両側腎腫大	腎腫大	腎腫大
過敏性膀胱炎	膀胱炎	単純性膀胱炎
包交時出血	出血	性交後出血
右坐骨骨折	坐骨骨折	坐骨骨折
右耳下腺腫脹	耳下腺腫脹	耳下腺腫脹
進行肺癌	肺癌	進行乳癌
肋骨起始部骨転移	肋骨転移	腸骨リンパ節転移
外傷性変化	外傷	外傷性趾変形
中等度精神遅滞	中等度知的障害	心因反応精神遅滞
先天性左股関節脱臼	先天性股関節脱臼	先天性股関節脱臼
リポフスチン沈着	神経セロイドリポフスチン症	毛包性ムチン沈着症
鮮血痰	血痰	血痰
壊死性変化	壊死	壊死性膵炎
溶連菌感染	溶連菌感染症	溶連菌感染症
局所発赤	発赤	局所出血
不整脈チーム	不整脈	不整脈
中等度ＣＯＰＤ	慢性閉塞性肺疾患	中等度知的障害
胸部圧痛	圧痛	腹部圧痛
両上肢痛	上肢痛	上肢痛
気分不快症状	悪心	気分循環症
右上腕骨近位端粉砕骨折	上腕骨近位端粉砕骨折	上腕骨近位端粉砕骨折
乳突蜂巣	乳様突起炎	眼窩蜂巣炎
褥創形成	褥瘡	舌低形成
ガマ腫	がま腫	乳腺腫
膀胱腫瘍再発	膀胱腫瘍	膀胱腫瘍
夜間せん妄状態	せん妄	夜間せん妄
神経系腫瘍	腫瘍	神経細胞腫瘍
クッシング徴候	クッシング症候群	クッシング症候群
先天性側弯	肋骨異常を伴う先天性側弯症	先天性弱視
非定型抗酸菌肺炎	肺炎	非定型肺炎
軽度甲状腺腫大	甲状腺腫	卵巣甲状腺腫
手足痺れ	四肢しびれ	手足口病
節外性濾胞辺縁帯リンパ腫	脾辺縁帯リンパ腫	節性辺縁帯リンパ腫
左下葉肺癌	下葉肺癌	下葉肺癌
Ｋｌｅｂｓｉｅｌｌａ　ｐｎｅｕｍｏｎｉａｅ敗血症	新生児クレブシエラ敗血症	新生児コアグラーゼ陰性ぶどう球菌敗血症
若年性認知症	認知症	血管性認知症
外腸骨域リンパ節腫大	リンパ節腫大	鎖骨上リンパ節腫脹
貧血高度	貧血	貧血母斑
腰部腫瘍	腰椎部腫瘍	腰椎部腫瘍
鼠径ヘルニア	鼡径ヘルニア	鼡径ヘルニア
分化型管状腺癌	癌	膵管内管状腺癌
侵襲性肺アスペルギウス症	侵襲性肺アスペルギルス症	侵襲性肺アスペルギルス症
孤発性ＣＪＤ	孤発性クロイツフェルト・ヤコブ病	多発性漿膜炎
右下葉結節影	胸部異常陰影	皮下結節
軽度左軸偏位	心電図左軸偏位	心電図左軸偏位
左頚部結核性リンパ節炎	結核性リンパ節炎	頚部化膿性リンパ節炎
食道がん	食道癌	食道びらん
肛門部発赤	発赤	肛門部腫瘤
脳室拡大進行	脳室拡大	脳室拡大
下腿潰瘍	下腿皮膚潰瘍	下腿腫瘍
小脳転移	転移性脳腫瘍	脊椎転移
腎盂軽度拡張	腎盂拡張	腎盂拡張
腫瘍指摘	腫瘍	腫瘍
心臓原発性悪性リンパ腫	心臓悪性リンパ腫	心臓悪性リンパ腫
準夜帯嘔気	嘔気	頬小帯異常
成人Ｓｔｉｌｌ病	成人スチル病	成人型クラッベ病
脳血管疾患	脳血管障害	肺血管疾患
左膝窩部痛	膝窩部痛	膝窩部痛
非浸潤性尿路上皮癌	尿管尿路上皮癌	非浸潤性小葉癌
下咽頭がん	下咽頭癌	下咽頭異常
両上肢痺れ	上肢しびれ	上肢しびれ
混合性肝癌	肝癌	混合型肝癌
甲状腺痛	甲状腺炎	甲状腺癌
少量血便	血便	粘血便
脳梗塞有	脳梗塞	脳梗塞
痕発赤	発赤	発赤
不消化便	消化不良性下痢	骨軟化症
末梢性めまい	めまい症	末梢性めまい症
左上腕骨肉腫	上腕骨骨肉腫	上腕骨骨肉腫
四肢型運動失調	運動失調	脊髄性運動失調
産生胃癌	胃癌	早期胃癌
下肢冷感軽度	下肢冷感	下肢冷感
左室内同期不全	左室不全	左室不全
左脛腓骨骨折	腓骨骨折	脛骨腓骨骨折
漿液性腺腫	卵巣漿液性腺腫	卵巣漿液性腺腫
日本海裂頭条虫	日本海裂頭条虫症	日本海裂頭条虫症
先天性脳血管異常	脳動静脈奇形	先天性耳管異常
臀部皮疹	発疹	斑状皮疹
歩行時軽度跛行	跛行	脊髄性間欠性跛行
心室中隔扁平化	心室中隔欠損症	心室中隔欠損症
フルニエ壊疽	外陰部壊死性筋膜炎	神経原性壊疽
肝芽腫再発	肝芽腫	肝芽腫
状血管腫	血管腫	腎血管腫
卵巣癌破裂	卵巣癌	卵巣破裂
右下腿疼痛	下腿痛	下腿痛
軽度眼球突出	眼球突出症	眼球突出症
前頭葉障害	前頭葉症候群	前頭葉腫瘍
歯牙損傷	切歯破折	気管損傷
両側乳糜胸水	胸水貯留	良性石綿胸水
肺門部リンパ節腫大	肺門リンパ節腫脹	肺門リンパ節腫脹
麻疹罹患歴	麻疹	麻疹様紅斑
尿漏れ	尿失禁症	尿道痛
心膜播種	腹膜播種	腹膜播種
髄液播種	腹膜播種	腹膜播種
左腎動脈狭窄症	腎動脈狭窄症	腎動脈狭窄症
体動時創部痛	術創部痛	術創部痛
後頭部皮下血腫	頭部皮下血腫	側頭部皮下血腫
ＭＲＳＡ菌血症	ＭＲＳＡ感染症	ＭＲＳＡ敗血症
篩骨蜂巣	篩骨洞炎	篩骨洞癌
左退形成性星細胞腫	退形成性星細胞腫	退形成性星細胞腫
仮性動脈瘤切除	偽性動脈瘤	偽性動脈瘤
鼻中隔血腫	血腫	鼻中隔穿孔
左嗅裂ポリープ	ポリープ	上顎洞ポリープ
労作時疲労	疲労感	労作性失神
不定愁訴多	不定愁訴症	不定愁訴症
軽度失調性構音障害	構音障害	運動障害性構音障害
びらんからの出血	出血	びらん性関節症
動揺性精神神経症状	神経症	精神神経症
過呼吸気味	過換気症	無呼吸発作
真菌性感染性心内膜炎	細菌性心内膜炎	亜急性感染性心内膜炎
気道狭窄音	気道狭窄	気道狭窄
未分類関節炎	関節炎	若年性関節炎
左視床出血	視床出血	視床出血
骨突出部発赤	発赤	骨盤出口狭窄
神経症性うつ病	抑うつ神経症	神経症性抑うつ状態
右浸潤影	胸部異常陰影	角膜浸潤
四肢近位筋筋力低下	筋力低下	四肢筋力低下
左耳後部腫瘤	耳後部腫瘤	耳後部腫瘤
右乳腺良性腫瘍	乳腺腫瘍	耳下腺良性腫瘍
左尿管結石性腎盂腎炎	結石性腎盂腎炎	結石性腎盂腎炎
イレウス気味	偽性イレウス	イレウス
筋力低下可能性	筋力低下	筋力低下
咽喉頭違和感	咽喉頭異常感症	咽喉頭異常感症
前立腺癌死	前立腺癌	前立腺癌
再度皮疹	発疹	斑状皮疹
左肩腱板損傷	肩腱板損傷	肩腱板損傷
低形成	骨髄低形成	舌低形成
再脱臼	脱臼	亜脱臼
左肺動脈狭窄症	肺動脈狭窄症	肺動脈狭窄症
肺動脈弁上狭窄	肺動脈弁上狭窄症	肺動脈弁上狭窄症
後頸部発赤	発赤	後頭部脳瘤
血管原性浮腫	浮腫	血管神経性浮腫
偽粘液腫	粘液腫	粘液腫
毛包向性菌状息肉症	菌状息肉症	菌状息肉症
Ｂｌｕｅ　ｔｏｅ　ｓｙｎｄｒｏｍｅ	末梢動脈疾患	Ｅｕｔｈｙｒｏｉｄ　Ｓｉｃｋ症候群
嚢胞様腫瘤像	腫瘤	顎下腺腫瘤
右足不随意運動	不随意運動症	異常不随意運動
婦人科癌	癌	喉頭蓋癌
両側眼振	眼振	潜伏眼振
爪水虫	爪白癬	脱水症
子宮体癌Ｉａ期	子宮体癌	子宮体癌再発
過活動型せん妄	せん妄	疲憊せん妄
左下肢鬱滞性皮膚炎	うっ滞性皮膚炎	うっ滞性皮膚炎
ＢＰＳＤ	認知症に重なったせん妄	Ｂ型肝炎
進行性核上麻痺	進行性核上性麻痺	進行性核上性麻痺
汎発性水痘感染症	水痘	潜在性結核感染症
えん下障害	嚥下障害	嚥下障害
左上腕悪性黒色腫	上腕部悪性黒色腫	上腕部悪性黒色腫
左側頭葉挫傷	脳挫傷	外側手腕挫傷
虚血性肝炎	肝炎	虚血性腸炎
重症敗血症	敗血症	重症便秘症
幽門前部狭窄	幽門狭窄症	膀胱頚部狭窄
圧迫移植部ネクローシス	壊死	胆のうコレステローシス
子宮頸癌子宮頚癌	子宮頚癌	子宮頚部上皮内癌
舌乾燥	口腔乾燥症	口内乾燥
足痛い	足痛	足痛
円形紅斑	紅斑症	多形紅斑
左眼後発性白内障	白内障	後発白内障
徐脈気味	徐脈	徐脈発作
境界性パーソナリティ障害	境界型パーソナリティ障害	境界型パーソナリティ障害
鼻骨折	鼻骨骨折	鼻骨骨折
膵尾部腫瘤性病変	膵腫瘤	膵頭部腫瘤
重症腸炎	腸炎	慢性腸炎
左大腿骨転子下骨折	転子下骨折	大腿骨転子部骨折
左低形成腎	低形成腎	低形成腎
肺野すりガラス状陰影	肺野異常陰影	肺トキソプラスマ症
アテローム性血栓性脳梗塞	血栓性脳梗塞	アテローム血栓性脳梗塞
結腸癌肝転移	転移性肝癌	大腸癌骨転移
診察時皮疹	発疹	落屑性皮疹
切開関連性心房粗動	心房粗動	一過性心房粗動
硬性白斑	白斑	老人性白斑
術後不整脈	不整脈	術中不整脈
広範囲脊柱管狭窄症	広範脊柱管狭窄症	広範脊柱管狭窄症
中～低分化肝細胞癌	肝細胞癌	卵巣未分化胚細胞腫
起床時咳嗽	咳	感染後咳嗽
腰骨骨折	腰椎骨折	恥骨骨折
血性腹水貯留	腹水症	血性腹水
心理的不安	不安障害	心理的虐待
カンジダ肺炎	肺カンジダ症	カンジダ症
右小細胞癌	小細胞肺癌	食道小細胞癌
頬部悪性腫瘍	頬部腫瘍	腹部悪性腫瘍
多源性ＰＶＣ散発	心室期外収縮	多源性心室期外収縮
原発性甲状腺機能低下	甲状腺機能低下症	原発性甲状腺機能低下症
ヨードアレルギー	ヨード過敏症	牛乳アレルギー
右ＩＣ動脈瘤	内頚動脈脳動脈瘤	右胃動脈瘤
顔面形成	顔面形成異常	顔面形成異常
活動性肝炎	肝炎	活動性慢性肝炎
インフルエンザ陽性	インフルエンザ	インフルエンザ脳症
眼球結膜浮腫	結膜浮腫	眼球結膜裂傷
排便なし	便秘症	排便障害
全身性Ｃａｎｄｉｄａ感染症	カンジダ症	全身性アクチノバチルス症
顔面神経痛	三叉神経痛	顔面神経損傷
多発肺膿瘍	肺膿瘍	多発性肝膿瘍
疣贅様構造物	疣贅	皮斑様血管炎
アルコ−ル性肝硬変	肝硬変症	アルコール性肝硬変
皮質層状壊死	壊死	皮膚壊死
発熱随伴症状	発熱	腫瘍随伴症候群
急性肺動脈血栓塞栓症	肺動脈血栓塞栓症	肺動脈血栓塞栓症
両下肢深部静脈血栓症	下肢静脈血栓症	下肢静脈血栓症
右上腕骨近位端骨折	上腕骨近位端骨折	上腕骨近位端骨折
脳炎脳症	脳症	脳炎後遺症
辺縁性脳炎	脳炎	辺縁系脳炎
易疲労性強い	易疲労感	疲労性筋炎
せん妄生	せん妄	せん妄
右第３趾爪囲炎	爪囲炎	化膿性爪囲炎
多発縦隔リンパ節転移	縦隔リンパ節転移	縦隔リンパ節転移
家族性ＣＪＤ	家族性クロイツフェルト・ヤコブ病	家族性心筋症
圧迫時疼痛	疼痛	難治性疼痛
症型Ａ群溶連菌感染症	溶連菌感染症	Ｂ群溶連菌感染症
末梢肺動脈塞栓症	動脈塞栓症	末梢動脈塞栓症
歩容困難	歩行障害	歩行困難
脳室出血	出血	脳室内出血
顔面痺れ	しびれ感	顔面疣贅
尿失禁状態	尿失禁症	尿失禁症
重度失調性構音障害	構音障害	運動障害性構音障害
卵巣癌Ⅲｃ期	卵巣癌	卵巣癌肉腫
低血糖鞘状	低血糖	低血糖発作
発赤潰瘍	発赤	多発胃潰瘍
左下肺浸潤影	肺部異常陰影	下肺野陰影
右大脳動脈未破裂動脈瘤	脳動脈瘤	大腿動脈仮性動脈瘤
失語正常	失語症	失語症
先週頭痛	頭痛	眼性頭痛
ｃｅｌｌ　ｌｅｕｋｅｍｉａ	白血病	解離性大動脈瘤ＤｅＢａｋｅｙＩＩ
失語持続	失語症	失語症
ＧＣＡ	巨細胞動脈炎	ＨＣＡＨＣ
大動脈弁硬化症	大動脈弁狭窄症	大動脈硬化症
多発筋炎	多発性筋炎	多発性筋炎
呼吸促迫症状	呼吸促迫	呼吸促迫
大腿骨骨頭壊死	大腿骨頭壊死	大腿骨頭壊死
呼気喘鳴	喘鳴	先天性喘鳴
サイトメガロ網膜炎	サイトメガロウイルス網膜炎	サイトメガロウイルス網膜炎
ＡＣＴＨ非依存性Ｃｕｓｈｉｎｇ症候群	クッシング症候群	ステロイド依存性ネフローゼ症候群
次週左気胸	気胸	特発性気胸
内分泌機能不全	内分泌機能異常	膵外分泌機能不全
熱	発熱	Ｑ熱
Ｍａｌｌｏｒｙ−Ｗｅｉｓｓ症候群	マロリ・ワイス症候群	Ｅｕｔｈｙｒｏｉｄ　Ｓｉｃｋ症候群
軽度音声障害	音声障害	軽度認知障害
緑膿菌腸炎	緑膿菌性腸炎	緑膿菌性腸炎
ドレーン出血	出血	皮質脳内出血
副鼻腔転移	副鼻腔癌	副鼻腔結核
原発不明癌頸部転移	原発不明癌	原発不明癌
発熱中	発熱	発熱
再発腫瘤	腫瘤	手指腫瘤
右錐体路障害	錐体路障害	錐体路障害
犬吠様咳嗽	咳	感染後咳嗽
両下肢筋痛	下肢筋肉痛	下肢筋肉痛
左室ブロック波形	心電図異常	房室ブロック
有痛性腫瘤	腫瘤	化膿性腫瘤
難治性冠攣縮性狭心症	冠攣縮性狭心症	冠攣縮性狭心症
起床時頭痛	頭痛	睡眠時頭痛
Ⅱ型房室ブロック	房室ブロック	術後房室ブロック
眼白内障	白内障	白内障
慢性下気道感染	急性気管支炎	慢性上気道炎
乳頭様腎盂腫瘍	腎盂乳頭状癌	腎盂腫瘍
喀痰付着	喀痰	喀痰
両側下腿潰瘍	下腿皮膚潰瘍	下腿腫瘍
心肺停止後蘇生	心肺停止	心肺停止
ＳＣＤ	脊髄小脳変性症	Ｓ状腎
無症候性腸アメーバ症	腸アメーバ症	慢性腸アメーバ症
手首痛	手部痛	手指痛
頸部食道癌	頚部食道癌	下部食道癌
症候性てんかん発症	症候性てんかん	症候性てんかん
左腎血管腫	腎血管腫	腎血管腫
地誌的失認	失認	発達性失認
命令性幻聴	幻聴	中枢性難聴
子宮体癌Ⅱ期	子宮体癌	子宮体癌再発
両側副腎腫瘍	副腎腫瘍	副腎腫瘍
左顔面神経麻痺症状	顔面神経麻痺	顔面神経麻痺
左顔面痛覚障害	片側痛覚鈍麻	顔面神経障害
顎部痛	顎痛	頬部痛
元々疼痛	疼痛	癌性疼痛
粘膿性鼻汁	鼻汁	化膿性鼻炎
膣原発横紋筋肉腫	横紋筋肉腫	鼡径部横紋筋肉腫
卵巣嚢腫ＯＰ	卵巣のう腫	卵巣肉腫
遅発性ペースメーカー感染症	ペースメーカ植え込み後感染症	ペースメーカリード断線
子宮筋肉腫	子宮肉腫	子宮癌肉腫
肺血管陰影増強	肺血管疾患	肺血管狭窄症
頭頸部放線菌症	放線菌症	皮膚放線菌症
腎機能障害	腎機能低下	肝機能障害
Ｈｏｄｇｋｉｎ　Ｌｙｍｐｈｏｍａ	ホジキンリンパ腫	ＨＩＶサイトメガロウイルス感染症
冠動脈−肺動脈瘻	肺動脈瘻	大動脈肺動脈窓
嚥下時疼痛	嚥下痛	嚥下痛
術後創感染	術後膿瘍	術後創部感染
大腸ポリープ後	大腸ポリープ	大腸ポリープ
右下葉扁平上皮癌	下葉肺扁平上皮癌	下葉肺扁平上皮癌
咳嗽法	咳	失文法
高リスク前立腺癌	前立腺癌	進行性前立腺癌
門脈圧亢進	門脈圧亢進症	門脈圧亢進症
認知面低下	軽度認知障害	下肢知覚低下
ノカルジア	ノカルジア症	ノカルジア症
右人工膝関節感染	人工膝関節感染	人工膝関節感染
膿梗塞	脳梗塞	肝梗塞
下大静脈狭窄	大静脈狭窄症	下大静脈損傷
十二指腸穿通性潰瘍	穿通性十二指腸潰瘍	十二指腸球後部潰瘍
左横隔膜弛緩症	横隔膜弛緩症	横隔膜弛緩症
火傷	熱傷	創傷
入眠困難感	不眠症	月経困難症
非定型カルチノイド腫瘍	カルチノイド	消化管カルチノイド
軽度食欲低下	食欲不振	重度視力低下
尿管結石有	尿管結石症	尿管結石症
両下腿壊疽性膿皮症様潰瘍	膿皮症	下腿難治性皮膚潰瘍
冠攣縮型狭心症	冠攣縮性狭心症	冠攣縮性狭心症
恥骨骨髄炎	骨髄炎	腸骨骨髄炎
かすみ目	視力低下	しらみ症
眩暈消失	めまい	意識消失
手指関節腫脹	関節炎	手指関節損傷
ＳＰＮ	充実性偽乳頭状腫瘍	Ｓ状腎
夜間嘔気	嘔気	夜間遺尿
左足背発赤	下腿発赤	足背腫瘍
女性器クラミジア感染症	クラミジア感染症	新生児クラミジア感染症
血液凝固障害	血液凝固異常	血液凝固異常
慢性的な呼吸困難	呼吸困難	肺性呼吸困難
右肺下葉肺炎	肺炎	乳嚥下性肺炎
低酸素虚血性脳症	低酸素性脳症	低酸素性脳症
左大葉性肺炎	大葉性肺炎	大葉性肺炎
膵臓癌術後再発	膵癌	直腸癌術後再発
足底湿疹	足湿疹	足湿疹
歩行ふらつき	めまい	退行期うつ病
結腸縫合不全	縫合不全	結腸回転不全
多発肝血管腫	多発性肝血管腫	多発性肝血管腫
紅色腫瘤	腫瘤	食道腫瘤
気管支閉鎖症	気管支閉鎖	気管支閉鎖
神経アミロイドーシス	アミロイドーシス	皮膚アミロイドーシス
夜疼痛	疼痛	疼痛
咽頭粘膜発赤	発赤	咽頭発赤
時々不整脈	不整脈	術中不整脈
多発性リンパ節転移	多部位リンパ節転移	多部位リンパ節転移
新生児死亡	原因不明の死亡	新生児紅斑
最近花粉症	花粉症	スギ花粉症
食道空腸吻合部狭窄	吻合部狭窄	尿管回腸導管吻合部狭窄
クリオグロブリン性血管炎	クリオグロブリン血症性血管炎	クリオグロブリン血症性血管炎
右頬部擦過傷	頬部擦過創	頬部擦過創
右肺下葉癌	下葉肺癌	舌下面癌
腎結石多発	腎結石症	腎結石自排
ＥＢウイルス初感染	ＥＢウイルス感染症	ＥＢウイルス感染症
外表奇形	奇形	外鼻奇形
急性膵臓炎	急性膵炎	急性膵炎
Ｉｓｐポリープ	大腸ポリープ	副鼻腔ポリープ
咽頭部発赤	発赤	咽頭発赤
頭部腫瘍	頭部皮下腫瘍	膵頭部腫瘍
遅発性発疹	発疹	特発性発疹
肺炎悪化	肺炎	肺炎結核
朝痰	喀痰	血痰
子宮体癌Ⅳ期	子宮体癌	子宮体癌再発
骨外腫瘤形成	腫瘤	骨髄低形成
低悪性度Ｂ細胞性リンパ腫	びまん性大細胞型Ｂ細胞性リンパ腫	リンパ形質細胞性リンパ腫
視神経脊髄炎（ＮＭＯ）	視神経脊髄炎	視神経脊髄炎
左下副甲状腺腺腫	副甲状腺腺腫	副甲状腺腺腫
単形性ＶＴ	非持続性心室頻拍	単純性便秘
特発性心室細動	心室細動	一過性心室細動
高脂血症高脂血症	高脂血症	高脂血症性網膜症
白色調腫瘍	腫瘍	白色水腫
左頬部有棘細胞癌	頬部有棘細胞癌	頬部有棘細胞癌
Ｇｏｔｔｒｏｎ徴候	ゴットロン丘疹	Ｇ６ＰＤ欠乏性貧血
脊柱起立筋膿瘍	筋膿瘍	脊髄硬膜外膿瘍
左踵骨骨折	踵骨骨折	踵骨骨折
胃癌幽門狭窄	幽門狭窄症	術後幽門狭窄
拡張能障害	心不全	腸機能障害
小腸静脈瘤破裂	食道静脈瘤破裂	食道静脈瘤破裂
右上肢振戦	一側上肢振戦	一側上肢振戦
中枢性甲状腺機能低下症	甲状腺機能低下症	続発性甲状腺機能低下症
左肺動脈閉塞	肺動脈狭窄症	小脳動脈閉塞
単純性網膜症	網膜症	近視性網膜症
両眼性複視	複視	遠視性弱視
Ｈｅｎｏｃｈ−Ｓｃｈｏｎｌｅｉｎ紫斑病	ＩｇＡ血管炎	先天性血栓性血小板減少性紫斑病
右胸腔内腫瘍	腫瘍	胸腔内腫瘤
尿もれ	尿失禁症	肉離れ
下肢筋力低下自覚	筋力低下	上肢筋力低下
右足静脈瘤	静脈瘤	外陰静脈瘤
上気道浮腫	咽頭浮腫	上気道出血
複雑型熱性痙攣	熱性痙攣	無熱性痙攣
吻合部浮腫	浮腫	吻合部潰瘍
右膀胱側壁部膀胱癌	膀胱側壁部膀胱癌	膀胱側壁部膀胱癌
Ｃａｐｎｏｃｙｔｏｐｈａｇａ　ｃａｎｉｍｏｒｓｕｓ感染症	グラム陰性菌感染症	大動脈弁閉鎖不全症兼僧帽弁閉鎖不全症兼三尖弁閉鎖不全症
子宮頸部頸管狭窄	子宮頚管狭窄症	子宮頚管狭窄症
呼吸喘鳴	喘鳴	呼吸促迫
口腔内乾燥	口腔乾燥症	口内乾燥
脊椎管狭窄症	脊柱管狭窄症	脊柱管狭窄症
ヘルペス髄膜炎	髄膜炎	ヘルペス角膜炎
左股関節破壊	股関節症	股関節割創
左前庭障害	前庭障害	前庭障害
膠原繊維性腸炎	腸炎	ウイルス性腸炎
食道期軽度障害	嚥下障害	食道通過障害
右外腸骨静脈狭窄	静脈狭窄	外腸骨動脈狭窄
妊娠発覚	妊娠	妊娠湿疹
両膝関節症	膝関節症	膝関節症
類もやもや病	もやもや病	もやもや病
呼内疾患ベース肺炎	肺炎	アデノウイルス肺炎
左足関節開放性脱臼骨折	足関節開放性脱臼骨折	足関節開放性脱臼骨折
白色粘性痰	喀痰	白色粃糠疹
食道癌２病変	食道癌	食道癌骨転移
右卵巣奇形腫	卵巣奇形腫	卵巣奇形腫
感冒罹患	感冒	感冒
血腫像	血腫	血腫
ｌｙｍｐｈｏｍａ	悪性リンパ腫	新生児Ｒｈ不適合
左足首骨折	足関節骨折	中足骨骨折
慢性血栓性肺高血圧症	慢性血栓塞栓性肺高血圧症	慢性血栓塞栓性肺高血圧症
眼振誘発	眼振	眼振
急性ウイルス性脳炎	ウイルス性脳炎	急性ウイルス性肝炎
掻痒等	そう痒	掻創
労作時呼吸困難感軽度	労作時呼吸困難	労作時呼吸困難
逆流性食道炎症状	逆流性食道炎	逆流性食道炎
非代償性Ｃ型肝硬変	Ｃ型非代償性肝硬変	非代償性肝硬変
子宮筋腫大	子宮筋腫	子宮筋腫
ヘルペス感染症	ヘルペスウイルス感染症	ケヌルス感染症
抑うつあり	うつ状態	抑うつ神経症
出血腫脹	出血	精巣腫脹
急性感音性難聴	感音難聴	両側性感音難聴
肺塞栓既往	肺塞栓症	肺塞栓症
リンパ節多発転移	多部位リンパ節転移	リンパ節転移
ｉｎｖａｓｉｖｅ　ｔｈｙｍｏｍａ	悪性胸腺腫	急性大動脈解離ＤｅＢａｋｅｙＩＩＩａ
イレウスリスク高い	イレウス	インスリン異常症
左肺下葉扁平上皮癌	下葉肺扁平上皮癌	下葉肺扁平上皮癌
分類不能型免疫不全	免疫不全	分類不能免疫不全症
高度拘束性換気障害	拘束性換気障害	拘束性換気障害
非典型的胸痛	胸痛	非定型顔面痛
ＭＲＳＡ感染	ＭＲＳＡ感染症	ＭＲＳＡ感染症
肝多発腫瘤	肝腫瘤	肝腫瘤
左大腿骨病的骨折	大腿骨病的骨折	大腿骨病的骨折
Ｓ状結腸癌術後肝転移	転移性肝癌	Ｓ状結腸軸捻転
棘波	心電図異常	棘刺創
黄色痰自己喀出	膿性痰	黄色靱帯骨化症
心膜腔内播種	転移性心腫瘍	心膜腔のう胞
耳痛	耳痛症	耳痛症
四肢末端しびれ	しびれ感	四肢端しびれ
内頸動脈狭窄	内頚動脈狭窄症	内頚動脈狭窄症
胃部分壊死	壊死	腱部分断裂
転倒受傷	外傷	前腕熱傷
左急性感音難聴	感音難聴	一側性感音難聴
タール便少量	黒色便	リール黒皮症
切除不能胃癌	胃癌	スキルス胃癌
後頭葉脳出血	脳出血	後頭孔脳脱出症
隅角結節	虹彩結節	皮下結節
落ち着かなさ	多動性障害	落ち込み
脊椎多発圧迫骨折	圧迫骨折	腰椎多発圧迫骨折
左傍脊柱筋膿瘍	筋膿瘍	腸腰筋膿瘍
Ⅰ型ＤＭ	糖尿病	Ｂ型肝炎
多発ＬＮ転移	多部位リンパ節転移	多発性癌転移
右角膜ヘルペス	ヘルペス角膜炎	口角ヘルペス
大腸粘膜癌	癌	大腸粘液癌
大動脈損傷	上大動脈損傷	上大動脈損傷
仙骨前腫瘤	腫瘤	仙骨腫瘍
前頭葉脳出血	脳出血	前頭葉症候群
社会不安症	不安神経症	社会不安障害
左頚部食道傍リンパ節転移	リンパ節転移	頚部リンパ節転移
時折物忘れ	健忘症	充填物粗造
左頬部未分化腺癌	癌	甲状腺未分化癌
ＩＩ型ＤＭ	２型糖尿病	ＡＩＤＳ
脊椎管狭窄	脊柱管狭窄症	脊柱管狭窄症
膨満　グル音正常	腹部膨満	血中コバルト異常
顔面神経麻痺静的再建	顔面神経麻痺	顔面神経麻痺
低分化性扁平上皮癌	癌	転移性扁平上皮癌
左房内粘液腫	心臓粘液腫	左心房粘液腫
重症うつ病	うつ病	不安うつ病
左肺下葉浸潤影	胸部異常陰影	肺野異常陰影
中葉舌区症候群	中葉無気肺	中葉症候群
膵管炎	膵炎	精管炎
軟部組織腫瘤	腫瘤	軟部組織内異物
腫瘤構造	腫瘤	腫瘤
慢性誤嚥	嚥下障害	慢性舌炎
Ｇｍ敗血症	敗血症	ＧＢＳ敗血症
右大腿部蜂窩織炎	大腿部蜂巣炎	大腿部蜂巣炎
病的腹水	腹水症	肝性腹水
慢性疲労	疲労感	慢性舌炎
膿性喀痰	膿性痰	膿性痰
Ｃｈｏｌｅｄｏｃｈｏｃｅｌｅ	総胆管のう腫	ｅｍｂｅｄｄｅｄ埋伏歯
癌再発	癌	乳癌再発
胆汁うっ滞型	胆汁うっ滞	胆汁うっ滞
肺門腫瘤	縦隔腫瘍	肺腫瘤
両膝関節疼痛	膝関節痛	膝関節痛
右鎖骨転移	骨転移癌	肝癌骨転移
緑内症	緑内障	緑内障
夕方痛み	疼痛	定型痛風
左側副部痛	側腹部痛	側胸部痛
後腹膜腫瘍上行結腸浸潤	後腹膜腫瘍	膿瘍性上行結腸憩室
心窩部自発痛	心窩部痛	心窩部痛
リンパ節腫大傾向	リンパ節腫大	リンパ節腫大
時々尿失禁	尿失禁症	切迫性尿失禁
左臀部悪性軟部腫瘍	殿部悪性軟部腫瘍	骨盤部悪性軟部腫瘍
低血糖遷延	低血糖	低血糖発作
右中大脳動脈閉塞症	中大脳動脈閉塞症	中大脳動脈閉塞症
重症ＣＭＶ腸炎	サイトメガロウイルス腸炎	重症潰瘍性大腸炎
発熱コントロール	発熱	陰茎コンジローマ
右下腿蜂窩織炎	下腿蜂巣炎	胃蜂窩織炎
膿瘍形成	膿瘍	眼異形成
右尿管損傷	尿管損傷	尿管損傷
感染性心内膜症	感染性心内膜炎	感染性心内膜炎
ブドウ球菌検出	ぶどう球菌感染症	ブタ流産菌病
副腎皮質機能不全	副腎皮質機能低下症	副腎皮質形成不全
Ｅｓｃｈｅｒｉｃｈｉａ　ｃｏｌｉ	大腸菌感染症	Ｅｕｔｈｙｒｏｉｄ　Ｓｉｃｋ症候群
両側網膜剥離	網膜剥離	胞状網膜剥離
播種性血管内凝固症	播種性血管内凝固	播種性血管内凝固
肺野肺門部異常陰影	肺門部異常陰影	肺門部異常陰影
右房浸潤	乳房悪性腫瘍	角膜浸潤
屈筋腱鞘炎	腱鞘炎	手屈筋腱腱鞘炎
肺結節陰影	胸部異常陰影	肺腫瘤陰影
呼吸困難感等自覚症状	呼吸困難	呼吸困難発作
原発性肺腫瘍	肺腫瘍	原発性骨腫瘍
右下腿コンパートメント症候群	下腿コンパートメント症候群	下腿コンパートメント症候群
右鎖骨上窩リンパ節腫大	鎖骨上リンパ節腫脹	鎖骨上リンパ節腫脹
右鼡径部腫脹	鼡径部腫脹	鼡径部腫脹
低悪性度リンパ腫	ホジキンリンパ腫	脾悪性リンパ腫
右側胸部皮下結節	皮下結節	側頭部皮下血腫
両側卵巣チョコレート嚢胞	チョコレートのう胞	チョコレートのう胞
回盲部悪性リンパ腫	悪性リンパ腫	頚部悪性リンパ腫
陰部腫脹	陰のう腫大	殿部腫脹
腹水浸出	腹水症	羊水漏出
ＴＡＡ	胸部大動脈瘤	血友病Ａ
腸管皮膚瘻	腸瘻	尿管皮膚瘻
ライン感染	カテーテル感染症	ドライブライン感染
多発擦過傷	擦過創	多発性擦過創
脂質異常	脂質異常症	脂質異常症
肺嚢胞感染	肺のう胞	人工弁感染
Ｃｈｕｒｇ−Ｓｔｒａｕｓｓ　症候群	好酸球性多発血管炎性肉芽腫症	シンプソン・ゴラビ・ベーメル症候群
脾結核	結核	耳結核
潰瘍性大腸炎急性増悪	潰瘍性大腸炎	潰瘍性大腸炎合併妊娠
肺抗酸菌感染症	肺非結核性抗酸菌症	肺炎球菌感染症
２型大腸癌	大腸癌	大腸癌
両眼網膜症	網膜症	慢性網膜症
左眼結膜炎	結膜炎	術後結膜炎
右肺原発腺癌	肺腺癌	肺門部腺癌
ＣＲＥＳＴ症候群	クレスト症候群	ＰＯＥＭＳ症候群
感覚神経障害	知覚障害	網膜神経障害
物忘れ	健忘症	肉離れ
脳筋症	ミトコンドリア脳筋症	心筋症
駆細胞型急性リンパ性白血病再発	急性リンパ性白血病	Ｐｈ陽性急性リンパ性白血病
左大腿骨骨腫瘍	大腿骨腫瘍	大腿骨腫瘍
膿瘍縮小	膿瘍	瞼裂縮小
右後頭葉塞栓性脳梗塞	塞栓性脳梗塞	陳旧性塞栓性脳梗塞
肝内転移	転移性肝腫瘍	肝癌骨転移
膵管内乳頭粘液腫瘍	膵管内乳頭粘液性腫瘍	膵管内乳頭粘液性腫瘍
胃癌多発骨転移	胃癌骨転移	胃癌骨転移
僧房弁疣贅	疣贅	化膿性疣贅
左膝窩動脈瘤	膝窩動脈瘤	膝窩動脈瘤
腹部背部痛	背部痛	手背部痛
アルコール性ニューロパチー	アルコール性多発ニューロパチー	アルコール性多発ニューロパチー
体幹部発赤	発赤	脳幹部出血
慢性突発性血小板減少性紫斑病	血小板減少性紫斑病	慢性特発性血小板減少性紫斑病
下部消化管穿孔	腸穿孔	下部消化管出血
Ｔ字杖歩行可能	歩行障害	小脳性歩行失調
鎖骨上リンパ節腫大	鎖骨上リンパ節腫脹	鎖骨上リンパ節腫脹
右大腿ヘルニア嵌頓	大腿ヘルニア嵌頓	大腿ヘルニア嵌頓
大腫瘤影	腫瘤	肺腫瘤陰影
双極２型障害	２型双極性障害	双極性感情障害
感染性腹部動脈瘤	感染性腹部大動脈瘤	感染性腹部大動脈瘤
ヘルペス性脳炎	サル痘	ヘルペス脳炎
不安症様	不安神経症	不安障害
右前額部痛	前頭部痛	前胸部痛
右胸膜播種	胸膜播種	胸膜播種
骨折病変	骨折	骨折
半月体形成糸球体腎炎	半月体形成性糸球体腎炎	半月体形成性糸球体腎炎
筋力低下著明	筋力低下	筋力低下
下肢骨折	骨折	上肢骨折
付属器圧痛	圧痛	付属器腫瘍
アスピリンアレルギー	アスピリン不耐症	ペニシリンアレルギー
固形腫瘍	腫瘍	蝶形骨腫瘍
嘔吐出現	嘔吐症	嘔吐症
統合失調症残遺状態	統合失調症	統合失調症様状態
右上肢不全片麻痺	不全片麻痺	上肢不全麻痺
低血糖生	低血糖	低血糖
劇症型肺炎球菌性敗血症	肺炎球菌性敗血症	肺炎球菌性敗血症
左大腿蜂窩織炎	蜂窩織炎	胃蜂窩織炎
発熱有	発熱	発熱
頭位性回転性めま	体位性めまい	頭位変換性めまい
不眠考	不眠症	不眠症
全失語	全失語症	全失語症
口唇紅潮	紅潮	口唇潰瘍
開腹腫瘤	腫瘤	上腹部腫瘤
左尺骨神経障害	尺骨神経麻痺	多発性神経障害
外側部乳癌	乳癌	乳輪部乳癌
脳幹部神経膠腫	脳幹神経膠腫	脳幹神経膠腫
両足関節以遠しびれ感	しびれ感	全身のしびれ感
左再発性気胸	続発性気胸	特発性気胸
胃のむかつき	悪心	胃のう胞
気管性喘息	気管支喘息	気管支喘息
痒疹結節散在	痒疹	脛骨結節部痛
日中下痢	下痢症	乳児下痢
骨粗鬆症有	骨粗鬆症	骨粗鬆症
先天性胆管欠損	胆管先天奇形	先天性胆のう欠損
左深部静脈血栓症	深部静脈血栓症	深部静脈血栓症
冠性Ｔ波	心電図異常	熱性虚脱
多発胸膜肥厚斑	胸膜肥厚	胸膜肥厚
カンジダ眼内炎	眼内炎	カンジダ性口内炎
副腎転移	転移性副腎腫瘍	肋骨転移
左緊張性気胸	緊張性気胸	緊張性気胸
度腟壁裂傷	腟裂傷	会陰腟壁裂傷
仙骨部腫瘤	腫瘤	後頚部腫瘤
帯状疱疹再燃	帯状疱疹	帯状疱疹
左前胸部腫瘤	前胸部腫瘤	前胸部腫瘤
喘息症状	咳喘息	尿毒症肺
ふらつく気	よろめき歩行	しゃっくり
拡張障害型心不全	心不全	拡張相肥大型心筋症
アカシジア症状	錐体路障害	ノカルジア症
間歇的腹痛	腹痛症	心因性腹痛
左肺舌区扁平上皮癌	肺扁平上皮癌	肺門部扁平上皮癌
星状細胞腫	星細胞腫	星状芽細胞腫
急性腎障害	腎障害	薬剤性腎障害
左鎖骨上リンパ節腫脹	鎖骨上リンパ節腫脹	鎖骨上リンパ節腫脹
陳旧性脳出血	脳出血	外傷性脳出血
良性下垂体腫瘍	下垂体腫瘍	悪性下垂体腫瘍
腸雑音聴取可	異常腸音	腸音亢進
左側頭部帯状疱疹	帯状疱疹	後頭部帯状疱疹
左肺原発性肺癌	原発性肺癌	原発性肺癌
頭蓋内出血性病変	非外傷性頭蓋内出血	頭蓋内占拠性病変
閉塞性睡眠呼吸障害	睡眠時無呼吸症候群	閉塞性睡眠時無呼吸
右披裂部腫瘍	腫瘍	悪性軟部腫瘍
両膝変形	変形性膝関節症	中指変形
表在性腫瘍	腫瘍	転移性腫瘍
左母指多指症	副母趾	母指三指節症
両側側脳室軽度拡大	脳室拡大	脳室拡大
脈性右室心筋症	不整脈原性右室心筋症	不整脈原性右室心筋症
アルコール性末梢神経障害	アルコール性多発ニューロパチー	アルコール性視神経障害
縦隔炎併発	縦隔炎	縦隔炎
暗紅色斑	紅斑症	歯の白色斑
骨盤圧痛	骨盤痛	骨盤痛
骨巨細胞腫瘍	骨巨細胞腫	骨巨細胞腫
Ｌａｎｇｈａｎｓ巨細胞	ランゲルハンス細胞組織球症	上腕骨近位部巨細胞腫
気管支喘息発症	気管支喘息	気管支喘息発作
分葉状嚢胞性腫瘤	腫瘤	足舟状骨良性腫瘍
胆管拡張	胆管拡張症	胆管拡張症
甲状腺肥大	甲状腺疾患	甲状腺欠損
患肢発赤	発赤	下腿発赤
好中球浸潤	好中球増加症	好中球増加症
多房性腫瘤	腫瘤	化膿性腫瘤
夜間不安	不安障害	夜間多尿
右上肢線状強皮症	線状強皮症	線状強皮症
左内耳障害	迷路障害	角膜内皮障害
左耳介発赤	発赤	耳介裂創
朝方倦怠感	倦怠感	下肢倦怠感
後頚部脂肪腫	頚部脂肪腫	頚部脂肪腫
副腎性クッシング症侯群	クッシング症候群	薬物誘発性クッシング症候群
混合性アルカローシス	アルカローシス	呼吸性アルカローシス
痛く	疼痛	痛風
皮疹再燃	発疹	皮膚腫瘤
再発悪性リンパ腫	悪性リンパ腫	縦隔悪性リンパ腫
子宮筋腫手術	子宮筋腫	子宮筋腫術後
時折心窩部痛	心窩部痛	心窩部痛
右足根骨骨折	足根骨骨折	足根骨骨折
腕頭静脈血栓症	静脈血栓症	大腿静脈血栓症
脊椎病変	脊椎異常	脊椎萎縮
歯状核	歯状核赤核淡蒼球ルイ体萎縮症	鋸歯状舌
右脛骨骨幹部骨折	脛骨骨幹部骨折	脛骨骨幹部骨折
両側腎盂軽度拡張	腎盂拡張	腎盂拡張
軽度屈曲拘縮	屈曲拘縮	小指屈曲拘縮
左下肺野陰影	下肺野陰影	下肺野陰影
ＥＢＶ腸炎	細菌性腸炎	出血性腸炎
左側舌癌	舌癌	転移性舌癌
足しびれ	下肢しびれ	下肢しびれ
膵内分泌腫瘍肝転移	転移性肝癌	膵外分泌腫瘍