出現形	正解	予測
副腎原発神経芽腫	副腎神経芽腫	構音障害
Ｗｅｎｃｋｅｂａｃｈ型房室ブロック	ウェンケバッハ型第２度房室ブロック	腸骨骨折
痰貯留多	喀痰	空隙歯列弓
皮膚リンパ腫	菌状息肉症	外傷性両手切断
個細胞壊死	壊死	広範囲顎骨支持型補綴物脱離
左大腿骨顆上骨折	大腿骨外顆骨折	腓骨開放性粉砕骨折
病原性大腸菌Ｏ−１５７感染性腸炎	病原性大腸菌感染症	頚髄麻痺
口腔粘膜浮腫	浮腫	気道損傷・胸腔に達する開放創合併なし
腟粘膜発赤	発赤	肩鎖関節挫傷
レム睡眠行動異常症	レム睡眠行動障害	胸部下部食道癌
閉塞性膵炎	膵炎	尺骨骨折の遷延癒合
脱髄性疾患	脱髄疾患	果糖血症
多発性脾膿瘍	脾膿瘍	尿管炎
間質性肺水腫	肺水腫	下腿メルケル細胞癌
無動性無言	無動性無言症	シュワルツ・ヤンペル症候群
舌扁平上皮癌	舌癌	寄生虫症
両側肺門部浸潤影	胸部異常陰影	前大脳動脈解離
軽度悪心	悪心	成人Ｔ細胞白血病リンパ腫・慢性型
慢性活動性ＥＢウルス感染症	ＥＢウイルス感染症	痙性扁平足
蛋白尿減少	蛋白尿	放射線食道炎
脳障害	脳症	脊髄髄膜腫瘍
中心性奬液性網脈絡膜症	中心性漿液性網脈絡膜症	マイボーム腺炎
左一側性反回神経麻痺	一側性反回神経麻痺	嗅粘膜性嗅覚障害
イレウス様	イレウス	脳循環不全
膵炎併発	膵炎	皮膚粘膜リーシュマニア症
ｈｅｍｏｐｈａｇｏｃｙｔｉｃ　ｓｙｎｄｒｏｍｅ	血球貪食症候群	手骨開放骨折
抗癌剤漏出	薬剤漏出性皮膚障害	延髄血管芽細胞腫
水痘帯状疱疹	帯状疱疹	前頭頂骨進入
ｓｙｓｔｅｍｉｃ　ｍａｓｔｏｃｙｔｏｓｉｓ	肥満細胞腫症	乳糖不耐性下痢症
発汗多量	多汗症	前頭骨内板過骨症
早発黄疸	早発性黄疸	直腸悪性黒色腫
急性細菌性気管支炎	急性気管支炎	迷走神経損傷
右上葉肺小細胞癌	上葉肺大細胞癌	腹腔内腫瘤
腟癌１期	腟癌	子宮頚部びらん
会陰部発赤	発赤	左上大静脈遺残
嚥下時痛軽度	嚥下痛	インフルエンザ性喉頭炎
左顔面血管腫	顔面血管腫	足部メルケル細胞癌
鼻汁多く	鼻汁	異常不随意運動
口腔内出血痕	口腔出血	上腕悪性末梢神経鞘腫
ＳＩＡＤ	抗利尿ホルモン不適合分泌症候群	乳糖不耐性下痢症
夜両足痛	足痛	ピーナッツアレルギー
左後頭葉梗塞	脳梗塞	椎体骨折
左内眼角基底細胞癌	眼角基底細胞癌	膝関節外側側副靱帯捻挫
難治性イレウス	イレウス	脳循環不全
副鼻腔腫瘍	鼻副鼻腔腫瘍	先天性貧血
大腸菌菌血症	菌血症	趾圧挫傷
右前頭葉出血	脳出血	心膜のう胞
左膝部痛	膝窩部痛	人工早産
仙椎陳旧性骨折	陳旧性骨折	細気管支拡張症
乳癌既往	乳癌	外耳道ボーエン病
軽度咽頭発赤	咽頭発赤	足底多汗症
痙攣起	痙攣	側頭葉症候群
下肢浮腫圧痕	下肢浮腫	示指側副靱帯断裂
左側頬部腫脹	頬部腫脹	コレ・シカール症候群
心室中隔穿孔	心室中隔欠損症	結節性多発動脈炎
四肢浮腫軽度	四肢浮腫	ヒトデ毒
大腸ポリープ　ポリペク後	大腸ポリープ	全子宮内反症
腰椎椎体椎間板炎	腰椎椎間板炎	胸部良性軟部腫瘍
左下葉肺炎悪化	大葉性肺炎	陰茎癌
ぼんやり感持続	反応性低下	足関節外側靱帯損傷
右鼠径部痛	鼡径部痛	肋間筋不全断裂
皮疹不変	発疹	膝部血腫
創部痛	術創部痛	重症再生不良性貧血
軽度右気胸	気胸	滲出性腹水
腸閉塞歴	イレウス	肺サルコイドーシス
左大腿骨骨折	大腿骨骨折	壊死性腸炎
紅斑局面多発	紅斑症	異常体重増加
下部進行食道癌	食道癌	網膜前出血
無γグロブリン血症	無ガンマグロブリン血症	１型糖尿病性低血糖性昏睡
子宮頸管ポリープ切除	子宮頚管ポリープ	悪性高血圧症
手首疼痛	疼痛	ピーナッツアレルギー
ｓｐｌｅｎｉｃ　ｍａｒｇｉｎａｌ　ｚｏｎｅ　ｌｙｍｐｈｏｍａ	脾辺縁帯リンパ腫	悪性小脳腫瘍
体動時息ぎれ	労作時呼吸困難	遺伝性運動感覚性ニューロパチー
一部浮腫	浮腫	外耳道癌
ふらつき注意	よろめき歩行	多発性骨盤内臓器損傷
左中耳炎	中耳炎	迷路瘻
胃食道逆流症状	胃食道逆流症	回盲部憩室
両側卵巣子宮内膜症性嚢胞	卵巣子宮内膜症のう胞	軸椎骨折
新出肝転移	転移性肝癌	急性硬膜外血腫
脊椎カリエス	脊椎結核	肘頭部挫傷
行動障害	素行障害	大腿骨多発骨折
妊娠性糖尿病	妊娠糖尿病	示指皮膚癌
小豆大紅斑	紅斑症	異常体重増加
ＦＳＧＳ	巣状糸球体硬化症	手骨開放骨折
左寛骨臼骨折	寛骨臼骨折	斜乱視
原発性両眼内悪性リンパ腫	眼窩悪性リンパ腫	子宮性無月経
腹腔鏡補助下子宮筋腫核	子宮筋腫	母指骨性マレット指
両下肢静脈血栓	下肢静脈血栓症	口腔腫瘍
神経根障害	神経根炎	腸間膜のう腫
クモ膜下出血	くも膜下出血	手関節部滑膜肉腫
後鼻汁症候群	後鼻漏	グラム陰性桿菌感染症
糖尿病性腎症１期	腎性糖尿	既往子宮術後妊娠
左臀部慢性膿皮症	慢性膿皮症	急性単純性歯髄炎
メサンギウム増殖性腎炎	メサンギウム増殖性糸球体腎炎	紫外線角結膜炎
左前頭葉心原性脳梗塞	心原性脳塞栓症	メコン住血吸虫症
閉塞性尿路感染	尿路感染症	高血圧性頭痛
顔面蝶形紅斑	ＬＥ蝶形皮疹	異常体重増加
上行結腸癌肝転移	転移性肝癌	示指悪性黒色腫
仙骨部色素沈着	色素異常症	肺動脈弁狭窄症
肥満糖尿病	糖尿病	単一臍動脈
左肩痛み	肩部筋痛	脛骨前筋症候群
ＰＳＶＴ発作	発作性上室頻拍	手骨開放骨折
顎変形症術後顎変形症	顎変形症	副唾液腺管
ＤＭＮ　２期	糖尿病	悪性小脳腫瘍
労作時胸部絞扼感	胸内苦悶	慢性腎臓病ステージＧ３ｂ
右膝変形	変形性膝関節症	流産熱
指趾潰瘍	趾皮膚潰瘍	Ｂ群連鎖球菌肺炎
２型食道癌	食道癌	反復性耳下腺炎
骨性腫瘤	腫瘤	良性黒色表皮腫
外傷性脊髄損傷	脊髄損傷	頭蓋底陥入症
下肢結節性紅斑	結節性紅斑	ペースメーカ不全
左動眼神経麻痺	動眼神経麻痺	穿通性頭部外傷
家族性海綿状血管腫	海綿状血管腫	白癬
術中直腸損傷	直腸損傷	拘禁反応
下肢動脈瘤	下肢の動脈瘤	新生児膿痂疹
精神病様症状	精神病	ＥＢウイルス伝染性単核症
項頸部痛	頚部痛	アルコール性脳症候群
頸部白斑	白斑	ベネズエラ馬脳脊髄炎ウイルス病
左大腿骨転子部粉砕骨折	転子下骨折	トリコモナス腟炎
最近眠気	非器質性過眠症	線維性骨炎
ＶＨＤ	心臓弁膜症	手骨開放骨折
夜頻尿	夜間頻尿症	急性子宮内膜炎
回盲部炎	回盲部憩室炎	盲腸狭窄症
重症肺血栓塞栓症	肺塞栓症	下顎歯槽骨炎
左歯痛	歯痛	骨端線成長停止
腹膜播種切除	腹膜播種	房室接合部期外収縮
右乳突蜂巣	乳様突起炎	薬剤性糖尿病・昏睡合併あり
右肺尖部気胸	気胸	レリー・ワイル症候群
骨盤内子宮内膜症	子宮内膜症	小腸閉鎖
左頬部痛	頬部痛	鞍鼻
局麻薬アレルギー	薬物過敏症	手指関節拘縮
肺クリプトコックス症	急性肺クリプトコッカス症	帯環金属冠過高
右肩関節亜脱臼半横指	肩関節亜脱臼	指節癒合症
慢性蕁麻疹	慢性じんま疹	不規則月経
マラセチア毛嚢炎	マラセチア毛包炎	慢性咳嗽
高分化型漿液性腺癌	癌	中指屈筋腱癒着
腫瘍床	腫瘍	急性肺性心
左膀胱尿管逆流症	膀胱尿管逆流	胃空腸周囲炎
外側疼痛	疼痛	頬部挫傷
卵巣癌再発卵巣癌	卵巣癌	慢性気管炎
錐体路病変	錐体外路系疾患	脳卒中後片麻痺
リンパ球性白血病	リンパ性白血病	膝部腫脹
クラミジア感染	クラミジア感染症	頬部血管肉腫
奬液性嚢胞腺腫	膵漿液性のう胞腺腫	胃体部癌
夜間倦怠感	倦怠感	後腹膜気腫
脳血栓塞栓症	脳血管閉塞性脳梗塞	小腸間葉系腫瘍
左リウマチ性肘関節症	関節リウマチ・膝関節	ＨＩＶ脳症
右下腿潰瘍感染	下腿皮膚潰瘍	屈曲性対麻痺
気分不快時	悪心	結核性中耳炎
問題なし前立腺肥大	前立腺肥大症	前置胎盤
急性パルボウイルスＢ１９感染症	パルボウイルス感染症	骨盤内炎症性疾患
脂肪性腫瘤	脂肪腫	体液調節不全症
ウィルス性肺炎	肺炎	踵骨開放骨折
類円形紅斑	紅斑症	異常体重増加
書字不能	書痙	大腿動脈損傷
肺動脈狭窄	肺動脈狭窄症	特発性下垂体機能低下症
夜間不眠状態	不眠症	頚部挫傷後遺症
熱型	発熱	真菌感染母体より出生した児
骨盤内充実性腫瘍	骨盤腫瘍	連鎖球菌肺炎
夢遊病	夢遊症	眼瞼良性腫瘤
脊髄小脳変性症６型	脊髄小脳変性症	頬部隆起性皮膚線維肉腫
左内頚動脈閉塞	内頚動脈閉塞症	橈骨手根靱帯断裂
両側角乾燥性結膜炎	結膜炎	坐骨恥骨軟骨結合若年性骨軟骨症
脳虚血症状	脳虚血症	耳の位置異常
微熱持続	微熱	胎芽性肉腫
夕方浮腫	浮腫	慢性気管支炎
眼性疲労	眼精疲労	顔面紅潮
直腸肛門奇形	鎖肛	腓骨動脈損傷
右大腿部腫瘍	大腿悪性軟部腫瘍	赤白血病
頚椎症神経根症	頚椎症性神経根症	後頭蓋窩のう腫
壊死性遊走性紅斑	遊走性紅斑	しゅう酸塩尿症
睡眠障害招くリスク	睡眠障害	肺炎球菌性咽頭炎
上大静脈血栓	静脈血栓症	頭部多発切創
骨盤内ＬＮ転移	骨盤内リンパ節転移	閉鼻声
ＰＫＤ	多発性のう胞腎	手骨開放骨折
分水嶺脳梗塞	脳梗塞	斜視
上皮性腫瘍	腫瘤	腎欠損症
大球性正色素貧血	大球性貧血	前腕血管脂肪腫
挙上空腸穿孔	腸穿孔	ウイルス関連血球貪食症候群
腸管アメーバ感染症	腸アメーバ症	脳動脈炎
放射線性皮膚炎	放射線皮膚炎	上咽頭後壁癌
肛門周囲びらん	外痔びらん	背側脊椎破裂
髄膜炎徴候	髄膜炎	新生児上顎骨骨髄炎
胸部不快	胸内苦悶	精巣蜂巣炎
下葉肺炎	肺炎	臍ヘルニア嵌頓
右足根部粉砕骨折	粉砕骨折	アカントアメーバ角膜炎
蛋白漏出胃腸症	蛋白漏出性胃腸症	網膜鋸状縁断裂
左大脳陳旧性ラクナ梗塞	陳旧性ラクナ梗塞	急性ムコイド中耳炎
出血多量	急性大量出血	肋軟骨部痛
腹水多量	腹水症	表在性角膜炎
腸間膜リンパ管腫	リンパ管腫	多発骨折
右卵巣悪性腫瘍	卵巣悪性腫瘍	アルドステロン産生腫瘍
糖尿病（２型）	２型糖尿病	鎖骨開放性粉砕骨折
化膿性胸鎖関節炎	化膿性関節炎・胸鎖関節	下肢変形
右乳腺線維腫症	線維腫	小脳変性症
肺野鬱血像	肺野異常陰影	興奮型痴愚
児嘔気	嘔気	網膜膠腫
尿閉歴	尿閉	尿道漏
陰嚢びらん	陰のうびらん	小腸脂肪肉腫
精神的ショック	ショック	ビンスワンガー病
右上腕骨外側上顆炎	外側上顆炎	急性羊水過多症
子宮頚上皮内癌	子宮頚部上皮内癌	輪状網膜症
難治性非定型性抗酸菌症	非結核性抗酸菌症	腸憩室炎
軽度腹水	腹水症	表在性角膜炎
湿疹様	湿疹	乳癌皮膚転移
大後頭孔狭窄	軟骨形成不全症	転子間骨折
熱型変化	発熱	帯状角膜混濁
右無機能腎	無機能腎	角膜中心潰瘍
月経痛コントロール不十分	月経痛	フィブリン減少症
左鎖骨下動脈閉塞	鎖骨下動脈閉塞症	脳結核
右ＤＶＴ	深部静脈血栓症	手骨開放骨折
非特異的胸痛	胸痛	腟損傷
Ａｅｒｏｍｏｎａｓ　ｈｙｄｒｏｐｈｉｌａ敗血症	敗血症	肺動脈分岐部狭窄症
重症細菌性敗血症	敗血症	肝移植ドナー
逆行性健忘	逆向性健忘	閉所恐怖症
腹直筋膜下血腫	筋肉内血腫	コロナウイルス感染症
関連腎臓病	腎疾患	腰椎損傷
認知症様症状	認知症	四肢脱力感
顎骨骨折	下顎骨骨折	幻覚薬乱用
高度大動脈弁狭窄	大動脈弁狭窄症	出血性網膜色素上皮剥離
右顔面骨骨折	顔面骨骨折	眼窩内血管腫
炎症性粉瘤	粉瘤	小児性皮質性骨増殖症
左腰部疼痛	腰痛症	眼瞼挫傷
ＨＣＶ重複感染症	Ｃ型肝炎ウイルス感染	調節性眼精疲労
脂質異常症（＋）	脂質異常症	小腸炎
上腹部圧痛	腹部圧痛	母指球部痛
両側椎骨動脈瘤	椎骨動脈瘤	短肢症
非ケトン性高血糖	高血糖高浸透圧症候群	平背症候群
Ｙｅｒｓｉｎｉａ腸炎	エルシニア腸炎	ばち指
声帯浮腫	声帯炎	２型尿細管性アシドーシス
誤嚥性肺炎併発	誤嚥性肺炎	パラプロテイン血症
咳嗽持続	咳	腓腹筋痛
左側下顎骨嚢胞	顎骨のう胞	外陰挫滅傷
右末梢前庭障害	末梢前庭障害	外傷性横隔膜ヘルニア・胸腔に達する開放創合併なし
胆管閉鎖症	胆管閉塞症	三角靱帯捻挫
閉塞性動脈硬化症　症状	閉塞性動脈硬化症	１型糖尿病性ニューロパチー
洞不全	洞不全症候群	前胸壁痛
特発性リンパ浮腫	リンパ浮腫	上咽頭癌
シャント吻合部狭窄	透析シャント狭窄	鎖骨下動脈閉塞症
無気力	無力症	オスラー結節
胸骨炎	胸骨周囲炎	口蓋垂結核
ナッツアレルギー	ピーナッツアレルギー	慢性辺縁性歯周炎軽度
甲状腺乳頭癌術後再発	甲状腺乳頭癌	腰椎骨髄炎
上肢疼痛	疼痛	殿部皮膚潰瘍
Ｔｕｒｎｅｒ症候群	ターナー症候群	糖尿病性アシドーシス
肝臓機能障害用	肝機能障害	癌関連網膜症
左心不全徴候	心不全	ブラストミセス症
ＩＰＭＮ癌化	膵管内乳頭粘液性腺癌	粘膜下腫瘍
後発頚部転移	頚部転移性腫瘍	病巣性ムチン症
下痢治	下痢症	先天性卵巣奇形
朝方疼痛	疼痛	大転子骨折
蜂窩肺形成	蜂窩織炎	角膜脂肪変性
右ＩＣＡ高度狭窄	内頚動脈狭窄症	偽性髄膜炎
膵体部嚢胞	膵のう胞	食道静脈瘤
右気管支狭窄	気管支狭窄症	開放性多発性骨盤内臓器損傷
非ヘルペス性辺縁系脳炎	辺縁系脳炎	感染性外耳炎
無症候性ＶＴ	心室頻拍	骨膜下膿瘍
好酸球増多	好酸球増加症	湿性ラ音
口腔清掃	個人衛生の著しいレベル低下	膝蓋骨骨髄炎
両下腿皮膚潰瘍	下腿皮膚潰瘍	唾液腺腫瘍
無石性胆嚢炎	胆のう炎	リウマチ熱後慢性関節障害
ｓ型ポリープ	ポリープ	頭部損傷
時折頭痛	頭痛	盲腸周囲ヘルニア
関節リウマチ発症	関節リウマチ	副腎皮質ホルモン剤副作用
残像腫瘍	腫瘍	耳介擦過創
両顎下腺腫大	顎下腺肥大	器質性気分障害
夜間中途覚醒時	睡眠障害	肋骨腫瘍
今朝頭痛	頭痛	盲腸周囲ヘルニア
眼球偏移	眼球偏位	アメーバ性虫垂炎
腹腔内癒着高度	腹膜癒着	フェイスボータイププロトラクター破損
右母指多指症	多指症	橈骨遠位端関節内骨折
薬剤性骨髄抑制	骨髄機能低下	新生児型副腎白質ジストロフィー
肥満	肥満症	先天性空腸狭窄症
網膜中心動脈閉塞	網膜中心動脈閉塞症	ミトコンドリア糖尿病・ケトアシドーシス合併あり
中枢神経悪性リンパ腫再発	悪性リンパ腫	先天性胸骨欠損
旅行者下痢症	下痢症	趾第２度熱傷
右声帯ポリープ	声帯ポリープ	小唾液腺炎
非Ｂ非Ｃ型肝硬変	肝硬変症	膵管拡張
頭部皮下結節	皮下結節	転移性上顎洞癌
足がむくみ	下肢浮腫	先天性熱帯熱マラリア
下肢潰瘍	下肢皮膚潰瘍	メネトリエ病
難治性胸腹水	難治性腹水	薬物性角膜炎
幻覚症状	幻覚	関節軟骨腫瘍
異常腫瘤	腫瘤	足関節偽痛風
未破裂脳動脈瘤コイル塞栓	未破裂脳動脈瘤	頭部多発割創
左下顎骨慢性骨髄炎	慢性顎骨骨髄炎	頚部転移性腫瘍
左側頭葉膠芽腫	側頭葉膠芽腫	金属ポンティック破損
脳血管障害性パーキンソニズム	脳血管障害性パーキンソン症候群	腰椎不顕性骨折
右後角脳室内出血	脳室内出血	小指膿瘍
難治性浮腫	高度浮腫	大腿部脂肪肉腫
Ｇｒａｎｕｌｏｍａｔｏｓｉｓ　ｗｉｔｈ　ｐｏｌｙａｎｇｉｉｔｉｓ	多発血管炎性肉芽腫症	乳糖不耐性下痢症
再発脊索腫	脊索腫	術後呼吸不全
Ｃ型肝硬変症	Ｃ型肝硬変	舌裂
左踵部悪性黒色腫	踵部悪性黒色腫	第２趾末節骨骨折
未分化癌	癌	サイロシン中毒
両側副腎悪性リンパ腫	悪性リンパ腫	上肢腫脹
帯状疱疹無	帯状疱疹	前頭頂骨進入
左膝痛み	膝関節痛	人工早産
右下腿痛	下腿痛	ウルリヒ・ファイヘティガー症候群
気管支喘息症状	気管支喘息	妊娠性反復性黄疸
大腿骨内顆骨壊死	特発性大腿骨内顆骨壊死	第２趾末節骨亀裂骨折
炎症性貧血	貧血	中指挫創
両下肢掻痒感	皮膚そう痒症	先天性第Ｘ因子欠乏症
右後頭葉脳挫傷	脳挫傷	咽喉頭異常感症
女性化乳房	女性化乳房症	アンジェルマン症候群
ｍａｓｓ　ｌｅｓｉｏｎ	腫瘤	乳糖不耐性下痢症
右大脳半球多発脳梗塞	多発性脳梗塞	メイ・ヘグリン症候群
大動脈弁膜症	大動脈弁弁膜症	手指神経損傷
鎮静困難	興奮状態	心臓性神経衰弱症
再発腫瘤近傍	腫瘤	大腿部外傷性骨化性筋炎
右下腿麻痺	下肢麻痺	頚椎捻挫
切除不能多発性肝転移	転移性肝腫瘍	輸血後肝炎
腹腔内膿瘍形成	膿瘍	アレルギー性鼻結膜炎
発作性上室性頻拍	発作性上室頻拍	糖原病３型
筋肉痛生	筋肉痛	脊椎固定スクリューのゆるみ
腰椎滑り症	腰椎すべり症	下肢上皮内癌
淡血性胸水	血性胸水	急性硬膜下血腫
腎被膜下出血	外傷性腎被膜下血腫	植物状態
仙骨部褥瘡痕	仙骨部褥瘡	人工骨感染
左肝腫瘍	肝腫瘍	背部横紋筋肉腫
非Ｃｌｏｓｔｒｉｄｉｕｍ性ガス壊疽	ガス壊疽	複雑性合趾症
リンパ腺腫脹	リンパ節腫大	外傷性両手切断
心室二段脈	心室性二段脈	腸上皮化生
鼻腔腫瘍摘出	鼻腔腫瘍	殿部母斑
疼痛時頓用	疼痛	びまん性汎細気管支炎
多房性膿瘍	膿瘍	たこつぼ型心筋症
右耳介後部痛	耳痛症	皮膚ブラストミセス症
左胸壁腫瘍切除	胸壁腫瘍	耳介欠損
無呼吸症候群	無呼吸発作	二分膝蓋骨
右尿管癌	尿管癌	眼窩内異物
出血過多	出血	肋軟骨部痛
甲状腺嚢腫	甲状腺のう胞	腹部悪性黒色腫
両側浸出性中耳炎	滲出性中耳炎	シーバー病
覚醒度	麻酔覚醒遅延	頚部食道開放創
高血糖	高血糖症	腰椎硬膜外血腫
有意弁膜症	弁膜炎	皮膚リーシュマニア症
胸痛無	胸痛	縦隔甲状腺腫
右下肺野無気肺	無気肺	前腕第１度熱傷
小脳性失調	小脳性運動失調症	口唇外傷性腫脹
好酸球増多症	好酸球増加症	湿性ラ音
右腎明細胞肉腫	腎明細胞肉腫	膠原病
甲状腺左葉濾胞腺腫	濾胞性甲状腺腺腫	全身性浮腫
下位運動ニューロン徴候	運動ニューロン疾患	結核性痔瘻
主幹動脈狭窄	脳動脈狭窄症	焦点性知覚性発作
創部皮下血腫	外傷性皮下血腫	膀胱直腸障害
掻痒感軽減	そう痒	脳幹部海綿状血管腫
両肺小結節影	肺野異常陰影	興奮型痴愚
造影剤アレルギー歴	薬物過敏症	小指屈筋腱断裂
左眼鼻涙管閉塞症	鼻涙管閉鎖症	妊娠性乳腺炎
慢性的な抑うつ気分	うつ状態	急性多発性硬化症
鼻部異物肉芽腫	皮膚異物肉芽腫	肝動脈再建術後
遠隔ＬＮ転移	リンパ節転移	手骨開放骨折
子宮がん	子宮癌	播種性糞線虫症
Ｂｉｃｋｅｒｓｔａｆｆ型脳幹脳炎	ビッカースタッフ脳幹脳炎	セメント質増殖症
睾丸腫脹	精巣腫脹	予防接種後感染症
右中皮腫	中皮腫	管内性増殖性糸球体腎炎
ジベル薔薇色粃糠疹	ジベルばら色粃糠疹	局在性網脈絡膜炎
脳実質外腫瘍	腫瘍	喉頭白斑症
抑鬱感	気うつ	後腹膜気腫
扁桃腺腫大	扁桃肥大	滑膜肉腫
口内出血	口腔出血	上腕悪性末梢神経鞘腫
右上方視野欠損	視野欠損	うっ血性鼻炎
両側臼蓋形成不全症	臼蓋形成不全	腹壁欠損
進行肝癌	肝癌	昏迷
噴門部狭窄	胃狭窄	閉塞性鼻炎
突発性腎出血	腎出血	胃平滑筋肉腫
前股関節症	股関節症	子宮穿孔・骨盤腔に達する開放創合併あり
多発肝嚢胞	多発性肝のう胞	恥骨骨炎
過換気状態	過換気症	口腔褥瘡性潰瘍
傍大動脈ＬＮ	大動脈周囲リンパ節転移	肘関節内遊離体
左椎骨動脈低形成	骨髄低形成	外傷性関節症
左房拡張	心拡大	軟骨形成不全症
サルモネラ菌感染症	サルモネラ感染症	妊娠・分娩・産褥の既存の本態性高血圧症
両側性多発性嚢胞腎	多発性のう胞腎	感染性腹部大動脈瘤
化学物質アレルギー	アレルギー	手指関節拘縮
右手指腫脹	手指腫脹	顔面ヘルペス
右足背発赤	発赤	胎向異常新生児
脊柱管高度狭窄	脊柱管狭窄症	耳介開放創
右急性網膜壊死	急性網膜壊死	示指ガングリオン
皮膚硬化がまだかなり	新生児皮膚硬化症	ジャンパー膝
口腔内乾燥軽度	口腔乾燥症	尿路性器はえ幼虫症
下肢筋痛	下肢筋肉痛	高線維素血症
蠕動不良	異常腸音	大腿骨多発骨折
四肢腱反射亢進	反射亢進	中指ＰＩＰ関節捻挫
黒色丘疹	丘疹	硬膜下水腫
胸部陰影	胸部異常陰影	ＡＬＫ陽性未分化大細胞リンパ腫
クモ膜下嚢胞	くも膜のう胞	全盲
２次性糖尿病	二次性糖尿病	網膜中心動脈閉塞症
Ｈａｅｍｏｐｈｉｌｕｓ　ｉｎｆｌｕｅｎｚａｅ敗血症	敗血症	肺動脈分岐部狭窄症
慢性期疼痛	慢性疼痛	びまん性汎細気管支炎
右上葉原発肺小細胞癌	小細胞肺癌	腹腔内腫瘤
出血源不詳	出血	術後甲状腺機能低下症
一般細菌感染	細菌感染症	左胃動脈瘤
急性小脳失調症	急性小脳性失調症	口唇外傷性腫脹
浸潤癌化所見	癌	粘膜下腫瘍
痔核脱出	痔核	糖尿病足病変
重症膵炎	膵炎	卵管腫瘍
痛みアリ	疼痛	腹壁挫傷
左心室内血栓症	心室内血栓症	円板状角膜炎
右足疼痛	疼痛	ピーナッツアレルギー
増殖前網膜症	網膜症	外陰部角化症
傍神経節腫瘍	傍神経節腫	半球間硬膜下血腫
小腸膀胱瘻	膀胱皮膚瘻	術後性上顎顎欠損
左小細胞肺癌	小細胞肺癌	薬剤性膵炎
少量左胸水	胸水貯留	急性硬膜下血腫
多発ＨＣＣ再発	肝細胞癌	妊娠中呼吸器合併症
結核性嚢腫	結核	発達性協同障害
右大腿骨外顆骨折	大腿骨外顆骨折	副腎損傷
巨大膵仮性嚢胞	仮性膵のう胞	萎縮性声帯炎
大腿腫脹	下腿腫脹	声門閉鎖
全身性ＣＭＶ感染症	サイトメガロウイルス感染症	根面板破損
多発肝内転移	転移性肝腫瘍	示指悪性黒色腫
右外耳道炎	外耳炎	舌下腺肥大
両下肢圧痕性浮腫	クインケ浮腫	示指側副靱帯断裂
下部腸間膜動脈出血	動脈性出血	小脳梗塞
ＩｇＭ型Ｍ蛋白	単クローン性免疫グロブリン血症	大腿骨側頚部骨折
喘息発作様症状	気管支喘息発作	マンガン欠乏症
分食道癌	食道癌	反復性耳下腺炎
多少便秘気味	便秘症	二次性骨粗鬆症・病的骨折あり
ポリープ状病変	ポリープ	頭部損傷
既往高血圧	高血圧症	脾損傷
右リウマチ性膝関節症	関節リウマチ・膝関節	先天性外耳道狭窄症
急性骨髄性白血病（ＡＭＬ）	急性骨髄性白血病	腎芽腫
腹水大量	腹水症	表在性角膜炎
全身皮膚発赤	発赤	左上大静脈遺残
多発肺嚢胞	肺のう胞	全身痙攣
右小脳橋角部腫瘍	小脳橋角部腫瘍	頭部アテローム
右眼網膜静脈分枝閉塞症	網膜静脈分枝閉塞症	ぶどう球菌性関節炎
右脛骨腓骨開放骨折	脛骨腓骨開放骨折	重複腟
左側卵巣腫瘍	卵巣腫瘍	スフィンゴリピドーシス
口腔内びらん	口唇びらん	重複母指
紅斑熱群リケッチア症	リケッチア感染症	乳頭腫
ＩＴＰ	特発性血小板減少性紫斑病	乳糖不耐性下痢症
気管支喘息小発作	気管支喘息発作	上皮内癌
解離性動脈瘤破裂	解離性動脈瘤	血栓性血小板減少性紫斑病
左眼窩内腫瘍	眼窩腫瘍	下顎部メルケル細胞癌
肺外小細胞癌	小細胞肺癌	４分の１半盲
高度大動脈弁狭窄症	大動脈弁狭窄症	母指ＭＰ関節痛
ｂｒｅａｋｔｈｒｏｕｇｈ　ｈｅｐａｔｉｔｉｓ	肝炎	上顎歯牙腫
左室圧排	右室肥大	シルビウス裂くも膜のう胞
両側声帯外転障害	声帯外転筋麻痺	先天性外耳道閉鎖症
一部水疱形成	水疱症	雀卵斑
糖尿病潰瘍	糖尿病性潰瘍	下眼瞼扁平母斑
飲みこみにくさ	嚥下障害	環指基節骨骨折
左腎低形成	低形成腎	人工妊娠中絶の不成功
左母趾疼痛	母趾痛	心原性ショック
副腎ヒストプラズマ感染症	真菌症	大腿骨骨折
右眼糖尿病網膜症	糖尿病網膜症	トキソプラスマ症
下肢浮腫左	下肢浮腫	易怒性
両松葉杖歩行	歩行障害	発達性構音障害
冠動脈狭窄３枝病変	狭心症３枝病変	電撃傷
遺伝性低尿酸血症	低尿酸血症	逆生歯
低アルドステロン血症	低アルドステロン症	結核性気胸
小腸皮膚瘻	皮膚瘻	尿管膀胱移行部狭窄
重度僧帽弁狭窄症	僧帽弁狭窄症	粟粒結核
非細菌性血栓性疣贅	疣贅	肛門括約筋不全
特発性腸間膜血腫	血腫	心因性腹痛
脳原発性悪性リンパ腫	脳悪性リンパ腫	外転神経不全麻痺
抜管後両側反回神経麻痺	両側性反回神経麻痺	エンテロウイルス髄膜炎
肝骨転移	骨転移癌	ガングリオシドーシス
乳腺線維腫症	線維腫	小脳変性症
術後左反回神経麻痺	反回神経麻痺	一側性パーキンソン症候群
無症候性髄膜腫	髄膜腫	乳房線維肉腫
左肺下葉肺癌	下葉肺癌	強度近視
アルコール離脱症候群	アルコール離脱状態	肝性胸水
左腸骨骨肉腫	腸骨軟骨肉腫	感染性流産
脳梁低形成	脳梁形成不全	先天性脳腫瘍
表皮内水疱形成	先天性表皮水疱症	根面板脱離
後頚部圧痛	圧痛	テリエン周辺角膜変性
不定愁訴様	不定愁訴症	包皮切創
良性胆道狭窄	胆管狭窄症	腰仙部打撲傷
左下葉非小細胞肺癌	下葉非小細胞肺癌	大網膿瘍
ＣＫＤ　腎硬化症	腎硬化症	鼻部裂創
前頭葉出血	出血	心膜のう胞
有茎性乳頭状腫瘍	腫瘍	頚部リンパ節転移
理解困難	言語理解障害	女性仮性半陰陽
スメア異常	腟スメア細胞診陽性	１型糖尿病性筋萎縮症
腹腔内敗血症	敗血症	脳塞栓症
膵尾部腫大	膵腫大	手外傷後変形治癒
過呼吸状態	過換気症	外陰脂肪腫
右肺門部原発肺小細胞癌	小細胞肺癌	４分の１半盲
胃癌骨髄癌腫症	骨髄転移	伝染性紅斑
眼乾燥感	ドライアイ	小児丘疹性先端皮膚炎
内側縦束症候群	核間性眼筋麻痺	電解質異常
両足関節炎	足関節炎	子宮内膜腫瘍
夜低血糖	低血糖	死体腎移植後
左上下肢軽度麻痺	四肢麻痺	頚椎捻挫
下肢痙性	痙性対麻痺	周産期に発生した大量肺出血
皮疹状況	発疹	腋窩圧挫傷
不適応	適応障害	遺伝性心疾患
陰茎部痛	陰茎部疼痛	ステノトロフォモナス・マルトフィリア肺炎
髄外形質細胞腫	骨外性形質細胞腫	脊髄横断損傷
ｍａｌｉｇｎａｎｔ　ｌｙｍｐｈｏｍａ	悪性リンパ腫	ビタミン過剰症
重症ＡＧＨＤ	重症成人成長ホルモン分泌不全	更年期神経症
両白内障	白内障	先天性のう胞性腺腫様形成異常
腎結石	腎結石症	第５趾ボーエン病
湿疹性病変	湿疹	多発性腹腔内臓器損傷・腹腔に達する開放創合併なし
穿刺部発赤	発赤	胎向異常新生児
時々背部痛	背部痛	足関節外果剥離骨折
手内筋萎縮	筋萎縮症	失声症
腎機能悪化	腎機能低下	前腕ガングリオン
尾てい骨骨折	尾骨骨折	高アンモニア血症
高度視力障害	視力障害	上腕骨顆開放性粉砕骨折
周期性クッシング症候群	クッシング症候群	牽引装置破損
昨夜微熱	微熱	熱性蛋白尿
腓腹筋痙攣	痙攣	風疹脳脊髄炎
左肋骨打撲	肋骨部打撲	調節緊張症
破壊性脊椎症	脊椎症	膝窩部滑液包炎
胆嚢破裂	胆のう管破裂	角膜上皮欠損
独歩不可	歩行障害	子宮広間膜裂孔ヘルニア嵌頓
骨破壊進行	関節リウマチ	環指腱鞘巨細胞腫
下肢白癬	白癬	脳底動脈瘤破裂によるくも膜下出血
左鼓膜発赤	発赤	術後疼痛
潜在結核	結核	不育症
熱苦症状	発熱	モルガーニ症候群
シャイドレジャー症候群	シャイ・ドレーガー症候群	口腔粘膜の刺激性過形成
肺動脈弁閉鎖症	肺動脈弁閉鎖	先天性外陰欠損
脾摘施行Ｃ型肝炎	Ｃ型肝炎	舟状頭蓋
胸水セルブロック	胸水貯留	腹部停留精巣
右肺上葉すりガラス影	胸部異常陰影	前大脳動脈解離
Ｆｏｌｌｉｃｕｌａｒ　ｌｙｍｐｈｏｍａ	濾胞性リンパ腫	ビタミン過剰症
腫瘍性ＤＩＣ	線溶亢進	下腿挫創
右精巣上体炎	精巣上体炎	卵巣性不妊症
左肘関節亜脱臼	亜脱臼	瞳孔異常
左聴神経腫瘍	聴神経腫瘍	再発性脳梗塞
左肺感染性嚢胞	肺のう胞	閉鎖性腎破裂
母体出血	出血	人工歯破損
右足趾壊疽	下肢壊疽	精巣精巣上体炎
胃腸障害	急性胃腸障害	手背膿瘍
残遺癌	癌	腸間膜リンパ節腫脹
不安大きく	不安障害	重複精管
ＭＳ再発	多発性硬化症	手骨開放骨折
強直間代性痙攣発作	間代性痙攣	顔面開放創
一過性意識消失発作	一過性脳虚血発作	ＴＢＧ異常症
乳児白血病	白血病	アレルギー性肝臓症
筋委縮	筋萎縮症	非流暢性失語
水腎再燃	水腎症	小結節性肝硬変
しびれていない	しびれ感	中脳水道先天異常
時々血痰	血痰	ポリオウイルス感染症
左鼠経ヘルニア	鼡径ヘルニア	成人型クラッベ病
遺伝性腎性尿崩症	先天性腎性尿崩症	大腿骨偽関節
尿管結石	尿管結石症	心因性生理的機能低下
体幹掻痒感	そう痒	脳幹部海綿状血管腫
右大腿部骨幹部骨折	大腿骨骨幹部骨折	尋常性ざ瘡
糖尿病神経症	糖尿病性神経痛	単一臍動脈
古典的肝細胞癌再発	肝細胞癌	内側膝窩神経障害
左室低形成	左心低形成症候群	角膜知覚鈍麻
劇症肝炎亜急性型	劇症肝炎	コリンエステラーゼ欠損症
分岐部動脈瘤	内頚動脈後交通動脈分岐部動脈瘤	股関節滑液包炎
腫瘍感染	腫瘍	鼻腔内びらん
悪性腫瘍スクリーニング	悪性腫瘍	習慣性扁桃炎
外陰部炎	外陰炎	十二指腸結核
軽度骨髄抑制	骨髄機能低下	橋本病母体より出生した児
右踵骨折	骨折	二次性甲状腺機能低下症
ＰＰＨ	肺高血圧症	大動脈弁狭窄症兼肺動脈弁閉鎖不全症
頭痛時折	頭痛	盲腸周囲ヘルニア
血腫貯留	血腫	膵臓性腹膜炎
不整脈発作	不整脈	体重減少性無月経
静脈炎症状	静脈炎	二次性糖尿病・末梢循環合併症あり
子宮間質肉腫	肉腫	後腹膜胆のう
右主気管支膜様部壊死	壊死	下腿骨折変形治癒
右下肺野スリガラス影	胸部異常陰影	前大脳動脈解離
時々頭痛	頭痛	盲腸周囲ヘルニア
胆嚢腺扁平上皮癌	癌	肝被膜下血腫・腹腔に達する開放創合併あり
上行結腸早期癌	上行結腸癌	サイトメガロウイルス肺炎
突発性血小板減少性紫斑病	血小板減少性紫斑病	カプラン症候群
意識変動	意識障害	弓状暗点
左閉鎖リンパ節転移	リンパ節転移	結節性壊死性皮膚炎
両側小脳梗塞	小脳梗塞	メイ・ヘグリン症候群
胃癌多発肝転移	転移性肝癌	示指悪性黒色腫
左前腕浮腫	浮腫	短肋骨症候群
赤紫斑	紫斑病	瓜実条虫症
偽腔閉塞型大動脈解離	解離性大動脈瘤	手部良性軟部腫瘍
高度感音性難聴	感音難聴	肘損傷
左耳介欠損	耳介欠損	遷延性虹彩炎
尿路感染	尿路感染症	第４趾皮膚癌
縦隔炎再発	縦隔炎	異所性胃粘膜
前立腺肥大有	前立腺肥大症	前置胎盤
胆嚢腫瘍	胆のう腫瘍	術後嚥下障害
胃がん	胃癌	上腕骨近位骨端線離開
左中大脳動脈梗塞	中大脳動脈塞栓症	胃癌検診
Ｓｏｔｏｓ症候群	ソトス症候群	精子異常
必要認知症	認知症	四肢脱力感
肝腫瘤性病変	肝腫瘤	環指切創
大動脈瘤解離	解離性大動脈瘤	老人性紫斑
挿入部出血	出血	上腕悪性末梢神経鞘腫
眠前発熱	発熱	腸管運動障害
肺炎反復	肺炎	胆泥
子宮内発育不全	子宮発育不全	項部硬直
左眼窩内腫瘤	眼窩腫瘤	ヘアリー細胞白血病
多発性腎梗塞	腎梗塞	鎌状赤血球症
多臓器不全状態	多臓器不全	下腿脂肪肉腫
再度痙攣発作	痙攣発作	小指ＭＰ関節橈側側副靱帯損傷
変動一過性徐脈	徐脈	肺の先天奇形
四肢色素沈着	皮膚色素沈着	手指こわばり
良性発作性頭位めまい	良性発作性頭位めまい症	開放性消化管血腫
三角圧痛	肩部筋痛	上腕部腫脹
両側声帯不全麻痺	声帯不全麻痺	環指ＰＩＰ関節側副靱帯断裂
舌痛	舌痛症	下顎セメント芽細胞腫
肺動脈弁下狭窄	肺動脈弁下狭窄症	習慣性顎関節亜脱臼
乳癌局所再発	乳癌	中縦隔腫瘍
頚椎症性神経根炎	頚椎症性神経根症	後頭蓋窩のう腫
痛みきつい	疼痛	腹壁挫傷
両側顎下腺腫大	顎下腺肥大	１型糖尿病性眼筋麻痺
中等度咽頭期嚥下障害	嚥下障害	循環性抗凝血因子症
ビタミンＤ不足	ビタミンＤ欠乏症	Ｐ４５０オキシドレダクターゼ欠損症
日中下痢便	下痢症	のう胞性腺増殖症
胸郭低形成	胸郭異常	自然分娩
肺スリガラス陰影	胸部異常陰影	乳房咬創
頻脈傾向変	頻脈症	睡眠時無呼吸症候群用口腔内装置不適合
口蓋腫瘤	腫瘤	レオパード症候群
パーキンソン病関連疾患	パーキンソン病	若年性ポリープ
グラム陰性桿菌菌血症	グラム陰性桿菌敗血症	粘液腫
右上肢腫脹	上肢腫脹	筋膿瘍
左肩甲骨部痛	肩甲骨痛	子宮腺筋症
開腹子宮筋腫核	子宮筋腫	緑膿菌性先天性肺炎
白内障手術	白内障	先天性扁平足
腫瘤残存	腫瘤	足関節偽痛風
直腸癌Ｒａ	直腸癌	性器下疳
カルボプラチンアレルギー	薬物過敏症	固定性歯科矯正装置不適合
肺原発ホジキンリンパ腫	ホジキンリンパ腫	新生児の脳易刺激性
循環障害	末梢循環障害	メタルリテーナー破損
原発性空腸癌	空腸癌	医原性副腎皮質機能低下症
右卵巣チョコレート嚢腫	チョコレートのう胞	閉経後症候群
重度精神運動発達遅滞	混合性特異的発達障害	舌切創
左腎梗塞	腎梗塞	慢性貧血
筋緊張高く	筋強直	悪性リンパ腫骨髄浸潤
母指潰瘍治癒遅延	皮膚潰瘍	脊椎形成異常
歩行時呼吸困難感	労作時呼吸困難	硬化性卵巣
滑液貯留	体液貯留	肩甲腓骨型脊髄性筋萎縮症
痰症状	喀痰	異所性灰白質
腸管血流障害	末梢循環障害	眼瞼挫創
発赤強い	発赤	胎向異常新生児
全身性単純ヘルペスウイルス感染症	ヘルペスウイルス感染症	骨髄肉芽腫
冠動脈高度石灰化	冠動脈石灰化	極低出産体重児
劇症型腸アメーバ症	腸アメーバ症	頭頂葉血管腫
慢性痛	慢性疼痛	びまん性汎細気管支炎
不適応行動	適応障害	上腕神経叢症候群
心室内血栓	心室内血栓症	円板状角膜炎
腹膜播種結節摘出	腹膜播種	房室接合部期外収縮
緑色痰	喀痰	後天性腎のう胞
冠動脈硬化	冠状動脈硬化症	大腿部第３度熱傷
右中葉肺癌	中葉肺癌	転移性頭蓋骨腫瘍
ポンプポケット内血腫	血腫	口腔粘膜のう胞
血管免疫芽球型Ｔ細胞リンパ腫	血管免疫芽球性Ｔ細胞リンパ腫	臍周囲炎
腹部緊満	腹部膨満	肺動脈血栓症
舌骨喉頭下垂	喉頭下垂症	プラスティックブラケット不適合
尿量低下	乏尿	楔状骨骨折
脳梗塞症	脳梗塞	ＸＸＸ症候群
左非浸潤性乳管癌	非浸潤性乳管癌	ゴム腫性フランベジア
むつかぶれ	おむつ皮膚炎	中脳水道先天異常
水平亜脱臼	亜脱臼	胸壁痛
右反復性膝蓋骨脱臼	反復性膝蓋骨脱臼	外陰開放創
早期癌	癌	膝皮膚欠損創
吻合部出血	出血	ＫＩＴ（ＣＤ１１７）陽性消化管間質腫瘍
子宮頸がん	子宮頚癌	斜骨折
腺扁平上皮癌	癌	血栓性静脈炎
喉頭蓋サルコイドーシス	サルコイドーシス	腹壁神経痛
結核性	結核	不育症
声門部狭窄	喉頭狭窄症	骨性斜頚
両側急性硬膜外血腫	急性硬膜外血腫	手指皮下血腫
高レニン高血圧	高レニン性高血圧症	骨形成不全症
頭蓋底髄膜腫	髄膜腫	ホルト・オラム症候群
右前胸部痛	前胸部痛	顔面皮膚上皮内癌
膵全体癌	膵癌	淋菌性咽頭炎
両側血気胸	血気胸	ガス自殺
穿刺部位出血	出血	主婦湿疹
手掌黄色腫	黄色腫症	手掌有棘細胞癌
皮膚湿疹	湿疹	裂溝性鼻
唾石	唾石症	非結核性抗酸菌性骨髄炎
非吻合部多発胆管狭窄	胆管狭窄症	腰仙部打撲傷
軽度肥満歴	肥満症	気管支痙攣
左腎嚢胞不変	腎のう胞	膵体尾部欠損
軽度発赤腫脹	発赤	無ベータリポ蛋白血症
左手関節変形	変形性手関節症	コクサッキーウイルス咽頭炎
蛋白尿（３＋）	蛋白尿	ＳＡＰＨＯ症候群
左手首痛	手部痛	陳旧性骨折
びまん性肺胞出血	肺胞出血	性交後出血
続発性赤芽球癆	赤芽球ろう	脛骨骨幹部骨折
インフルエンザ菌	インフルエンザ	人工膝関節周囲骨折
左舌区小細胞癌	小細胞肺癌	人工肩関節周囲骨折
左足背疼痛	足背痛	下顎口唇挫創
成人発症Ｓｔｉｌｌ病（ＡＯＳＤ）	成人スチル病	ビタミン過剰症
大球性正色素性貧血	正色素性貧血	前腕血管脂肪腫
双極Ⅱ型障害	２型双極性障害	パラインフルエンザウイルス気管支炎
限局型全身性強皮症	全身性強皮症	感冒性腸炎
右水晶体脱臼	水晶体脱臼	眼窩悪性腫瘍
心サルコイト゛ーシス	心サルコイドーシス	殿部筋肉痛
Ｓ状結腸高分化腺癌	Ｓ状結腸癌	腋窩腫脹
右側頬部腫脹	頬部腫脹	コレ・シカール症候群
右上背部痛	背部痛	足関節外果剥離骨折
両下肢痛み	疼痛	悪性症候群
多発海綿状血管腫	多発性海綿状血管腫	尿道球腺結核
結核歴	結核	不育症
ＳＭＡ浸潤	膵癌	混合型脳性麻痺症候群
微小癌	癌	フレームタイププロトラクター破損
慢性疼痛性障害	慢性疼痛	若年性ヘルペス状皮膚炎
高Ｃｌ血症	高クロール血症	脳毛細血管拡張症
乳頭状腺癌	癌	腰椎骨髄炎
帯状疱疹ウイルス脊髄炎	ウイルス脊髄炎	ミトコンドリア心筋症
内臓播種性ＶＺＶ感染症	汎発性帯状疱疹	羞明
様皮疹	発疹	腋窩圧挫傷
左帯状疱疹	帯状疱疹	脳皮質下出血
骨形成不全症Ⅲ型	骨形成不全症	後頭孔脳脱出症
高度肥満症	病的肥満症	先天性空腸狭窄症
右前頭葉脳内血腫	血腫	軟口蓋外傷
マルチミニコア病	マルチコア病	膀胱出血
四肢関節腫脹	関節炎	片側性唇・粘膜下口蓋裂
右腸骨静脈血栓症	腸骨静脈圧迫症候群	胎盤梗塞胎児
脳底動脈閉塞	脳底動脈閉塞症	胸部平滑筋肉腫
胸背部圧迫感	背部圧迫感	骨髄移植拒絶反応
眼瞼結膜軽度貧血	貧血	慢性裂肛瘢痕
子宮頸癌Ⅲｂ期	子宮頚癌	腸骨窩部痛
傍卵巣嚢胞	傍卵巣のう胞	臍帯圧迫
肝内腫瘤性病変	腫瘤	環指切創
血管性紫斑病	症候性紫斑病	痙性イレウス
時々右股関節痛	股関節痛	一側性顎関節突起形成不全
ＡＳＤ	心房中隔欠損症	乳糖不耐性下痢症
緑膿菌肺感染症	緑膿菌肺炎	精索炎
母子感染歴	母子感染	頭部皮下異物
ふらつきあり転倒リスク高い	めまい	閉じこめ症候群
頸腕症候群	頚肩腕症候群	腟狭窄症
食道癌術後リンパ節転移	リンパ節転移	細動脈硬化性萎縮腎
亜急性期小脳梗塞	小脳梗塞	メイ・ヘグリン症候群
喘息コントロール	咳喘息	鼻漏
右膝違和感	全身違和感	アルコール性コルサコフ症候群
腓骨神経麻痺徴候	腓骨神経麻痺	汎発性頑癬
中高分化型腺癌	癌	体表面積２０−２９％の腐蝕
軽度脳梗塞	脳梗塞	喉頭蓋裂
身体外傷	外傷	心筋変性症
心源性塞栓症	心原性脳塞栓症	大腿軟性線維腫
左上腕骨近位端骨折	上腕骨近位端骨折	血小板減少症
神経根性痛	疼痛	びらん性膀胱炎
白色壊死組織付着	壊死	鉤頭虫症
夜間中途覚醒	睡眠障害	エリスロポエチン産生腫瘍
軽度肺動脈弁狭窄	肺動脈弁狭窄症	習慣性顎関節亜脱臼
転移性肝癌術後再発	転移性肝癌	示指悪性黒色腫
無涙症	涙液分泌不全	オトガイ神経麻痺
劇症Ａ型肝炎	Ａ型劇症肝炎	結膜のうアルカリ化学熱傷
ｃｒｉｔｉｃａｌ　ｉｌｌｎｅｓｓ　ｐｏｌｙｎｅｕｒｏｐａｔｈｙ	多発ニューロパチー	ビタミン過剰症
右眼増殖性糖尿病網膜症	増殖性糖尿病性網膜症	妊娠性葉酸欠乏性貧血
右上腕腫脹	上腕部腫脹	体位性失神
右側胸水貯留	胸水貯留	腹部停留精巣
水疱瘡	水疱症	前腕母斑
軽度高Ｋ血症	高カリウム血症	肥大型心筋症
肝性脳症再発	肝性脳症	喉頭ジストニア
水様便流出	下痢症	オクルーザルスプリント破損
二絨毛膜二羊膜性双胎第	二絨毛膜二羊膜性双胎	深指屈筋腱断裂
浮腫傾向	浮腫	大腿部脂肪肉腫
骨Ｐａｇｅｔ病	骨パジェット病	大腸ＭＡＬＴリンパ腫
Ｅｎｔａｍｏｅｂａ　ｈｉｓｔｏｌｙｔｉｃａ	アメーバ赤痢	ビタミン過剰症
左頚部内頸動脈狭窄	内頚動脈狭窄症	ネザートン症候群
大腿筋横紋筋肉腫	横紋筋肉腫	鞍結節部悪性髄膜腫
腸炎性関節炎	関節炎	高アミラーゼ血症
ＰＭＳ	月経前症候群	手骨開放骨折
腓腹部圧痛	腹部圧痛	関節型若年性特発性関節炎
非チフス性Ｓａｌｍｏｎｅｌｌａ菌血症	菌血症	弛緩性片麻痺
微小多発肝膿瘍	肝膿瘍	尿管炎
卵管狭窄	卵管狭窄症	１１β−水酸化酵素欠損症
胸部大動脈解離	急性大動脈解離	光線黄斑症
蜂窩織炎発症	蜂窩織炎	原発性希発月経
輪状披裂関節炎	関節炎	前期破水による羊水過少症
左下肢蜂窩織炎	下肢蜂巣炎	正中唇裂
肺塞栓	肺塞栓症	総指伸筋腱脱臼
咽頭残留	嚥下障害	眼球破裂
低髄圧症状	低髄液圧症	歯肉退縮
左腓骨開放骨折	腓骨開放骨折	環椎後頭関節捻挫
大量水様下痢	下痢症	のう胞性腺増殖症
処方右乳癌	乳癌	外耳道ボーエン病
症候性けいれん	症候性てんかん	腹腔内遊離体
低血糖回避	低血糖	アレルギー性関節炎
左慢性閉塞隅角緑内障	慢性閉塞隅角緑内障	腸骨部膿瘍
弧発性古典的ＣＪＤ	孤発性クロイツフェルト・ヤコブ病	乳糖不耐性下痢症
呼吸機能低下	呼吸機能検査異常	膀胱頚部硬化症
右大腿リンパ節転移	リンパ節転移	黄疸
左第３趾潰瘍	趾皮膚潰瘍	内頚動脈瘤
足変形	足部変形	流産熱
膝関節水腫	膝関節水症	母指咬創
腹部瘢痕ヘルニア	腹壁瘢痕ヘルニア	巨大尿管
月経困難	月経困難症	脳挫傷・頭蓋内に達する開放創合併あり
左局所進行乳癌	進行乳癌	外耳道ボーエン病
好酸球性胆嚢炎	胆のう炎	結腸神経内分泌腫瘍
左下腿骨幹部骨折	骨折	尋常性ざ瘡
即時型アレルギー	アレルギー	多発梗塞性認知症
ふらつき有	めまい	口腔粘膜結核
ループス腎炎Ｖ型	ループス腎炎	活動過剰
閉塞性睡眠時無呼吸症侯群	睡眠時無呼吸症候群	連鎖球菌性髄膜炎
右下肢しびれ	下肢しびれ	耳介挫滅創
頭部脂漏性皮膚炎	脂漏性皮膚炎	重症便秘症
結核性ブドウ膜炎	結核性ぶどう膜炎	先天性腓骨弯曲
左真珠腫性中耳炎再発	真珠腫性中耳炎	手指偽関節
傍大動脈ＬＮ転移	大動脈周囲リンパ節転移	斑状皮疹
痙直型四肢麻痺	四肢麻痺	腸管癒着
角化性紅斑散在	紅斑症	急性小脳性失調症
労作時呼吸苦自覚	労作時呼吸困難	ＭＰ関節痛
慢性腎炎	慢性腎炎症候群	尿毒症性心膜炎
間質性肺炎像	間質性肺炎	連結冠過高
嘔気様	嘔気	網膜膠腫
左側頭葉皮質化出血	出血	外傷性滑車神経損傷
左上腕骨開放骨折	上腕骨開放骨折	側腹部第１度熱傷
腹部膨満継続	腹部膨満	肺動脈血栓症
右足底腱膜炎	足底筋膜炎	棘刺創
両側顎関節症	顎関節症	純型肺動脈閉鎖
出血性黄体	出血性黄体のう胞	弛緩性神経因性膀胱
右鼡径部疼痛	鼡径部痛	顔面掻創
高～中分化型管状腺癌	癌	体表面積２０−２９％の腐蝕
Ｌａｍｉｖｕｄｉｎｅ耐性Ｂ型肝硬変	Ｂ型肝硬変	晩期梅毒
遺伝性腎炎	家族性腎炎	家族性地中海熱
湿疹化	湿疹	多発性腹腔内臓器損傷・腹腔に達する開放創合併なし
左大腿部蜂窩織炎	大腿部蜂巣炎	口唇粘液のう胞
下肢対麻痺	対麻痺	頚椎捻挫
成長発達遅滞	発達遅滞	ピロプラスム症
下腿点状出血	点状出血	主婦湿疹
脈管奇形	奇形	正常眼圧緑内障
手指欠損	手指欠損症	門脈損傷
咽頭粘膜軽度発赤	咽頭発赤	足底多汗症
可動時痛	疼痛	肛門管炎
下垂手	垂れ手	卵巣明細胞腺癌
左陰嚢内容腫大	陰のう腫大	腰仙部血管脂肪腫
痰がからみ	喀痰	空隙歯列弓
朝出血	出血	顎関節部裂創
右鼠経ヘルニア修復術	鼡径ヘルニア	白点状眼底
ステロイド骨粗鬆症	ステロイド性骨粗鬆症	陰茎陰のう浮腫
足趾冷感	下肢冷感	予防接種後敗血症
不整腫瘤	腫瘤	足関節偽痛風
腎前性脱水	脱水症	遷延性心内膜炎
左肩部痛	肩部痛	脛骨前筋症候群
頸部皮下膿瘍	皮膚膿瘍	加齢黄斑変性
ウイルス性感冒	感冒	卵巣腫瘍破裂
多発腫大リンパ節	リンパ節腫大	リンパ球性下垂体炎
腹部自発痛	腹痛症	足関節内骨折
中分化型前立腺癌	前立腺癌	体表面積２０−２９％の腐蝕
左一側性形成不全性股関節症	一側性形成不全性股関節症	股関節痛
好酸球性気道炎症	好酸球性気管支炎	急性尿細管壊死
腸管蠕動障害	腸管運動障害	眼瞼挫創
褥瘡形成リスク高い	褥瘡	直腸良性腫瘍
腰椎変性辷り症	腰椎変性すべり症	輪状披裂関節捻挫
手術高血圧	高血圧症	喉頭痛
嚥下下困難	嚥下障害	慢性血行性脛骨骨髄炎
てんかん脳波	異常脳波	接触性眼瞼結膜炎
巨大血腫	血腫	エンテロウイルス腸炎
十二指腸原発神経内分泌腫瘍	十二指腸神経内分泌腫瘍	多発性外傷
腹水多量貯留	腹水症	腹部停留精巣
内腸骨リンパ節転移	腸骨リンパ節転移	コンポジットレジン脱離
ＣＭＶ胃腸炎	サイトメガロウイルス腸炎	ばち指
瘢痕痙性	瘢痕	脊髄性小児麻痺
両Ｔ字杖歩行	歩行障害	母指剥皮創
便性状変化	便異常	多発性筋炎
右血栓閉塞	血栓塞栓症	急性リンパ性髄膜炎
出血付着程度	出血	主婦湿疹
右海綿静脈洞髄膜腫	髄膜腫	乳腺腫瘤
虚血性心疾患合併	虚血性心疾患	バーキット白血病
壊死性筋炎	筋炎	母趾基節骨開放骨折
全肺腫瘍	肺腫瘍	ＣＡ１９−９高値
軽度構音障害	構音障害	前腕表在損傷
両下腿紅斑	紅斑症	耳介部腫瘍
低Ｃａ血症	低カルシウム血症	更年期神経症
二次性副腎不全	副腎クリーゼ	遺残性頚動脈脳底動脈吻合
一週間程度眠気	非器質性過眠症	線維性骨炎
子宮内腔癒着	子宮内膜症	脊椎披裂症
項部硬直軽度	項部硬直	外傷性脳動脈瘤
下熱	発熱	腸管運動障害
右母指陳旧性尺側側副靱帯損傷	靱帯損傷	一側性先天性股関節亜脱臼
左気管支狭窄	気管支狭窄症	開放性多発性骨盤内臓器損傷
皮膚型ＰＮ	結節性多発動脈炎	悪性小脳腫瘍
肺線維化	肺線維症	乳児ボツリヌス症
副鼻腔軽度粘膜肥厚	副鼻腔炎	膝蓋骨脱臼
味覚異常Ｇｒ１	味覚異常	環椎後頭骨癒合
中心視野欠損	視野欠損	うっ血性鼻炎
昨晩低血糖	低血糖	死体腎移植後
両水腎症	両側水腎症	閉鎖性外傷性脳室内出血
前回貧血	貧血	環指中節骨骨端線損傷
骨粗鬆症性圧迫骨折	骨粗鬆症・病的骨折あり	腹部第３度熱傷
右肺原発肺腺癌	肺腺癌	精索脂肪腫
脊髄原発悪性リンパ腫	悪性リンパ腫	頚部リンパ節炎
手指浮腫	浮腫	外耳道癌
口内炎再発	口内炎	橈骨遠位端骨折
皮質性認知症	皮質下認知症	殿筋炎
足背発赤	発赤	胎向異常新生児
後縦隔腫瘤	縦隔腫瘍	間欠性跛行
頚椎症性脊椎症	脊椎症	ＩＣＵ症候群
中部延髄右外側脳梗塞	脳梗塞	感染性口内炎
仙骨部瘻孔	難治性瘻孔	胃底部癌
軽鎖沈着症	単クローン性軽鎖重鎖沈着症	手部基底細胞癌
右傍気管リンパ節転移	リンパ節転移	口腔内血腫
ｓｍａｌｌ　ｃｅｌｌ　ｃａｒｃｉｎｏｍａ	癌	ビタミン過剰症
遺伝性出血性毛細血管拡張症	オスラー病	２型糖尿病性腎症第３期
胸椎後縦靭帯骨化症	胸椎後縦靱帯骨化症	葉間胸水
重症敗血症性ショック	敗血症性ショック	十二指腸ポリープ
間質性肺炎評価	間質性肺炎	ＫＲＡＳ遺伝子野生型直腸癌
右腎損傷	腎損傷	出血傾向
右肺門部原発	原発性肺癌	乳房咬創
再発食道癌	食道癌	反復性耳下腺炎
不定愁訴多い	不定愁訴症	包皮切創
発熱再燃	発熱	腸管運動障害
左肩関節痛	肩関節痛症	付加装置不適合
瘢痕様変化	瘢痕	接触性口内炎
元々頻尿	頻尿症	子宮腫瘍
浮腫対策	浮腫	大腿部脂肪肉腫
核下性顔面神経麻痺	顔面神経麻痺	脳幹神経膠腫
皮膚原発悪性リンパ腫	悪性リンパ腫	分娩における喉頭痙攣
市中感染型ＭＲＳＡ	ＭＲＳＡ感染症	誇大妄想
左尿管結石	尿管結石症	心因性生理的機能低下
乾性咳嗽頻回	乾性咳	腓腹筋痛
首痛	頚部痛	ピーナッツアレルギー
右側頭部紫斑	紫斑病	腸潰瘍
薬剤過敏性症候群	薬物過敏症	眼部開放創
延長症候群	ＱＴ延長症候群	上腕単独欠損
紫斑形成軽度	紫斑病	瓜実条虫症
両側肺動脈狭窄症	肺動脈狭窄症	特発性下垂体機能低下症
子宮筋腫核出後妊娠	妊娠	急性漿液ムチン性中耳炎
ＡＲＤＳ合併	急性呼吸窮迫症候群	乳糖不耐性下痢症
胆道系閉塞	胆道閉塞	小リンパ球性リンパ腫
軟骨損傷	肋軟骨損傷	ショパール関節炎
右副腎原発	副腎腫瘍	開放性胸管損傷
ｋｌｅｂｓｉｅｌｌａ　ｐｎｅｕｍｏｎｉａｅ感染症	クレブシェラ属感染	高リン血症
パ−キンソン症候群	パーキンソン症候群	化膿性関節炎・肩関節
右原発性肺癌	原発性肺癌	匙状爪
敗血症性ショック状態	敗血症性ショック	十二指腸ポリープ
時々発疹	発疹	心臓型総肺静脈還流異常症
めまい軽度	めまい	微熱
右横隔膜筋欠損	筋欠損	脳挫創・頭蓋内に達する開放創合併なし
脳症後遺症	脳症	足底部腫脹
胸膜悪性中皮腫	悪性胸膜中皮腫	心膜腔のう胞
漿膜損傷	損傷	双胎妊娠
頸椎症性	頚椎症	陰茎脂肪腫
多発外傷	多発性外傷	椎骨動脈閉塞症
皮膚損傷起	皮膚損傷	多趾切断
ふらつき目立	めまい	連結冠不適合
近位筋痛	筋肉痛	肘頭骨折
採血上脱水	脱水症	脛骨腓骨骨折
脳血管芽腫	小脳血管芽腫	外転神経麻痺
右慢性中耳炎	慢性中耳炎	多指切断
アレルギー様	アレルギー	多発梗塞性認知症
ノカルジア脳膿瘍	ノカルジア症	口唇刺創
大腸ポリープ有	大腸ポリープ	全子宮内反症
右後頭部帯状疱疹	後頭部帯状疱疹	動眼神経不全麻痺
右頚部結核性リンパ節炎	結核性リンパ節炎	頭部皮下血腫
陳旧性多発アテローム血栓性脳梗塞	陳旧性アテローム血栓性脳梗塞	先天性限局白皮症
誤嚥徴候	異物誤嚥	第ＶＩＩ因子欠乏症
右前腕皮疹	発疹	腱性マレット指
多発肺腫瘤	肺腫瘤	１型糖尿病性骨症
後腹膜浸潤	後腹膜悪性腫瘍	大腿骨遠位骨端線離開
網状紫斑	紫斑病	レッシュ・ナイハン症候群
胚細胞腫瘍	腫瘍	全身性多汗症
ゲノタイプ１ｂ型Ｃ型肝硬変	Ｃ型肝硬変	舌裂
類円形腫大	リンパ節腫大	中指基節骨開放骨折
中枢性気管支拡張像	気管支拡張症	足立方骨剥離骨折
小股歩行	歩行異常	サイトメガロウイルス脳炎
脳血管傷害	脳血管障害	高位鉗子分娩
糖尿病末梢神経障害	糖尿病性単ニューロパチー	Ｘ連鎖リンパ増殖症候群
ルンバール後頭痛	腰椎穿刺後頭痛	母指母斑細胞母斑
急性重症Ｂ型肝炎	Ｂ型肝炎	心膜石灰化
下垂時疼痛	疼痛	びまん性汎細気管支炎
頚部蜂窩織炎	頚部蜂巣炎	原発性希発月経
腹満不変	腹部膨満	消化管出血
一過性心筋虚血	心筋虚血	ビタミンＡ欠乏性結膜乾燥症
日勤帯発熱	発熱	パラタルバー破損
結核性喉頭狭窄	喉頭狭窄症	鎖骨下動脈閉塞症
両側鼻内ポリープ	鼻茸	発達性計算障害
手掌潮紅	紅潮	耳介部腫瘍
低血糖歴何年	低血糖	眼瞼脂肪腫
離床時眩暈	めまい	ＨＴＬＶ−１感染症
高齢者Ｃ型慢性肝炎	Ｃ型慢性肝炎	一酸化炭素中毒による遅発性脳症
ＳＬＥ発症	全身性エリテマトーデス	手骨開放骨折
軽度咽頭違和感	咽頭異常感症	新生児心不全
体熱感	不明熱	真菌感染母体より出生した児
悪性腫瘍評価	悪性腫瘍	大腿骨骨肉腫
発赤領域	発赤	胎向異常新生児
閉塞性大腸癌	大腸癌	ブリッジ不適合
子宮頚部ポリープ	子宮頚管ポリープ	悪性高血圧症
両側大腰筋血腫	血腫	肥厚性皮膚骨膜症
ＰＳＬＮ転移	大動脈周囲リンパ節転移	手骨開放骨折
咽頭部疼痛	咽頭痛	真菌症性筋炎
肺腫瘍塞栓症	肺腫瘍	総指伸筋腱脱臼
羊水過多	羊水過多症	先天性前頭変形
筋肉痛症状	筋肉痛	退行期うつ病
心外膜石灰化	心膜石灰化	側頚瘻
右下肢急性動脈閉塞症	下肢急性動脈閉塞症	カシン・ベック病
４型進行胃癌	胃進行癌	点状角化症
圧迫性脊髄症	脊髄症	姿勢性脊柱側弯症
出血源不明	出血	術後甲状腺機能低下症
貧血性網膜症	貧血網膜症	カリウム代謝異常
椎間板突出	椎間板症	肝性昏睡
カルチノイド腫瘍	カルチノイド	頬粘膜上皮内癌
心臓内腫瘤	腫瘤	冠動脈バイパス術後
日中気分不快	悪心	結核性中耳炎
多発性嚢胞肝	多発性肝のう胞	恥骨骨炎
仙骨奇形	仙骨部奇形	舌下神経障害
けいれん再発	痙攣	涙点欠損症
遊走性静脈炎	遊走性血栓性静脈炎	手指捻挫
左胸膜炎	胸膜炎	移植性虹彩のう胞
直腸癌術後異時性肝転移	転移性肝癌	示指悪性黒色腫
手指痺れ	しびれ感	冠攣縮性狭心症
左卵管水腫	卵管留水症	仙骨尾骨異常
歩行時呼吸困難	労作時呼吸困難	硬化性卵巣
ガーゼ出血	出血	胃アミロイドーシス
老人性紅皮症	紅皮症	股関節脱臼後遺症
右被殻脳梗塞	被殻出血	喉頭蓋裂
自律神経ニューロパチー	自律神経性ニューロパチー	角化棘細胞腫
子宮頚部嚢胞	子宮頚部腫瘍	大腿骨骨幹部骨腫瘍
右原発閉塞隅角緑内障	原発閉塞隅角緑内障	中毒性単結節性甲状腺腫
腺腫内癌	癌	足根骨開放骨折
両下肢浮腫軽度	下肢浮腫	易怒性
右化膿性肩関節炎	化膿性関節炎・肩関節	医薬品中毒後遺症
膣転移	腟癌	大腿骨遠位骨端線離開
体力低下著明	体力低下	発音補助装置不適合
左小脳陳旧性梗塞	陳旧性脳梗塞	急性鼓膜炎
淡黄色粘稠痰	喀痰	後天性腎のう胞
外傷所見	外傷	心筋変性症
発赤局面	発赤	胎向異常新生児
膀胱癌既往	膀胱癌	手舟状骨不顕性骨折
左末梢性肺動脈狭窄	肺動脈狭窄症	顔面有棘細胞癌
骨代謝異常	代謝障害	空腸狭窄
心陰影拡大	胸部異常陰影	興奮型痴愚
腎動脈下腹部大動脈瘤	腹部大動脈瘤	発作性心房細動
腸管壁内気腫	皮下気腫	再発翼状片
慢性活動性ＥＢＶ感染症	ＥＢウイルス感染症	調節性眼精疲労
足関節圧痛	関節痛	アダイア・ダイトン症候群
夕方発熱	発熱	腸管運動障害
顔面紅班	紅斑症	結腸間葉系腫瘍
排便痛	排便障害	インフルエンザ性喉頭炎
左水腎	水腎症	小結節性肝硬変
代謝異常	代謝障害	慢性顎骨炎
両下肢リンハ゜浮腫	下肢リンパ浮腫	涙小管のう胞
左頸部ＬＮ腫脹	肘リンパ節腫脹	手関節掌側ガングリオン
肺門部リンパ節腫脹	リンパ節腫大	高血圧性脳症
呼吸困難感軽度	呼吸麻痺	硬化性卵巣
左膝窩動脈血栓症	動脈血栓症	自己免疫性溶血性貧血
左股関節脱臼	股関節脱臼	軽度知的障害・要治療の行動機能障害あり
ルーフ゜ス腎炎	ループス腎炎	活動過剰
鼠径部腫脹	鼡径部腫脹	予防接種後感染症
内鼠径ヘルニア	内鼡径ヘルニア	肺出血
左頬部血管腫	頬部血管腫	アルコール性遅発性パーソナリティ障害
開口制限	開口不全	乳糖不耐症
変形性関節炎	変形性関節症	汎発性ヘルペス
初回歩行時ふらつき	よろめき歩行	慢性片頭痛
洞性頻脈	洞頻脈	うつ病
腹膜播種巣	腹膜播種	房室接合部期外収縮
アレルギ—性結膜炎	アレルギー性結膜炎	緩徐進行１型糖尿病・神経学的合併症あり
鼠径部血腫	血腫	正中神経麻痺
暗赤色嘔吐	嘔吐症	つる状血管腫
直腸癌ＯＰ	直腸癌	アデノイド扁桃炎
左増殖性糖尿病網膜症	糖尿病網膜症	妊娠性葉酸欠乏性貧血
レム睡眠行動異常	異常行動	胸部下部食道癌
左大腿有棘細胞癌	大腿有棘細胞癌	完全脱毛症
声帯癌	声門癌	卵形マラリア
左大腿部疼痛	大腿痛	肩部筋痛
右顎関節症	顎関節症	純型肺動脈閉鎖
骨頭壊死	骨壊死	環指腱鞘巨細胞腫
中枢神経浸潤	中枢神経系損傷	慢性腎臓病ステージＧ１
直腸皮下瘻孔	難治性瘻孔	硬膜下肉芽腫
胆嚢腫大	胆のう肥大	手外傷後変形治癒
Ｈｅｅｒｆｏｒｄｔ症候群	ぶどう膜耳下腺熱	糖尿病性アシドーシス
前立腺癌既往	前立腺癌	陳旧性肺結核
ダグラス窩腹水	腹水症	絞扼性ニューロパチー
失見当障害	見当識障害	混合性嗅覚障害
ツツガムシ感染症	つつが虫病	母指球筋萎縮
特発性血小板減少症紫斑病	特発性血小板減少性紫斑病	顔面膿瘍
前立腺浮腫	浮腫	示指側副靱帯断裂
胞性腫瘤	腫瘤	大腿部外傷性骨化性筋炎
右鼠径リンパ節腫脹	鼡径部リンパ節腫脹	卵巣茎捻転
ＡＡＡ破裂	腹部大動脈瘤	下腿皮膚癌
夜間覚醒	不眠症	外反中足
初発癌	癌	末梢神経炎
右迷走神経鞘腫	神経鞘腫	高水圧の作用
痙攣様	痙攣	側頭葉症候群
機会誤嚥	嚥下障害	第ＶＩＩ因子欠乏症
大腿静脈血栓	静脈血栓症	自己免疫性溶血性貧血
股関節部骨折	股関節骨折	器質性双極性障害
吸収不全症侯群	吸収不良症候群	小脳性歩行失調
新生血管緑内障	緑内障	Ｓ状結腸型ヒルシュスプルング病
甲状腺低下症	甲状腺機能低下症	帯状疱疹後膝神経節炎
アメーバ肝膿瘍	肝アメーバ症	喉頭麻痺
先天性真珠腫	真珠腫	脈絡膜良性腫瘍
頭部皮膚欠損	頭部皮膚欠損創	網膜色素沈着
右肺門部浸潤影	胸部異常陰影	前大脳動脈解離
食道悪性腫瘍	食道癌	腸瘻
傍大動脈リンパ節転移	大動脈周囲リンパ節転移	斑状皮疹
ビタミンＤ欠乏	ビタミンＤ欠乏症	Ｐ４５０オキシドレダクターゼ欠損症
レントゲン異常	胸部異常陰影	伝染性下痢症
器質的心疾患	心疾患	喉頭腫瘍
温痛覚	温痛覚過敏	気管支リンパ節転移
両側内反足	内反足	ＢＢ型ハンセン病
低酸素症状	低酸素性脳症	ネラトン症候群
粘稠痰少量	喀痰	空隙歯列弓
ダンベル型腫瘍	腫瘍	統合失調症型障害
催不整脈作用	不整脈	少関節型若年性関節炎・手関節
左腋窩汗腺癌	汗腺癌	胃胚細胞腫瘍
感染性仮性嚢胞	仮性膵のう胞	多中心性細網組織球症
乳房熱感	ほてり	非還納性腹壁瘢痕ヘルニア
大腸穿孔	腸穿孔	ビタミンＡ欠乏性角膜軟化症
腎瘢痕	瘢痕	結膜結核
孤立性左室緻密化障害	孤立性心筋緻密化障害	口唇外傷
進行性顔面片側萎縮症	顔面痙攣症	第１手根中手関節脱臼骨折・手根骨
左手関節痛	手関節痛	陳旧性骨折
右鼠径部腫脹	鼡径部腫脹	手関節掌側ガングリオン
びりびりしたしびれ	しびれ感	中脳水道先天異常
発赤軽減	発赤	胎向異常新生児
悪寒等	悪寒	高口蓋
非逆流性食道炎	食道炎	糖尿病性腎硬化症
甲状腺萎縮	後天性甲状腺萎縮	機能性嘔吐
呼吸苦自覚症状	呼吸困難	下肢脱力感
多発単神経障害	多発性単ニューロパチー	情動精神病
中毒性	中毒	多発性パラミオクローヌス
右肺上葉結節影	胸部異常陰影	前大脳動脈解離
骨膜肥厚	肥厚性皮膚骨膜症	アルコール性ペラグラ
リステリア感染症	リステリア症	スプルー
アルコール性脂肪性肝炎	アルコール性脂肪肝	鼻背部湿疹
脳室穿破	脳出血	乳び尿
鼠径部リンパ節腫大	鼡径部リンパ節腫脹	リンパ球性下垂体炎
吐気治	嘔気	化膿性口腔粘膜肉芽腫
右鼡径部リンパ節腫脹	鼡径部リンパ節腫脹	脳虚血症
多発肺塞栓	肺塞栓症	総指伸筋腱脱臼
右腋窩リンパ節転位	腋窩リンパ節転移	網膜色素上皮症
重度右片麻痺	片麻痺	開放性外傷性気胸
両側乳房腫瘤	乳房腫瘤	網膜異物
原発不明癌頸部リンパ節転移	頚部リンパ節転移	肺毛細血管腫症
後腹膜脂胞肉腫	後腹膜脂肪肉腫	尿管弁
胆管閉塞機転	胆管閉塞症	感染性喉頭気管炎
右下葉原発扁平上皮癌	下葉肺扁平上皮癌	急性冠症候群
腰椎圧迫骨折既往	腰椎圧迫骨折	先天性外陰奇形
便秘悪化	便秘症	二次性骨粗鬆症・病的骨折あり
潜血３	顕微鏡的血尿	オクルーザルスプリント破損
アレルギー性血管浮腫	浮腫	クッシング病
肺動脈分岐部狭窄	肺動脈分岐部狭窄症	板状硬結
顕微的血尿	血尿	甲状腺欠損
右鼡径リンパ節腫脹	鼡径部リンパ節腫脹	脳虚血症
左足多趾症	多趾症	脂肪肉腫
日中痛み	疼痛	肩甲部熱傷
不安感	不安障害	口腔ヘルペス
眼球運動痛	疼痛	肛門管炎
腰椎変性側弯症	腰椎側弯症	強膜異物
右腎低形成	低形成腎	人工妊娠中絶の不成功
Ｙｅｒｓｉｎｉａ　ｅｎｔｅｒｏｃｏｌｉｔｉｃａ感染症	エルシニア菌食中毒	根面板破損
膿胸合併肺放線菌症	肺放線菌症	舌低形成
チクチク痛む	チクチク感	複雑性合指症
左水尿管症	水尿管症	腹部単純性血管腫
多発肺内転移	転移性肺癌	胸部単純性血管腫
左下葉肺癌断端再発	下葉肺癌	特発性神経痛
右大腿部発赤	下腿発赤	左上大静脈遺残
右顔面打撲	顔面打撲傷	前腕骨折後変形骨癒合
糖尿病性自律神経障害	糖尿病性自律神経ニューロパチー	Ｘ連鎖リンパ増殖症候群
分破水	破水	ＷＰＷ症候群
重症マイコプラズマ肺炎	マイコプラズマ肺炎	多動性障害
卵巣嚢腫破裂	卵巣のう腫破裂	不応性貧血
抗原血症	サイトメガロウイルス感染症	肛囲腫瘍
褥瘡発症	褥瘡	新生児臍帯結節
甲状軟骨浸潤	甲状軟骨の悪性腫瘍	大腿隆起性皮膚線維肉腫
潜在性副腎皮質機能低下症	副腎皮質機能低下症	多発性リウマチ性関節炎
眼球陷凹	眼球陥没	植込型除細動器不全
両足趾潰瘍	趾皮膚潰瘍	腟上皮異形成
過換気症状	過換気症	口腔褥瘡性潰瘍
左鎖骨下リンパ節転移	リンパ節転移	結節性壊死性皮膚炎
上右卵管留血腫	卵管留血腫	回盲部癌
濾胞性リンパ腫再発	濾胞性リンパ腫	家族性部分性脂肪萎縮症
両眼糖尿病性網膜症	糖尿病網膜症	手指腱鞘炎
左外傷性大腿骨頭壊死	外傷性大腿骨頭壊死	腸チフス
肝臓病変	肝疾患	角膜擦過傷
右第１趾潰瘍	趾皮膚潰瘍	Ｂ群連鎖球菌肺炎
腋窩痛	腋窩部痛	椎間板変性症
踵部発赤	発赤	左上大静脈遺残
両側ぶどう膜炎	ぶどう膜炎	癒着胎盤・出血を伴わない
右アスペルギルス肺炎	肺アスペルギルス症	網膜良性腫瘍
痔疾患	痔核	頚髄神経根引き抜き損傷
無疱疹帯状疱疹	帯状疱疹	前頭頂骨進入
吐き気軽度	嘔気	つる状血管腫
非結核性抗酸菌性人工関節感染症	非結核性抗酸菌症	新生児吐血
両下肢不随意運動	不随意運動症	踵部悪性黒色腫
前胸痛	胸痛	縦隔甲状腺腫
洞結節不全症候群	洞不全症候群	前胸壁痛
結腸皮膚瘻	皮膚瘻	尿管膀胱移行部狭窄
患肢熱感	ほてり	予防接種後敗血症
両側腎膿瘍	腎膿瘍	乳腺腫瘍
右喉頭腫瘍	喉頭腫瘍	上腕骨ユーイング肉腫
潜血	顕微鏡的血尿	オクルーザルスプリント破損
細菌性脳動脈瘤破裂	脳動脈瘤破裂	コレステリン腫
右鼡径部皮下出血	皮下出血	角膜周囲充血
右下腿筋肉内出血	筋肉内血腫	乳房形成不全
痒感	そう痒	脳幹部海綿状血管腫
大動脈リンパ節転移	大動脈周囲リンパ節転移	斑状皮疹
心内血栓	心内血栓症	乳房微細石灰化
術後出血	後出血	老年性そう痒症
気分悪	悪心	成人Ｔ細胞白血病リンパ腫・慢性型
腰部脊椎管狭窄症	腰部脊柱管狭窄症	非感染性下痢
遠位弓部嚢状動脈瘤	動脈瘤	先天性肺動脈弁閉鎖不全症
左総腸骨動脈狭窄	総腸骨動脈狭窄	口唇挫傷
尿潜血遷延	顕微鏡的血尿	デンタルショック
夜間悪寒	悪寒	高口蓋
造骨性骨転移	骨転移癌	回腸憩室穿孔
腫瘍制御	腫瘍	急性肺性心
失調性構音障害	構音障害	詳細不明精神作用物質使用による急性精神・行動障害
右上腕骨頸部骨折	上腕骨頚部骨折	頻発月経
リンハ゜節腫大	リンパ節腫大	リンパ球性下垂体炎
皮疹拡大傾向	発疹	膝部血腫
依然浮腫	浮腫	大腿部脂肪肉腫
右足底部蜂窩織炎	足蜂巣炎	原発性希発月経
血栓閉塞型大動脈解離	早期血栓閉鎖型大動脈解離	毛様細胞性星細胞腫
急性期脳血管障害	脳血管障害	老人性皮膚萎縮症
朝方痰	喀痰	肉芽腫性鼻炎
進行性直腸癌	直腸癌	アデノイド扁桃炎
小腸型クローン病	小腸クローン病	非感染性急性外耳炎
軽度すりガラス影	胸部異常陰影	イズラン病
二次性血小板増多症	血小板増加症	出口鉗子分娩
胃膵嚢胞	膵のう胞	脳血管形成不全
最近浮腫	浮腫	脱毛症
右顔面疼痛	顔面痛	流行性多発関節炎
便失禁多量	便失禁	網膜静脈血栓症
労作時頻脈	頻脈症	植込型除細動器移植状態
両下肢結節性紅斑	結節性紅斑	ペースメーカ不全
重症胆管炎	胆管炎	肺動脈形成不全症
右側胸部痛	胸痛	頬部挫傷
右小指基節骨骨折	小指基節骨骨折	人工呼吸器関連肺炎
右足背腫脹	足背腫脹	カモガヤ花粉症
右上肢発赤	発赤	左上大静脈遺残
呂律のまわりにくさ	構音障害	多発性筋炎
アミオダロン誘発性甲状腺中毒症	薬剤性甲状腺機能障害	不機嫌
左胸部痛	胸痛	顔面皮膚上皮内癌
右大腿痛	大腿痛	蝶形骨悪性腫瘍
左下腿ＤＶＴ	下腿静脈血栓症	内転型痙攣性発声障害
動悸等症状	動悸	慢性子宮内膜炎
紫斑	紫斑病	瓜実条虫症
致死性不整脈出現	不整脈	流産後卵管卵巣炎
顆粒膜細胞腫	卵巣顆粒膜細胞腫	頭部湿疹
一瞬痛み	疼痛	腹壁挫傷
意識障害患者	意識障害	寄生虫性虹彩のう胞
切迫早産腹緊	切迫早産	前額部第２度熱傷
難治性皮膚非定型抗酸菌症	非結核性抗酸菌症	放射線咽頭炎
頚部鈍痛	鈍痛	殿部有棘細胞癌
発赤範囲	発赤	胎向異常新生児
左腕腫脹	前腕腫脹	処置後筋骨格障害
右肺上葉陰影	胸部異常陰影	前大脳動脈解離
右上葉肺結節	結節性肺結核	顔面挫滅創
空腹時高血糖	高血糖症	死体腎移植後
右麻痺	片麻痺	胃重複癌
味覚変化	味覚障害	小腸重積症
器質化肺炎	特発性器質化肺炎	外顆偽関節症
浮腫悪化	浮腫	アルコール性脂肪肝
凝固異常症	血液凝固異常	老年性振戦
右側頭葉脳梗塞	脳梗塞	喉頭蓋裂
両側下顎骨折	下顎骨骨折	１型糖尿病性腎症第２期
左頭頂葉神経膠腫	頭頂葉神経膠腫	ローレンス・ムーン症候群
骨盤内多発リンパ節転移	骨盤内リンパ節転移	腸管ベーチェット病
直腸閉塞	直腸閉鎖	耳後部膿瘍
運動ニューロン病	運動ニューロン疾患	結核性痔瘻
肺犬糸状虫症	犬糸状虫症	新生児臍帯巻絡
軽度骨棘	骨棘	胸鎖関節炎
疲労感少	疲労感	潜水夫麻痺
多発性肝腫瘤	肝腫瘍	環指切創
意味性錯語	文意失語症	創部膿瘍
ｃｏａｒｓｅ　ｃｒａｃｋｌｅｓ	湿性ラ音	中指マレット指
緑色下痢便	下痢症	のう胞性腺増殖症
皮膚損傷リスク	皮膚損傷	多趾切断
左母指痛	母指痛	銀杏中毒
ＡＶブロック	房室ブロック	混合型脳性麻痺症候群
前縦隔ＬＮ転移	縦隔リンパ節転移	反復思考
間質性肺炎発症	間質性肺炎	連結冠過高
外側脱臼	脱臼	部分癒着胎盤
右環指基節骨骨折	環指基節骨骨折	肘挫滅創
左殿部疼痛	殿部痛	脊髄麻痺
両側錐体路障害	錐体路障害	脳卒中後片麻痺
両足しびれ	下肢しびれ	露出リンパ球症候群
膜性増殖性	膜性増殖性糸球体腎炎	眼周囲部挫傷
頻脈性心房粗動	心房粗動	１８ｑ欠失症候群
下肢血流障害	下肢血行障害	横隔膜損傷
左肺上葉大細胞癌	上葉肺大細胞癌	腹腔内腫瘤
結核性肋膜炎	結核性胸膜炎	前十字靱帯付着部剥離骨折
疼痛有	疼痛	大転子骨折
実質外腫瘤	腫瘤	重度知的障害・行動機能障害の言及なし
骨盤部リンパ節転移	骨盤内リンパ節転移	腸管ベーチェット病
左三叉神経帯状疱疹	三叉神経帯状疱疹	歯の対称捻転
間質性肺炎悪化	間質性肺炎	連結冠過高
仙骨部骨折	仙骨骨折	細気管支拡張症
重症低体温症	低体温	中大脳動脈血栓症
関節炎悪化	関節炎	仙腸関節弛緩
右尖足	尖足	頚部転移性腺癌
両手指浮腫	浮腫	外耳道癌
左主気管支狭窄	気管支狭窄症	開放性多発性骨盤内臓器損傷
浸潤癌化	癌	反射性瞳孔強直
就寝後呼吸困難	呼吸困難	新生児筋無力症
仮性膵嚢胞	仮性膵のう胞	萎縮性声帯炎
右肺上葉癌	上葉肺癌	子宮損傷・骨盤腔に達する開放創合併なし
訪室時疼痛	疼痛	びまん性汎細気管支炎
膠原病様症状	膠原病	門脈圧亢進症
軽度黄染	黄疸	横行結腸憩室
転移性膵癌	膵癌	示指悪性黒色腫
除皮質硬直様	除皮質硬直	尺側手根屈筋腱損傷
間歇跛行	間欠性跛行	心炎
動脈瘤コイル塞栓術	動脈瘤	ファンコニ貧血
紅斑散在	紅斑症	急性小脳性失調症
右膝疼痛	膝関節痛	人工早産
食思不振傾向	食欲不振	１型糖尿病性皮膚障害
皮内腫瘍	腫瘍	腎欠損症
左前床突起部髄膜腫	髄膜腫	急性眼窩炎
右脳梗塞	脳梗塞	ＸＸＸ症候群
軽度腹部痛	腹痛症	頚部滑膜肉腫
多発毛細血管拡張	オスラー病	２型糖尿病性腎症第３期
不整脈誘発	不整脈	流産後卵管卵巣炎
左肺動脈ＰＥ	肺動脈血栓塞栓症	陰茎挫滅傷
胃潰瘍再発	胃潰瘍瘢痕	感冒性胃腸炎
境界域精神発達遅滞	知的障害	電解質平衡異常
胆石膵炎	胆石性膵炎	顔面蜂巣炎
右腕頭動脈瘤	腕頭動脈瘤	喘鳴
外陰部ｐａｇｅｔ癌	外陰部パジェット病	壊死潰瘍
リウマチ様症状	関節リウマチ	仙骨部奇形
肺癌性リンパ管症	癌性リンパ管症	新生児の脳易刺激性
左上腕骨顆部骨折	上腕骨顆部骨折	小腸型ヒルシュスプルング病
骨盤位妊娠	骨盤位	薬物性結膜炎
大腿骨骨折後	大腿骨骨折	壊死性腸炎
左椎間孔狭窄	結合組織性椎間孔狭窄症	軸椎横突起骨折
前立腺軽度腫大	前立腺肥大症	外傷性横隔膜ヘルニア
下顎腫脹	下顎部腫脹	初老期精神病
鼻中隔弯曲	鼻中隔弯曲症	持続性心室頻拍
大腸憩室症	多発性大腸憩室症	子宮腫瘤
逆流性食道炎無	逆流性食道炎	糖尿病性腎硬化症
致死性偽膜性腸炎	偽膜性腸炎	頭蓋内膿瘍
眼窩蜂窩織炎	眼窩蜂巣炎	早期先天梅毒性喉頭炎
排尿後痛	排尿痛	声帯結節症
右腹痛	腹痛症	下肢神経損傷
嚥下耳痛	耳痛症	インフルエンザ性喉頭炎
茶色出血	出血	主婦湿疹
左下葉扁平上皮癌	下葉肺扁平上皮癌	急性冠症候群
右腎梗塞	腎梗塞	慢性貧血
原発性ヘモクロマトーシス	ヘモクロマトーシス	処女膜強靱
右前頭葉膠芽腫	前頭葉膠芽腫	後天性脳動静脈瘻
急性水頭症	水頭症	悪性縦隔腫瘍
活動性肺結核所見	活動性肺結核	足舟状骨ケーラー病
右眼白内障	白内障	先天性のう胞性腺腫様形成異常
本日胸痛	胸痛	縦隔甲状腺腫
直腸膀膀胱窩	直腸膀胱瘻	多発性腹腔内臓器損傷
頚部結核性リンパ節炎	結核性リンパ節炎	頭部皮下血腫
左橈骨遠位骨折	橈骨遠位端骨折	横行結腸ポリープ
逆行性Ｐ波	心電図異常	趾神経損傷
しびれない	しびれ感	中脳水道先天異常
臀部圧痛	圧痛	母指球部痛
咽頭血腫	咽頭部血腫	鎖肛
膀胱癌再発	膀胱癌	手舟状骨不顕性骨折
多発皮下転移	皮下腫瘍	大腿骨遠位骨端線離開
両側肺動脈血栓塞栓症	肺動脈血栓塞栓症	急性歯髄炎
副鼻腔病変	副鼻	全身痙攣発作
安静時呼吸苦	呼吸困難	新生児筋無力症
左胸膜播種	胸膜播種	脛骨顆剥離骨折
陰嚢疼痛	陰のう痛	ステノトロフォモナス・マルトフィリア肺炎
上眼瞼腫脹	眼瞼浮腫	精のう腺発育不全
右下肢複雑骨折	開放骨折	腰椎椎体骨折
可動性良好腫瘤	腫瘤	大腿部外傷性骨化性筋炎
両頬部発赤	発赤	左上大静脈遺残
感染性肝嚢胞	肝のう胞	糖原病１ｂ型
左鼡径部腫脹	鼡径部腫脹	予防接種後感染症
突然呼吸困難	呼吸困難	硬化性卵巣
皮下出血斑	皮下出血	上下肢リンパ浮腫
右下腿骨髄炎	大腿骨骨髄炎	乳房擦過創
平行機能障害	平衡異常	心臓脂肪腫
元々杖歩行	歩行障害	母指剥皮創
両下肢腫脹	下肢腫脹	嗅神経腫瘍
左傍矢状洞髄膜腫	傍矢状洞髄膜腫	眼角有棘細胞癌
限局性皮膚硬化型全身性強皮症	全身性強皮症	血液ガス値異常
毎回失禁	尿失禁症	網膜静脈血栓症
右小脳腫瘍	小脳腫瘍	クレチン病
続発性サルコペニア	サルコペニア	解離性感覚障害
非医原性左尿管狭窄	尿管狭窄	橋中心髄鞘崩壊症
下腿血腫	血腫	鼻部開放創
逆流性膀胱炎	膀胱尿管逆流	核黄疸ＩＩＩ期
覚醒時疼痛	疼痛	モンドール病
左大転子部発赤	発赤	左上大静脈遺残
卵巣原発腫瘍	卵巣腫瘍	スフィンゴリピドーシス
リンパ腫再発	悪性リンパ腫	腰椎椎間板炎
重度運動障害性構音障害	構音障害	喉頭閉塞
右肩周囲炎	肩周囲炎	膀胱損傷
軽度動悸	動悸	慢性子宮内膜炎
左ポスナーシュロスマン症候群	ポスナーシュロスマン症候群	歯髄壊疽
液体貯留	体液貯留	肩甲腓骨型脊髄性筋萎縮症
低張性低ナトリウム血症	低ナトリウム血症	弓部大動脈瘤
癌性胸腹膜炎	癌性腹膜炎	回盲部腸重積症
心臓内腫瘍	心臓腫瘍	大腿神経損傷
左坐骨神経麻痺	坐骨神経麻痺	麻痺性眼瞼下垂症
リステリア髄膜脳炎	リステリア性髄膜脳炎	先天性上大静脈狭窄症
点圧痛	圧痛	上腕部腫脹
帯状疱疹ウイルス脳炎	帯状疱疹性脳炎	不顕性骨折
齲蝕	う蝕	肺腫瘤陰影
腎性急性腎障害	腎障害	老人性関節炎
喉頭嚢胞	喉頭のう胞	意義不明の単クローン性免疫グロブリン血症
甲状腺乳頭腺癌	甲状腺乳頭癌	腰椎骨髄炎
左上下肢しびれ	半身しびれ	耳介挫滅創
心筋傷害	心筋疾患	知的障害と常同運動に関連した過動性障害
圧迫性骨折	圧迫骨折	母指屈筋腱癒着
胆嚢胆石	胆泥	肝損傷
縱隔リンパ節転移	縦隔リンパ節転移	ＭＲＣＮＳ敗血症
悪性細胞	癌	胎児胸水
Ｌｉｓｔｅｒｉａ　ｍｏｎｏｃｙｔｏｇｅｎｅｓ敗血症	敗血症	術後低蛋白血症
パニック症侯群	パニック障害	高インスリン血症
アレルギー性肺アスペルギルス症	アレルギー性気管支肺アスペルギルス症	脳ヘルニア
左下肢原発性リンパ浮腫	リンパ浮腫	胆管癒着
呼気時喘鳴	喘鳴	円板状外側半月板
落ち着かない	多動性障害	有痛性拘縮
苦悶症状	胸内苦悶	腰部ボーエン病
トルーソー症候群	トルソー症候群	中毒性大腸炎
全身浮腫不変	全身性浮腫	手関節部裂創
左側頭円蓋部髄膜腫	円蓋部髄膜腫	抗痙攣薬副作用
周術期喘息発作	気管支喘息発作	上皮内癌
薬剤性副腎不全	副腎皮質機能低下症	遺残性頚動脈脳底動脈吻合
乳がん	乳癌	高トリグリセライド血症
巣状分節状糸球体硬化症	巣状糸球体硬化症	転移性脳腫瘍
口腔乾燥感	口腔乾燥症	膝蓋骨骨髄炎
右手関節尺側部痛	手関節痛	脂腺腫
右上顎洞真菌症	上顎洞炎	デスモイド
鮮血便	血便	殿部血管肉腫
心配症	心配	匐行性角膜潰瘍
アシドーシス進行	アシドーシス	大腿脂肪腫
右足滑液包炎	滑液包炎	角膜疾患
第５胸椎転移	胸椎転移	外痔びらん
表出性言語発達遅滞	言語発達遅滞	回腸憩室症
発作性心房細動既往	発作性心房細動	頭皮開放創
左リウマチ性膝関節症	関節リウマチ・膝関節	先天性外耳道狭窄症
左大腿部痛	大腿痛	肩部筋痛
隆起性病変	胃ポリープ症	歯根弯曲
腫瘤状構造	腫瘤	足関節偽痛風
細菌性赤痢感染症	赤痢	乳痂
多数骨折	骨折	開放性胸膜損傷
門脈右枝血栓	門脈血栓症	ウイルス性髄膜脳炎
３型進行癌	癌	上腕第３度熱傷
倦怠感等	倦怠感	後腹膜気腫
全頭脱毛症	脱毛症	骨の癒合障害
筋攣縮	筋痙縮	特発性基底核石灰化症
元々徐脈	徐脈	播種性結核
特発性側彎症	特発性側弯症	演技性パーソナリティ障害
回盲部放線菌症	放線菌症	大腿部第２度熱傷
ｆａｎ症候群	マルファン症候群	尿道内異物
脊椎椎間板炎	椎間板炎	剥離性食道炎
起始異常	冠動脈起始異常	上腕神経叢症候群
右眼球破裂	眼球破裂	下腿皮膚癌
介助　疼痛	疼痛	若年性ヘルペス状皮膚炎
前失神	失神	爪甲線状母斑
ふらつき感自覚	よろめき歩行	多発性骨盤内臓器損傷
低分化型肝細胞癌	肝細胞癌	子宮内膜腺様のう胞性増殖症
右葉間胸水	葉間胸水	分娩時軟産道損傷
子宮内膜症性卵巣嚢胞	卵巣子宮内膜症のう胞	軸椎骨折
腎嚢胞出血	傍腎盂のう胞	心臓移植拒絶反応
無症候性キャリア	ＨＴＬＶ−１キャリア	アミノ酸欠乏性貧血
中等度腹水	腹水症	収縮期雑音
受容体脳炎	抗ＮＭＤＡ受容体脳炎	上腕筋肉痛
肛門部軽度発赤	肛門部周囲炎	足底多汗症
側方リンパ節転移	リンパ節転移	チャンス骨折
左硝子体混濁	硝子体混濁	鼻下部ヘルペス
統合失調症既往	統合失調症	２型糖尿病性昏睡
平衡機能障害	平衡障害	アクチバトール不適合
肺腫瘤影	胸部異常陰影	ぶどう球菌性熱傷様皮膚症候群
複雑型異型子宮内膜増殖症	腺腫性子宮内膜増殖症	眼周囲部挫傷
皮膚潰瘍形成	皮膚潰瘍	距骨骨折
肝肥大	肝型糖原病	前立腺症
紅斑腫脹	紅斑症	中等症潰瘍性大腸炎
腰部圧痛	腰痛症	眼瞼挫傷
元々不眠症	不眠症	頚部挫傷後遺症
左肩甲骨軟骨肉腫	肩甲骨軟骨肉腫	カタル性胃腸炎
肺血症性ショック	敗血症性ショック	低血糖
凝固線溶系異常	血液凝固異常	Ｖ型歯列弓
異所性静脈瘤	静脈瘤	涙管断裂
腫瘍崩壊	腫瘍	多房性腎のう胞
破壊性甲状腺炎	甲状腺炎	膝蓋骨良性腫瘍
右腸骨ＬＮ転移	腸骨リンパ節転移	異物残留
右腎被膜下血腫	血腫	植物状態
全身性サルコイドーシス	サルコイドーシス	心筋梗塞
脱分化型脂肪肉腫	脂肪肉腫	腸骨動脈血栓症
非機能性下垂体腫瘍	下垂体腫瘍	頭部神経痛
ＡＣＴＨ分泌不全	ＡＣＴＨ分泌低下症	急性出血性白質脳炎
時々残尿感	残尿感	気道熱傷
小人症	低身長症	胃憩室症
右臼蓋転移	骨盤転移	大腿骨遠位骨端線離開
右頭頂葉脳梗塞	脳梗塞	喉頭蓋裂
マルファン症候群合併	マルファン症候群	膵膿瘍
右眼網膜症	網膜症	足底動脈損傷
咽喉頭炎	咽頭喉頭炎	体幹母斑
右下葉肺扁平上皮癌	下葉肺扁平上皮癌	片側性完全唇裂
足趾壊疽	趾壊死	精巣精巣上体炎
左肺尖部腺癌	肺腺癌	前骨間神経麻痺
潰瘍型間質性膀胱炎	間質性膀胱炎	小指切創
紅色皮疹	発疹	開面金属冠破損
遺尿	遺尿症	混合型白血病
頚管狭窄	子宮頚管狭窄症	銃創
右腎門部腹側脂肪肉腫	腎周囲脂肪肉腫	サティリアジス
左中頭蓋窩髄膜腫	中頭蓋窩髄膜腫	ホルト・オラム症候群
脳梗塞後後遺症	脳梗塞	急性潰瘍性大腸炎
含歯性嚢胞	含歯性のう胞	トルサードドポアント
紅斑熱	日本紅斑熱	手指刺創
多発頭蓋骨転移	骨転移癌	歯間離開
Ｄａｎｌｏｓ症候群	エーラス・ダンロス症候群	手背第２度熱傷
運動低下性構音障害	構音障害	喉頭閉塞
右重症下肢虚血	重症虚血肢	Ｂ細胞性非ホジキンリンパ腫
両側腸腰筋血腫	血腫	肝右葉腫瘍
亀頭部発赤	発赤	胎向異常新生児
肝嚢胞感染	肝のう胞	胃癌末期
重症強迫性障害	強迫性障害	粃糠疹
顔面骨圧痛	圧痛	紅色陰癬
左椎間板ヘルニア	椎間板ヘルニア	自律神経失調症
会陰部疼痛	外陰部痛	ステノトロフォモナス・マルトフィリア肺炎
咀嚼時痛	咀嚼筋痛障害	大静脈症候群
左膝関節偽痛風	膝関節偽痛風	腎障害
２次性副甲状腺機能亢進症	副甲状腺機能亢進症	非持続性心室頻拍
右上腕蜂窩織炎	上腕蜂巣炎	晩期梅毒性多発ニューロパチー
右前大脳動脈未破裂動脈瘤	前大脳動脈瘤	頭部多発割創
リウマチ性胸水	リウマチ性肺疾患	腹部停留精巣
右眼白内障手術	白内障	先天性扁平足
悪性リンハ゜腫	悪性リンパ腫	ウイルス性心筋炎
胆管腫瘍栓	胆管腫瘍	術後嚥下障害
右基底核梗塞	脳梗塞	尿中１７−ケトステロイド上昇
境界型耐糖能障害	耐糖能異常	顔面多発打撲傷
リウマチ疾患	関節リウマチ	錐体路障害
白内障Ｏ	白内障	先天性のう胞性腺腫様形成異常
心房細動停止	心房細動	耳の気圧性外傷
帯状疱疹既往	帯状疱疹	前頭頂骨進入
腫瘤所見	腫瘤	足関節偽痛風
ＶＨＬ病	フォンヒッペル・リンダウ病	手骨開放骨折
時折血痰	血痰	ポリオウイルス感染症
陰嚢部腫脹	陰のう腫大	口唇創傷
帰室時疲労感	疲労感	潜水夫麻痺
高分化型腺癌	癌	体表面積２０−２９％の腐蝕
糖尿病等	糖尿病	単一臍動脈
Ｍｙｃｏｂａｃｔｅｒｉｕｍ　ｓｈｉｇａｅｎｓｅ感染症	非結核性抗酸菌症	根面板破損
後腹膜腫瘍切除術	後腹膜腫瘍	非侵入全奇胎
肺転移発覚	転移性肺腫瘍	胸部単純性血管腫
右中咽頭癌	中咽頭癌	七日熱
両側肺動脈血栓塞栓	動脈血栓症	急性歯髄炎
臀部炎症性粉瘤	粉瘤	小児性皮質性骨増殖症
左耳耳鳴	耳鳴症	脊椎疾患
鼠経ヘルニア	鼡径ヘルニア	神経線維肉腫
鼻閉塞	鼻閉	冠静脈洞型心房中隔欠損症
疲労感等	疲労感	潜水夫麻痺
日中掻痒感	そう痒	脳幹部海綿状血管腫
前交通動脈未破裂脳動脈瘤	未破裂脳動脈瘤	頭部多発割創
夜間低酸素血症	低酸素血症	ネラトン症候群
薬剤性腎不全	薬剤性腎障害	遺残性頚動脈脳底動脈吻合
気管支狭窄	気管支狭窄症	開放性多発性骨盤内臓器損傷
腫瘍増悪	腫瘍	大腿骨骨肉腫
急性軸索障害	びまん性軸索損傷	軸性視神経炎
完全型ベーチェット病	ベーチェット病	小児片麻痺
筋肉痙攣	痙攣	風疹脳脊髄炎
癌性髄膜腫症	悪性髄膜腫	水晶体欠損
化膿性脊椎椎間板炎	化膿性椎間板炎	１型糖尿病性腎硬化症
呼吸性雑音	胸部音異常	鎖骨肩峰部骨折
真菌塊	真菌症	眉毛部割創
両肩関節圧痛	圧痛	付加装置不適合
多発肝細胞癌	肝腫瘍	子宮内膜腺様のう胞性増殖症
右腎小嚢胞	傍腎盂のう胞	結核性線維症
左横隔膜神経麻痺	横隔神経麻痺	びまん性脳損傷
右高度水腎症	水腎症	小結節性肝硬変
創傷治癒遅延	創傷	腹膜癒着
上腫瘍	腫瘍	圧迫骨折
進行性食道癌	食道癌	反復性耳下腺炎
複雑性熱性痙攣	熱性痙攣	仙椎神経根損傷
先天性鼻咽腔閉鎖不全症	先天性鼻咽腔閉鎖不全	エンドリーク
右眼鼻涙管閉塞症	鼻涙管閉鎖症	妊娠性乳腺炎
縦隔原発Ｂ細胞大細胞型リンパ腫	縦隔原発大細胞型Ｂ細胞性リンパ腫	ナイミーヘン染色体不安定症候群
左半視野障害	視野障害	未破裂内頚動脈解離
大腿骨近位部骨折	大腿骨骨折	壊死性腸炎
左踵部痛	踵痛	人工早産
ポリープ様隆起	ポリープ	交叉咬合
刺激性皮膚炎	皮膚炎	オロプーシェウイルス病
慢性緑膿菌感染	緑膿菌感染症	腰椎棘間靱帯損傷
回腸閉塞	回腸狭窄	ヘルペスウイルス性湿疹
尾部嚢胞	膵のう胞	下半身第１度熱傷
虫刺症	蜂刺症	眼リンパ節リステリア症
第二趾爪囲炎	爪囲炎	一過性菌血症
膵仮性嚢胞破裂	仮性膵のう胞	腰部皮膚癌
シェーンラインヘノッホ紫斑病	ＩｇＡ血管炎	２型糖尿病性腎不全
記銘障害	記銘力低下	開放性延髄損傷
上歯肉癌	上顎歯肉癌	ダイアストロフィー性骨異形成症
チャーグ－ストラウス症候群	好酸球性多発血管炎性肉芽腫症	ニコチン性口内炎
低ＡＴⅢ血症	アンチトロンビン欠乏症	眼窩うっ血
超皮質性感覚性失語	皮質下感覚性失語症	陳旧性鎖骨骨折
ＮＯＭＩ	腸壊死	悪性小脳腫瘍
肥厚性幽門狭窄	肥厚性幽門狭窄症	口唇炎
問題なし脊柱管狭窄症	脊柱管狭窄症	耳介開放創
左踵骨裂離骨折	踵骨骨折	弱視眼振
慢性糸球体炎	糸球体腎炎	高ＩｇＡ血症
左眼結膜下出血	結膜下出血	慢性裂肛瘢痕
子宮頸部上皮内腫瘍	子宮頚部上皮内腫瘍	大腿骨骨幹部骨腫瘍
左腰部有棘細胞癌	腰部有棘細胞癌	続発性副甲状腺機能亢進症
糖尿病罹患	糖尿病	単一臍動脈
四肢圧痛	圧痛	眼部皮下出血
関節変形	関節奇形	コクサッキーウイルス咽頭炎
気分変動	気分変調症	間質性膀胱炎
左鎖骨下動脈起始異常	鎖骨下動脈起始異常	軟骨低形成症
立位バランス練習重症筋無力症	重症筋無力症	乏尿
腰椎脊柱管狭窄	腰部脊柱管狭窄症	非感染性下痢
左上葉小細胞肺癌	上葉小細胞肺癌	リンパ腫様丘疹症
左後縦隔腫瘍	後縦隔腫瘍	顎堤異常吸収
食道カンジタ症合併ＨＩＶ感染症	ＨＩＶカンジダ病	調節性眼精疲労
固縮無動	こわばり	新生児遅発代謝性アシドーシス
小体認知症	認知症	遷延性昏睡
突然腹痛	腹痛症	脳卒中後てんかん
尿閉気味	尿閉	尿道漏
生検部感染徴候	創傷感染症	大腿剥皮創
痛風症状	痛風	耳下腺瘻
脳転移新出	転移性脳腫瘍	石灰化腱膜線維腫
両側肩関節痛	肩関節痛症	付加装置不適合
右眼下鼻側視野異常	視野障害	全身末梢神経症
右肺Ｓ４原発腺癌	肺腺癌	卵巣子宮内膜症
右肘関節骨折	肘関節骨折	ツベルクリン反応陰性化
両耳下腺腫脹	耳下腺腫脹	複合性局所疼痛症候群ＩＩ型
再下血	下血	脊髄空洞症
両変形性股関節症	変形性股関節症	気道腐蝕
喘息コントロール不良	咳喘息	鼻漏
腹部大動脈狭窄症	大腿動脈狭窄症	鼻炎
左肺良性腫瘍	肺良性腫瘍	慢性腎盂腎炎
頸動脈狭窄症	内頚動脈狭窄症	ネザートン症候群
若年結核性腹膜炎	結核性腹膜炎	大動脈石灰化症
発赤部分	発赤	胎向異常新生児
大腸疾患	腸疾患	腋窩湿疹
頚部血腫	頚部表在損傷	頭頂部切創
肺雑聴取	胸部音異常	血友病性出血
急性冠症候群発症	急性冠症候群	永久歯萌出不全に起因した咬合異常
皮下浮腫	浮腫	易怒性
低活動型せん妄	せん妄	鼻壊疽
左化膿性耳下腺炎	化膿性耳下腺炎	ナルコレプシー
痔核症状	痔核	鼻声
拘束性心筋症	拘束型心筋症	腰椎脊索腫
右内頸動脈血栓閉塞	動脈血栓症	橈骨手根靱帯断裂
肝うっ血	うっ血肝	鈍的心臓外傷・胸腔に達する開放創合併なし
ＣＮＩ腎症	薬剤性腎障害	上肢腫脹
浮腫軽減	浮腫	アルコール性脂肪肝
胃液様	嘔吐症	尿路障害
右鼡径部出血	出血	びまん性肺胞傷害
右肺上葉肺炎	肺炎	陰茎癌
膠原病外来	膠原病	門脈圧亢進症
門亢症	門脈圧亢進症	半身しびれ
在型食道癌	食道癌	反復性耳下腺炎
創内異物	外傷性異物	溶血性尿毒症症候群
膀胱内尿貯留	後腹膜尿貯留	重症妊娠高血圧症候群
肢痛	疼痛	殿部皮膚潰瘍
肺結核性腹膜炎	結核性腹膜炎	大動脈石灰化症
腸管内血腫	血腫	胸膜うっ血
ネフローゼ状態	ネフローゼ症候群	喉頭軟骨膜炎
軽度僧帽弁逆流症	僧帽弁逆流症	ストーマ粘膜皮膚侵入
前胸部粉瘤	粉瘤	小児性皮質性骨増殖症
左室中部閉塞性肥大型心筋症	閉塞性肥大型心筋症	巨視症
しびれがきつい	しびれ感	中脳水道先天異常
両側内耳奇形	内耳先天奇形	異所性精巣
完全右脚ブロック指摘	完全右脚ブロック	筋拘縮症
肛門部潰瘍	肛門潰瘍	舌扁桃肥大
臀部紅斑	紅斑症	耳介部腫瘍
アレルギ—性鼻炎	アレルギー性鼻炎	肘部皮膚良性腫瘍
末節骨骨折	骨折	結核腫
脊椎症性変化	脊椎症	出血性虹彩炎
腸閉塞気味	イレウス	耳後部膿瘍
浅呼吸	呼吸困難	外傷性脳内血腫・頭蓋内に達する開放創合併なし
無症候性狭心症	狭心症	四肢挫傷
右顎下リンパ節腫脹	顎下リンパ節腫脹	植物胃石
左側頭葉海綿状血管腫	側頭葉海綿状血管腫	閉鎖性膀胱損傷
直腸癌術後直腸癌	直腸癌	アデノイド扁桃炎
痛覚消失	異常知覚	単胞性肺エキノコックス症
膵炎再燃	膵炎	橈骨動脈損傷
肘頭部潰瘍	前腕皮膚潰瘍	子宮頚管内異物
反復性腸閉塞	イレウス	肺サルコイドーシス
胎児腹水	胎児水腫	異形吸虫症
失見当識障害	見当識障害	混合性嗅覚障害
皮膚ツルゴール低下	脱水症	巨舌症
右肩悪性軟部腫瘍	悪性軟部腫瘍	下口唇皮膚良性腫瘍
非定型うつ	非定型うつ病	２型糖尿病・糖尿病性合併症なし
右中指スワンネック変形肩関節	スワンネック変形	老人性円背
胸郭運動異常	胸郭異常	輪状膵
前頭蓋底腫瘍	頭蓋底腫瘍	眼窩骨膜炎
腹部肥満	肥満症	肺動脈血栓症
Ｓ状結腸粘膜下腫瘤	腫瘤	後天性毛包性角化症
両側下腿圧痕性浮腫	下腿浮腫	眼瞼第３度熱傷
動脈瘤様骨嚢腫	動脈瘤様骨のう腫	小脳挫傷・頭蓋内に達する開放創合併なし
軟性腫瘤	腫瘤	足関節偽痛風
本日疼痛	疼痛	大転子骨折
出血軽度	出血	肋軟骨部痛
軽度間歇性跛行	間欠性跛行	腸骨動脈塞栓症
蛋白血症	異常蛋白血症	上腕骨近位端開放性粉砕骨折
不眠時２錠	不眠症	多産婦
後縦隔膿瘍	縦隔膿瘍	胆のうカルチノイド
胸水排出	胸水貯留	寛解中の反復性うつ病性障害
ＡＩＤＳ非定型抗酸菌症	非結核性抗酸菌症	腸憩室炎
尺側神経麻痺	尺骨神経麻痺	エンテロウイルス髄膜炎
徐脈等	徐脈	播種性結核
てんかんの発作	てんかん	涙点欠損症
腹部大動脈石灰化	大動脈石灰化症	極低出産体重児
サルコイドーシス疑	サルコイドーシス	心筋梗塞
左片麻痺	片麻痺	膿痂疹
足部冷感	下肢冷感	予防接種後敗血症
下痢〜水様便	下痢症	先天性卵巣奇形
コレステロールポリープ	ポリープ	肝性脳症
１型糖尿除	糖尿	股関節部付着部症
関節固縮	関節拘縮	肋骨周囲炎
肺多型癌	癌	結核性軟膜炎
慢性アレルギ—性鼻炎	アレルギー性鼻炎	肘部皮膚良性腫瘍
下顎骨正中部骨折	下顎正中部骨折	１型糖尿病性腎症第２期
後嘔吐	嘔吐症	乳汁分泌抑制
気分不快出現	悪心	結核性中耳炎
劇症Ａ群溶連菌感染症	劇症型Ａ群連鎖球菌感染症	閉鎖性尿管損傷
内腸骨静脈血栓症	静脈血栓症	胎盤梗塞胎児
軽度咽頭期嚥下障害	嚥下障害	循環性抗凝血因子症
舌根扁桃炎	扁桃炎	大腿挫創
右肺上葉小細胞癌	上葉小細胞肺癌	腹腔内腫瘤
ＣＭＶ網膜症	サイトメガロウイルス網膜炎	心臓性失神
脊椎側弯症	脊柱側弯症	陳旧性骨結核
悪心Ｇ１	悪心	足関節後果骨折
上腹部鈍痛	上腹部痛	頚部滑膜肉腫
脊髄視神経炎	視神経炎	皮膚良性リンパ腺腫症
本日血尿	血尿	上部消化管出血
クラミジア頸管炎	クラミジア頚管炎	骨髄炎後遺症
性急性リンパ性白血病	急性リンパ性白血病	片側痛覚過敏
周囲リンパ節腫大	リンパ節腫大	リンパ球性下垂体炎
印環細胞癌	癌	粘膜下腫瘍
６月肝転移	転移性肝腫瘍	急性硬膜外血腫
左内頸動脈中等度狭窄	頚動脈硬化症	悪性高熱症
左外耳道閉鎖	外耳道閉鎖	陰のうびらん
右鼡径部ヘルニア	鼡径ヘルニア	薬剤性顆粒球減少症
ＭＬＦ症候群	核間性眼筋麻痺	尿道内異物
醜形恐怖	醜形恐怖症	下行結腸憩室炎
肩関節疼痛	肩関節痛症	ＡＣＴＨ産生腫瘍
右手痺れ	上肢しびれ	ビタミンＡ欠乏性夜盲
逆流感	胃食道逆流症	胎勢回旋異常
播種性クリプトコックス症	播種性クリプトコッカス症	尿毒症性心筋症
左尿管導管吻合部狭窄	吻合部狭窄	動揺足関節
口唇落屑	皮膚落屑	体液量減少症
時折不整	不整脈	外傷性多発性切断
僧帽弁狭窄症兼閉鎖不全症	僧帽弁狭窄症	小指側副靱帯損傷
伸筋腱脱臼	脱臼	歯冠周囲膿瘍
両下腿潰瘍	下腿皮膚潰瘍	唾液腺腫瘍
内転障害	眼球運動痙攣	環軸関節脱臼
びまん性リンパ腫	リンパ腫	腰椎椎間板炎
多発嚢胞腎	多発性のう胞腎	感染性腹部大動脈瘤
足首骨折	足関節骨折	アレルギー性膀胱炎
右目白内障	白内障	先天性のう胞性腺腫様形成異常
嘔吐１回	嘔吐症	乳汁分泌抑制
深夜低血糖	夜間低血糖症	死体腎移植後
過敏症状	過敏症	殿部青色母斑
高Ｂｉｌ血症	高ビリルビン血症	脳毛細血管拡張症
右足小指骨折	小指骨折	足切断
第一腰椎破裂骨折	腰椎破裂骨折	皮下神経腫
せん妄発言	せん妄	２型自己免疫性膵炎
ヒステリー症状	ヒステリー反応	頚椎先天異常
歩行時創部痛	術創部痛	重症再生不良性貧血
パニック	パニック障害	眼筋内異物
正色素性正球性貧血	正球性正色素性貧血	前腕血管脂肪腫
右足腫脹	足部腫脹	老人性舞踏病
両肺胸膜肥厚	胸膜肥厚	頚管破裂
ＡＰＳ	抗リン脂質抗体症候群	乳糖不耐性下痢症
脳圧亢進症状	頭蓋内圧亢進症	猫ひっかき病
眼鏡　近視	近視	胎便吸引症候群
二次性ヘモクロマトーシス	ヘモクロマトーシス	処女膜強靱
潜在性副甲状腺機能低下症	副甲状腺機能低下症	手部皮膚潰瘍
両眼瞼黄色腫	眼瞼黄色腫	情緒不安定性パーソナリティ障害
右内腸骨動脈狭窄	動脈狭窄	上口唇青色母斑
正中頚嚢胞	正中頚のう胞	下腿悪性線維性組織球腫
両側尿管結石	尿管結石症	心因性生理的機能低下
高血圧状態	高血圧症	脾損傷
喀血症状	喀血	網膜滲出斑
指発赤	発赤	胎向異常新生児
Ⅱａ型高脂血症	高脂血症	四肢末端痛
右手橈骨骨折	橈骨骨折	進行性多巣性白質脳症
右睾丸痛	精巣痛	顔面掻創
本日血便	血便	骨痛
回腸出血	腸出血	単極性躁病
左副腎出血	副腎出血	脈絡網膜熱傷
後頭蓋下髄膜腫	髄膜腫	屈指症
急性前壁中隔梗塞	急性前壁中隔心筋梗塞	脛骨線維性骨炎
右顔面部帯状疱疹	顔面帯状疱疹	超皮質性失語
びまん性管内増殖性糸球体腎炎	慢性びまん性管内増殖性糸球体腎炎	髄液結核菌陽性
傍腹部大動脈リンパ節腫大	リンパ節腫大	リンパ球性下垂体炎
左上腕脂肪腫	上腕脂肪腫	臍下部痛
尿道口発赤	発赤	上腕骨遠位端粉砕骨折
冠動脈狭窄症	冠状動脈狭窄症	電撃傷
膵石灰化	膵石灰化症	アペール症候群
丘疹様	丘疹	気管気管支虚脱
肺上葉原発性肺癌	原発性肺癌	子宮損傷・骨盤腔に達する開放創合併なし
労作時胸部不快	労作時呼吸困難	精巣蜂巣炎
２型＋ステロイド性糖尿病	ステロイド糖尿病	外傷性肝破裂・腹腔に達する開放創合併あり
腫瘤縮小	腫瘤	足関節偽痛風
Ｓａｌｍｏｎｅｌｌａ　ｅｎｔｅｒｉｔｉｄｉｓ敗血症	サルモネラ敗血症	肺動脈分岐部狭窄症
グル音異常	異常腸音	脛骨骨膜炎
鉄吸収障害	鉄欠乏症	中指痛
水中毒症状	水中毒	白色皮膚萎縮
鼻中隔彎曲	鼻中隔弯曲症	持続性心室頻拍
本日右眼白内障	白内障	徐脈性心房細動
過敏性腸症侯群	過敏性腸症候群	結核性女性骨盤炎症性疾患
会話性幻聴	幻聴	毛包母斑
筋疲労感	筋疲労	下行結腸腫瘍
水疱後びらん	水疱症	雀卵斑
胆管内結石	胆管結石症	代理ミュンヒハウゼン症候群
時々せん妄	せん妄	２型自己免疫性膵炎
処置後膵炎	膵炎	手掌部外傷
術後右反回神経麻痺	術後性反回神経麻痺	一側性パーキンソン症候群
反復性細菌感染	細菌感染症	左胃動脈瘤
ｗｉｄｅ　ＱＲＳ頻拍	頻拍症	ホルモン産生腫瘍
両側性末梢性顔面神経麻痺	末梢性顔面神経麻痺	足背腫瘍
皮膚軟部組織感染症	皮膚感染症	仙腸部関節癒合
腰痛ヘルニア	椎間板ヘルニア性腰痛症	小脳梗塞後遺症
イレウス合併	イレウス	脳循環不全
息苦しく	呼吸困難	１型糖尿病性腎症第３期Ａ
肺好酸球性肉芽腫	肺好酸球性肉芽腫症	母指末節骨骨折
無菌性腸炎	非感染性腸炎	ＭＰ関節内骨折
骨盤内リンパ嚢腫	骨盤部感染性リンパのう胞	聴神経のう腫
両側眼瞼下垂症	眼瞼下垂症	扁桃炎
両側性結核性胸膜炎	結核性胸膜炎	前十字靱帯付着部剥離骨折
甲状腺機能亢進症状	甲状腺機能亢進症	傍十二指腸ヘルニア
平坦Ｔ波	心電図異常	骨膜下膿瘍
ペーシング不全	両室ペーシング機能付き植込型除細動器不全	流産後子宮内膜炎
後頭部打撲	頭部打撲	前腕骨折後変形骨癒合
薬剤性過敏症候群	薬剤性過敏症症候群	眼部開放創
両側喉頭肉芽腫	喉頭肉芽腫	前立腺欠損
ふらつきあり	めまい	閉じこめ症候群
右鼡径ヘルニア	鼡径ヘルニア	薬剤性顆粒球減少症
職業性ストレス	急性ストレス反応	筋膜結核
卵管水腫	卵管留水症	仙骨尾骨異常
左下葉原発性肺扁平上皮癌	肺扁平上皮癌	片側性完全唇裂
外気胸	気胸	斜鼻
ポリープ数個	ポリープ	頭部損傷
右低音障害型感音難聴	急性低音障害型感音難聴	妊娠性静脈瘤
外陰部血腫	外陰血腫	血栓塞栓症
左乳突蜂巣炎	乳様突起炎	薬剤性糖尿病・昏睡合併あり
未破裂左内頸動脈瘤	内頚動脈瘤	仮性声帯麻痺
中咽頭側壁扁平上皮癌	癌	硬膜外血腫・頭蓋内に達する開放創合併なし
ＥＶＡＮＳ症候群	エバンス症候群	手背第２度熱傷
右聴神経腫瘍	聴神経腫瘍	再発性脳梗塞
両肺多発結節性陰影	胸部異常陰影	乳房咬創
左血腫	血腫	膵臓性腹膜炎
早期乳癌	乳癌	腸骨血管損傷
脾臓腫瘤	腫瘤	テタニー性白内障
多発髄膜腫	多発性髄膜腫	乳房線維肉腫
術中出血多	多量出血	肋軟骨部痛
先天性嚢胞肺	先天性のう胞肺	頚髄星細胞腫
手背部疼痛	手背部痛	術後乳び胸
腹部大動脈嚢状瘤	腹部大動脈瘤	踵部第１度熱傷
腫瘍感染合併	腫瘍	下腿挫創
ＩＰ合併	間質性肺炎	乳糖不耐性下痢症
左腫瘤	腫瘤	足関節偽痛風
ゾメタ骨髄炎	骨髄炎	腰椎奇形
葉酸欠乏	葉酸欠乏症	大腿腫瘍
右胸膜原発血管肉腫	血管肉腫	小腸壊死
拘縮気味	筋拘縮症	新生児遅発代謝性アシドーシス
手関節圧痛	圧痛	陳旧性骨折
浮腫残存	浮腫	手関節部裂創
非てんかん性心因性発作	てんかん	腸骨動脈閉塞症
鼻口蓋管嚢胞	鼻口蓋管のう胞	腋窩石灰化上皮腫
下腸間膜動脈閉塞	腸間膜動脈塞栓症	トランスコバラミンＩＩ欠乏症
右中大脳動脈領域梗塞	中大脳動脈閉塞症	胃癌検診
消化管腫瘤	腫瘤	大腿部外傷性骨化性筋炎
脛骨前面圧痕性浮腫	浮腫	脊髄硬膜内髄外神経鞘腫
多少眠気	非器質性過眠症	線維性骨炎
高濃度腫瘤	腫瘤	重度知的障害・行動機能障害の言及なし
ＤＧＥ症状	消化管術後後遺症	悪性小脳腫瘍
過形成性ポリープ	胃過形成ポリープ	頭部損傷
日光アレルギー	光線過敏症	小指屈筋腱断裂
両膝痛	膝関節痛	アレキサンダー病
こわばりあり	こわばり	下顎隆起
慢性炎症性腸疾患	腸炎	上腕骨骨幹部骨腫瘍
尺骨頭脱臼	脱臼	下垂体障害
けいれん症状	痙攣	足背ボーエン病
重度三尖弁閉鎖不全症	三尖弁閉鎖不全症	乳汁分泌欠如
肺炎併発	肺炎	陰茎癌
右下肢感覚鈍麻	感覚異常症	尿閉
第二度房室ブロック	第２度房室ブロック	高チロシン血症３型
慢性進行性肺アスペルギルス症	肺アスペルギルス症	脳ヘルニア
点状発赤	発赤	胎向異常新生児
白血病化	白血病	骨盤骨腫瘍
消退性発赤	発赤	胎向異常新生児
ヒステリー	ヒステリー反応	器質性偽遅滞性人格
手指皮疹	発疹	下肢短縮萎縮
残尿	残尿感	膀胱外反症
腫脹圧痛	圧痛	上腕部腫脹
ループスアンチコアグラント陰性	ループスアンチコアグラント	十二指腸破裂
両肺気胸	気胸	前腕第１度熱傷
右肺胸水貯留	胸水貯留	腹部停留精巣
血性吐物	吐血	外傷性視神経症
両側腓骨神経麻痺	腓骨神経麻痺	汎発性頑癬
廃用	廃用症候群	ＧＭ１ガングリオシドーシス
浮動感	めまい	慢性癒着性心膜炎
軽度右室肥大	右室肥大	乳房葉状腫瘍
右膝蜂窩織炎	膝部蜂巣炎	前腕腫瘍
強制換気	人工呼吸器装着状態	口腔褥瘡性潰瘍
２型＋ステロイド糖尿病	ステロイド糖尿病	外傷性肝破裂・腹腔に達する開放創合併あり
左下肢ガス壊疽	ガス壊疽	心因性反応
低血糖用	低血糖	アレルギー性関節炎
喚語障害	不全失語症	乳腺肥大
右足底潰瘍	足底皮膚潰瘍	肩部血管腫
右網膜静脈分枝閉塞症	網膜静脈分枝閉塞症	ぶどう球菌性関節炎
腹痛時	腹痛症	脳卒中後てんかん
多動多弁	多動性障害	皮下脂肪型肥満
右手背浮腫	限局性浮腫	外耳道癌
足趾しびれ	下肢しびれ	汗腺腫
突然意識障害	意識障害	寄生虫性虹彩のう胞
足底痺れ	しびれ感	外傷性低脳圧症
角膜ヘルペス	ヘルペス角膜炎	アデノウイルス脳脊髄炎
食思不振症状	食欲不振	１型糖尿病性皮膚障害
細菌性食道炎	食道炎	記銘力低下
開大代謝性アシドーシス	代謝性アシドーシス	先天性ヨード欠乏症候群
心因性過食症	心因性過食	耳垢栓塞
術後肺転移	転移性肺腫瘍	胸部単純性血管腫
転移性腫瘤	転移性腫瘍	大腿部外傷性骨化性筋炎
夜間尿意	夜間頻尿症	足根骨部剥離骨折
右下腿腫脹	下腿腫脹	腺腫性子宮内膜増殖症
背部皮脂欠乏性湿疹	皮脂欠乏性湿疹	糖尿病性昏睡
足爪白鮮	足爪白癬	リポジストロフィー
神経性疼痛	神経痛	耳損傷
房室接合部調律	異所性調律	人工聴覚器植え込み状態
末梢循環不全徴候	末梢循環不全	結腸瘻
眼瞼下垂自覚	眼瞼下垂症	扁桃炎
右上顎洞乳頭腫	上顎洞乳頭腫	向精神薬服用母体より出生した児
帯状疱疹拡大	帯状疱疹	総頚動脈損傷
左尾状核ラクナ硬塞	ラクナ梗塞	高カリウム血性周期性四肢麻痺
ＳＭＡ閉塞	急性上腸間膜動脈閉塞症	グラスアイオノマーセメント脱離
めまいの発作	めまい	喉頭開放骨折
呼吸切迫	急性呼吸窮迫症候群	術後てんかん
劇症型連鎖球菌感染症	連鎖球菌感染症	閉鎖性尿管損傷
腹部疝痛	仙痛	母指球部痛
胆嚢多発ポリープ	胆のうポリープ	糖尿病足壊疽
柑皮症	カロチン血症	健忘症
浮腫状	浮腫	アルコール性脂肪肝
陰部掻痒	外陰部そう痒症	ＭＲＳＡ敗血症
十二指腸多発びらん	十二指腸びらん	毛様体異物残留
前立性肥大症	前立腺肥大症	前置胎盤
嘔気状況	嘔気	網膜膠腫
両側眼球外転障害	眼球運動障害	慢性脳炎
元々浮腫	浮腫	手関節部裂創
左小脳出血	小脳出血	トリニトロトルエン中毒
躁うつ	躁うつ病	ぶどう球菌感染症
夜間失禁	尿失禁症	異常嚥下癖
ベージェット病	ベーチェット病	側胸部皮膚癌
元来頭痛	頭痛	盲腸周囲ヘルニア
褥瘡発生リスク低い	褥瘡	直腸良性腫瘍
下部直腸癌	直腸癌	アデノイド扁桃炎
両側総腸骨動脈狭窄	総腸骨動脈狭窄	口唇挫傷
牽引痛	牽引性頭痛	陰のう血管腫
Ⅱ度熱傷	熱傷	チーズ洗浄職人肺
重度感覚障害	体感異常	ポスナーシュロスマン症候群
両側肺尖部進行性胸膜肥厚	胸膜肥厚	膀胱後部膿瘍
婦人入院脳梗塞	脳梗塞	中心性網脈絡膜炎
炎症性ポリープ多発	ポリープ	胃腫瘤
右坐骨結節転移再発	転移性腫瘍	アルコール性肝障害
ダンピング症候群併発	ダンピング症候群	肋骨不全損傷
右上肢痺れ	しびれ感	肘関節挫創
ＭＣＴＤ	混合性結合組織病	手骨開放骨折
ループスアンチコアグラント陽性	ループスアンチコアグラント	十二指腸破裂
昨日水様便	下痢症	舌甲状腺
気分不快増強	悪心	大腿骨顆上開放骨折
拡張期高血圧	高血圧症	頚髄損傷後遺症
右気管支肺炎	気管支肺炎	アキレス腱切創
左頸部リンパ節腫大	薬剤性自己免疫性溶血性貧血	リンパ球性下垂体炎
右低音部感音難聴	感音難聴	筋欠損
ＰＨＴ	肺高血圧症	大動脈弁狭窄症兼肺動脈弁閉鎖不全症
夜間失見当	見当識障害	腰部損傷
劇症型髄膜炎菌感染症	髄膜炎菌感染症	開放性気管支損傷
物忘れ気	健忘症	胸椎椎間板ヘルニアによる神経根症
両難聴	難聴	日光紅斑
左腎細胞癌	腎細胞癌	高血糖高浸透圧症候群
多発膵転移	転移性膵腫瘍	筋肉結核
両眼白内障手	白内障	先天性のう胞性腺腫様形成異常
右手関節滑膜炎	滑膜炎	甲状腺中毒症性心筋症
膠原病由来	膠原病	門脈圧亢進症
声門上喉頭癌	喉頭癌	胸椎開放性脱臼骨折
右膝メルケル細胞癌	メルケル細胞癌	膵漿液性のう胞腺腫
右椎骨動脈起始部狭窄	椎骨動脈狭窄症	象牙質知覚過敏症
加害妄想	妄想反応	脛骨顆開放性粉砕骨折
嚢胞性胸腺腫	胸腺腫	自然流産
急性乳突洞炎	急性中耳炎	プラーク性歯肉炎
舌内リンパ節転移	リンパ節転移	網膜色素上皮症
悪性リンパ腫既往	悪性リンパ腫	ウイルス性心筋炎
左肺下葉腫瘤影	肺腫瘤	ぶどう球菌性熱傷様皮膚症候群
Ｌ３圧迫骨折	圧迫骨折	母指屈筋腱癒着
左感音性難聴	感音難聴	腕頭動脈瘤
腎臓疾患	腎疾患	傍腎盂のう胞
ＣＯＰＤＩ期	慢性閉塞性肺疾患	乳糖不耐性下痢症
転倒歴多数	よろめき歩行	小指腱鞘炎
ＤＩＨＳ	薬疹	乳糖不耐性下痢症
夜勤帯下血	下血	ボツリヌス中毒
インスリン依存性糖尿病	１型糖尿病	ＨＣＡＨＣ
頸部椎間板ヘルニア	頚椎椎間板ヘルニア	頚椎症
右眼網膜裂孔	網膜裂孔	リステリア性心内膜炎
拍動性疼痛	疼痛	ベリリウム肺症性肝肉芽腫
下血増悪	下血	脊髄空洞症
ＤＭ性腎不全	糖尿病性腎不全	壊疽性傍ストーマヘルニア
膝関節軽度屈曲拘縮	屈曲拘縮	子宮頚部軽度異形成
ＡＴＬ	成人Ｔ細胞白血病リンパ腫	手骨開放骨折
肺動脈弁閉鎖不全	肺動脈弁閉鎖	先天性外陰欠損
熱感軽度	ほてり	カンジダ性湿疹
重度不眠	不眠症	頚部挫傷後遺症
咀嚼困難感	咀嚼障害	頚髄神経根引き抜き損傷
食道圧迫	食道圧迫症	喉頭蓋血腫
両足関節痛	足関節痛	アダイア・ダイトン症候群
術後肝転移	転移性肝癌	急性硬膜外血腫
朝低血糖	低血糖	死体腎移植後
喘息疑い	咳喘息	発声困難
顔皮疹	発疹	胃大弯部癌
子宮筋腫有	子宮筋腫	睡眠相後退症候群
淡明細胞型腎細胞癌	腎細胞癌	高血糖高浸透圧症候群
浮腫生	浮腫	アルコール性脂肪肝
再出血徴候	出血	皮膚放線菌症
アシネトバクター敗血症	敗血症	肺動脈分岐部狭窄症
左自然気胸再発	自然気胸	肋骨転移
高度肥満２型糖尿病	２型糖尿病	胸椎破裂骨折
右大腿骨骨肉腫	大腿骨骨肉腫	脛骨慢性化膿性骨髄炎
左腎盂腎炎治癒後	腎盂腎炎	中心性頚髄損傷
二次性水頭症	外傷後水頭症	三尖弁逆流
ダグラス窩播種	腹膜播種	胎児栄養失調症
左室拡張能低下	左室不全	脊椎開放骨折
ウィルス感染症	ウイルス感染症	卵巣腫瘍破裂
左手尺骨神経麻痺	尺骨神経麻痺	潜函病性骨壊死
周期性呼吸時折	周期性呼吸	外陰炎
異常帯下	帯下	非アルコール性脂肪性肝炎
多発性大腸ポリープ	大腸ポリープ	全子宮内反症
糖尿病用	糖尿病	単一臍動脈
術前心電図異常	心電図異常	頭部外傷２型
中耳炎症状	中耳炎	迷路瘻
脱力症状	脱力感	頭蓋底良性腫瘍
上半身掻痒感	そう痒	先天性第Ｘ因子欠乏症
動揺性めまい	めまい	トキソプラスマ網膜症
褥瘡発生歴	褥瘡	新生児臍帯結節
水分摂取困難	嚥下障害	胃乳頭腫
趾爪囲炎	爪囲炎	一過性菌血症
右下葉原発低分化腺癌	癌	反射性瞳孔強直
挙上期誤嚥	異物誤嚥	第ＶＩＩ因子欠乏症
腹部膨満増強	腹部膨満	肺動脈血栓症
右副腎腫瘍摘出術	副腎腫瘍	水頭症性無脳症
右鎖骨痛	鎖骨痛	非対称性弯曲足
細菌性扁桃炎	扁桃炎	石綿性胸膜斑
左歯性上顎洞炎	歯性上顎洞炎	脳梁離断症候群
重度歯周病	歯周症	趾末節骨悪性腫瘍
正常圧緑内障	緑内障	捻転歯
梗塞後出血	出血性脳梗塞	急性心筋梗塞後心室内血栓症
骨髄異型性症候群	骨髄異形成症候群	腹部母斑細胞母斑
光線過敏	光線過敏症	マイボーム腺腫瘍
副睾丸炎	精巣炎	エルブ麻痺
虚脱病変	虚脱	非外傷性腸穿孔
慢性アレルギー性鼻炎	季節性アレルギー性鼻炎	肘部皮膚良性腫瘍
肘痛	肘関節痛	下肢第３度熱傷
夕食前低血糖	低血糖	死体腎移植後
先天性代謝異常症	代謝障害	慢性顎骨炎
単頸双角子宮	双角子宮	大動脈弁弁膜症
原発性肺高血圧症	肺高血圧症	高ＩｇＥ症候群
左眼加齢性黄斑変性症	加齢黄斑変性	卵巣顆粒膜細胞腫
左鎖骨リンパ節転移	リンパ節転移	結節性壊死性皮膚炎
殿部色素沈着	色素異常症	肺動脈弁閉鎖
舌浮腫	浮腫	肺切除術後
ストレス性潰瘍	ストレス潰瘍	頚部悪性軟部腫瘍
舌損傷	損傷	臍部せつ
発熱下	発熱	腸管運動障害
失見当識発言	見当識障害	混合性嗅覚障害
右眼内悪性リンパ腫	眼窩悪性リンパ腫	子宮性無月経
腹部大動脈狭窄	大動脈狭窄症	鼻炎
右季肋部自発痛	季肋部痛	中等度知的障害
軽度痺れ	しびれ感	中咽頭乳頭腫
星芒状血管腫	血管腫	悪性髄膜腫
右房内腫瘤	腫瘤	急性心筋炎
Ｓ状結腸転移	転移性消化器腫瘍	外傷性脊椎症
全身掻痒感	そう痒	脳幹部海綿状血管腫
右手舟状骨骨折	手舟状骨骨折	フェオミコーシス性脳膿瘍
肉芽腫性腸疾患	腸疾患	示指屈筋腱断裂
両足圧痕性浮腫	浮腫	外耳道癌
発作後精神病	精神病	滴状類乾癬
虫垂粘液嚢胞腺腫	虫垂粘液のう胞	十二指腸血管腫
四肢水疱	水疱症	雀卵斑
右足趾骨髄炎	趾骨髄炎	食事性高脂血症
若年性リウマチ	関節リウマチ	錐体路障害
体陽性脳炎	脳炎	項部筋肉痛
境界域ＤＭ	糖尿病	混合型脳性麻痺症候群
結節性不整脈	不整脈	体重減少性無月経
劇症敗血症	敗血症	２型糖尿病性ミオパチー
慢性血腫	血腫	先天性心膜奇形
骨破壊病変	関節リウマチ	環指腱鞘巨細胞腫
眼窩部痛	眼痛	椎間板変性症
昨日不眠	不眠症	頚部挫傷後遺症
頚椎脊柱管狭窄症	頚部脊柱管狭窄症	銃創
発赤域	発赤	胎向異常新生児
膵頭部転移	転移性膵腫瘍	筋肉結核
高度肝障害	肝障害	角膜擦過傷
右肺下葉腫瘍	肺腫瘍	ＣＡ１９−９高値
口腔内発赤腫脹	発赤	腹水細胞診陽性
中咽頭再発腫瘍	咽頭腫瘍	限局性膿胸
左下肢冷感	下肢冷感	予防接種後敗血症
大腫瘍	腫瘍	急性肺性心
胸骨肋骨転移	肋骨転移	外傷性髄液鼻漏・頭蓋内に達する開放創合併なし
重症心身障害児	重症心身障害	白血病性網膜症
腹部軽度膨隆	腹部膨満	膝蓋部擦過創
リンパ管症	癌性リンパ管症	頭皮圧挫傷
遷延性抑うつ状態	うつ状態	接着剤アレルギー性接触皮膚炎
結核性強膜炎	結核性胸膜炎	先天性腓骨弯曲
下腿筋萎縮	筋萎縮症	急性音響性外傷
膵頭癌	癌	黒色表皮腫
ＶＡＨＳ	ウイルス関連血球貪食症候群	大動脈弁狭窄症兼肺動脈弁閉鎖不全症
圧痛自発痛	圧痛	上腕部腫脹
痰中等量引ける	喀痰	異所性灰白質
放射線障害	放射線宿酔	脳リピドーシスの認知症
浅眠	不眠症	線維性骨炎
反射異常	異常反射	先天性気管食道瘻
慢性間質性腎炎	慢性尿細管間質性腎炎	足根骨癒合
脳溢血	脳卒中	肩甲部脂肪腫
右下肢深部静脈血栓症	下肢静脈血栓症	奇静脈肺葉
カテーテル感染	カテーテル感染症	上葉非小細胞肺癌
腫瘍多発	腫瘍	急性肺性心
背部筋緊張高い	筋強直	悪性リンパ腫骨髄浸潤
全身紅斑	紅斑症	急性小脳性失調症
しびれてる感	しびれ感	中脳水道先天異常
少量尿失禁	尿失禁症	中毒性肝障害
脳腫瘍切除	脳腫瘍	慢性光線性皮膚炎
右側下顎骨体部骨折	下顎骨骨折	１型糖尿病性腎症第２期
高血糖是正	高血糖症	腰椎硬膜外血腫
腫瘤拡大	腫瘤	足関節偽痛風
病原性大腸菌	病原性大腸菌感染症	カテーテル関連尿路感染症
耳小骨奇形	耳小骨の先天奇形	母趾末節骨骨端線損傷
全身性紫斑	全身性紫斑病	若年性慢性硬膜下血腫
微小多発脳梗塞	多発性脳梗塞	メイ・ヘグリン症候群
右股関節亜脱臼	股関節亜脱臼	中東呼吸器症候群
糸球体血尿	血尿	遺伝性ジストニア
左橈骨神経麻痺	橈骨神経麻痺	脳底動脈先端症候群
全身性間代性痙攣	間代性痙攣	眼周囲部外傷性皮下異物
右肋間痛	肋間痛	機能性収縮期雑音
右続発性緑内障	続発性緑内障	頭部多発打撲傷
軟骨腫	骨軟骨腫	梅毒性脳動脈炎
開大性代謝性アシドーシス	代謝性アシドーシス	先天性ヨード欠乏症候群
パニック様症状	全般性不安障害	眼瞼疣贅
胆嚢充満結石	胆のう結石症	代理ミュンヒハウゼン症候群
左上葉肺転移	転移性肺腫瘍	１型糖尿病合併妊娠
軽度しびれ感	しびれ感	中脳水道先天異常
意識レベル低	意識障害	ＴＢＧ異常症
爪囲紅斑	爪囲炎	急性小脳性失調症
子宮頸癌Ｉｂ１期	子宮頚癌	腸骨窩部痛
感覚性運動失調	運動失調	尿管瘤
両側鎖骨上窩リンパ節腫大	リンパ節腫大	単純性肺好酸球増加症
中枢性めまい	中枢性めまい症	共同性外斜視
関節滑膜炎	滑膜炎	甲状腺中毒症性心筋症
続発性膜性腎症	膜性腎症	開頭術後骨欠損
立位保持困難	四肢筋力低下	発音補助装置不適合
先天性風疹症侯群	先天性風疹症候群	壊死性肺炎
左足痺れ	しびれ感	子宮類内膜腺癌
Ｒｉｅｄｅｌ甲状腺炎	線維性甲状腺腫	超高熱
椎骨動脈狭窄	椎骨動脈狭窄症	象牙質知覚過敏症
活動性肺結核症	活動性肺結核	足舟状骨ケーラー病
鼻腔化膿性肉芽腫	細菌性肉芽腫症	後大脳動脈塞栓症
痙攣発作再発	痙攣発作	小指ＭＰ関節橈側側副靱帯損傷
右脛骨内果骨折	足関節内果骨折	妊娠中感冒
左胸膜転移	胸膜播種	大腿骨遠位骨端線離開
卵巣腫瘍再発	卵巣腫瘍	スフィンゴリピドーシス
右肺中葉転移	転移性肺癌	脳室拡大
下腿筋痛	下肢筋肉痛	新生児臍出血
右大腰筋血腫	血腫	コロナウイルス感染症
十二指腸潰瘍再発	慢性十二指腸潰瘍	頭蓋椎骨接合部異常
Ａｆ不変	心室細動	尿道内異物
左下腿部帯状疱疹	帯状疱疹	アトピー性紅皮症
顔面麻痺１	顔面神経麻痺	先天性前腕変形
巨大腫瘤	腫瘤	足関節偽痛風
右足関節腫脹	足関節腫脹	片側性唇・粘膜下口蓋裂
外陰部湿疹	湿疹	裂溝性鼻
両肺副雑音	胸部音異常	血友病性出血
腎機能異常	腎機能検査異常	新生児胃破裂
姿勢障害	姿勢異常	ヘルペスウイルス性虹彩炎
左肘頭開放骨折	開放骨折	少関節型若年性関節炎・膝関節
イレウス発生	イレウス	脳循環不全
若干硬結	硬結	爪の障害
左骨盤内リンパ嚢胞	骨盤部感染性リンパのう胞	ＩＰ関節炎
発作性３度房室ブロック	第３度房室ブロック	先天性肛門狭窄症
身体損傷	損傷	前胸部摩擦音
右大腿骨骨腫瘍	大腿骨腫瘍	陰部切創
慢性胆嚢炎	慢性胆のう炎	鼡咬症スピロヘータ症
偽性高Ｋ血症	高カリウム血症	外耳道膿瘍
反応性胸水	胸水貯留	腹部停留精巣
元々痛み	疼痛	腹壁挫傷
骨盤内膜症	骨盤子宮内膜症	小腸閉鎖
右耳下腺腫瘤	耳下腺腫瘤	萎縮性咽頭炎
肝形質細胞腫	形質細胞腫	肋骨奇形
躁病相	躁状態	中足骨開放骨折
易出血傾向	出血傾向	バリズム
ジューリング疱疹状皮膚炎	ジューリング病	慢性肝炎
末梢発赤	発赤	胎向異常新生児
部分性脂肪萎縮症	部分的脂肪萎縮症	複合性局所疼痛症候群
亜急性脊髄連合変性症	亜急性連合性脊髄変性症	習慣性便秘
副腎偶発腫	良性副腎皮質腫瘍	白赤芽球症
右下腿紅斑	紅斑症	耳介部腫瘍
腸管通過障害	消化管狭窄	眼瞼挫創
努力様呼吸	起坐呼吸	手指知覚異常
膿疱形成	膿疱	鼻咽腔線維腺腫
左卵巣膿瘍	卵巣膿瘍	頭頂葉星細胞腫
発赤皮疹	発疹	下顎部ボーエン病
赤痢アメーバ大腸炎	アメーバ赤痢	耳性めまい
サイトメガロウイルス感染	サイトメガロウイルス感染症	ヘルペスウイルス性外耳炎
Ｇｒａｄｅ　３肝障害	肝障害	胎盤機能不全症
低ＡＬＢ血症	低アルブミン血症	肥大型心筋症
Ⅱ型糖尿病	２型糖尿病	鎖骨開放性粉砕骨折
両顎関節痛	顎関節痛	月経異常
逆流性胆管炎	逆行性胆管炎	特発性非家族性ジストニア
関節痛症状	関節痛	マンソン住血吸虫症
空気塞栓	空気塞栓症	眼内レンズ挿入眼
肝膿瘍破裂	肝膿瘍	示指変形
総肺静脈還流異常症	肺静脈還流異常症	残遺痔核皮膚弁
両下腿痛	下腿痛	ウルリヒ・ファイヘティガー症候群
左橈骨頭脱臼骨折	脱臼骨折	既往帝切後妊娠
正中創感染	創傷感染症	咽頭憩室
左網膜分枝動脈閉塞症	動脈閉塞症	殿部石灰化上皮腫
頸部浮腫	浮腫	外耳道癌
肺扁平上皮癌、病期不明	肺扁平上皮癌	虹彩形成不全症
低血圧自覚症状	低血圧症	人工骨頭破損
常時痛み	疼痛	肩甲部熱傷
倦怠感増	倦怠感	後腹膜気腫
脾臓腫瘍	脾腫瘍	ステロイド糖尿病
多発肝転移増大	転移性肝癌	末梢自律神経ニューロパチー
頸部食道狭窄	食道狭窄	偽性髄膜瘤
陰茎アポクリン癌	陰茎アポクリン腺癌	咽喉圧挫損傷
元来月経痛	月経痛	膵性糖尿病
胆嚢十二指腸瘻	胆のう十二指腸瘻	脚気神経炎
特発性肺胞出血	肺胞出血	性交後出血
左鼠径部疼痛	鼡径部痛	双極性感情障害・軽躁病エピソード
左側頬粘膜癌	頬粘膜癌	卵巣線維腫
円盤状皮疹	円板状エリテマトーデス	腋窩圧挫傷
左手首疼痛	手部痛	中手骨不全骨折
アレルギー反応	アレルギー	多発梗塞性認知症
夜間痙攣	痙攣	外直筋麻痺
膵体部小嚢胞	腫瘍性膵のう胞	食道静脈瘤
耳介脂漏性湿疹少	脂漏性皮膚炎	外傷性慢性硬膜下血腫
両側急性硬膜下出血	急性硬膜下血腫	遺伝性掌蹠角化症
毎回尿失禁	尿失禁症	中毒性肝障害
喉頭蓋腫脹	喉頭蓋炎	単純型顔面外傷
愁訴	不定愁訴症	包皮切創
血腫不変	血腫	膵臓性腹膜炎
各種膠原病	膠原病	門脈圧亢進症
肺気胸	気胸	滲出性腹水
深部感覚鈍麻	感覚異常症	金属歯冠修復粗造
脊柱圧痛	圧痛	上腕部腫脹
亜脱臼傾向	亜脱臼	趾屈筋腱断裂
自傷痕	自傷	卵巣損傷・骨盤腔に達する開放創合併なし
嘔吐持続	嘔吐症	乳汁分泌抑制
痙攣重積後脳症	痙攣重積型二相性急性脳症	前頭部脳瘤
小腸大腸型	小腸大腸クローン病	顔面痙攣症
薬剤肝障害	薬物性肝障害	味覚消失
転移性膵体部癌	膵体部癌	淋菌性咽頭炎
左前頭葉神経膠腫	前頭葉神経膠腫	老人性肺炎
精神運動興奮	精神運動興奮状態	眼異形成
インフルエンザＡ型感染症	インフルエンザＡ型	肩部悪性線維性組織球腫
紅斑反応	紅斑症	先天性間葉芽腎腫
右尿管結石症	尿管結石症	心因性生理的機能低下
瞳孔不同	瞳孔不同症	先天性肩甲骨変形
多発肝転移巣	転移性肝腫瘍	末梢自律神経ニューロパチー
顕微鏡的大腸炎	大腸炎	趾伸筋腱断裂
直腸Ｒａ癌	直腸癌	性器下疳
原発性アルドステロン	原発性アルドステロン症	増殖性網膜症
苔癬局面	苔癬	ライフェンシュタイン症候群
足趾爪混濁肥厚	ころもじらみ寄生症	胎児赤芽球症
ＣＭＶ肺炎	サイトメガロウイルス肺炎	狭心症
右ＩＣＡ狭窄	内頚動脈狭窄症	偽性髄膜炎
痰貯留	喀痰	空隙歯列弓
足趾蜂窩織炎	足蜂巣炎	原発性希発月経
僧帽弁狭窄兼逆流症	僧帽弁狭窄症	ストーマ粘膜皮膚侵入
中背部悪性黒色腫	背部悪性黒色腫	下唇赤唇部癌
歯槽膿漏	歯周炎	心筋疾患
左肘関節破壊	関節リウマチ・肘関節	殿部第１度熱傷
副甲状腺亢進症	副甲状腺機能亢進症	橈骨亀裂骨折
右声帯不全麻痺	声帯不全麻痺	環指ＰＩＰ関節側副靱帯断裂
心合併症	心臓合併症	増悪労作型狭心症
皮下石灰化	皮膚石灰沈着症	顎関節前方脱臼
薬剤性発熱	発熱	副腎皮質形成不全
労作時前胸部痛	前胸部痛	顔面皮膚上皮内癌
肺炎等	肺炎	胆泥
軽度ＡＤＨＤ	注意欠陥多動障害	下腿複雑骨折後骨髄炎
新生児一過性多呼	新生児一過性多呼吸	ブレブ
両心房拡大	心肥大	子宮頚管裂傷
上転障害	眼球運動障害	頭部急性リンパ節炎
不眠状態	不眠症	頚部挫傷後遺症
プレクリニカルクッシング症候群	クッシング症候群	牽引装置破損
左胸鎖乳突筋炎	胸鎖乳突筋炎	術後副腎皮質機能低下症
腫瘍性	腫瘍	統合失調症型障害
時々関節痛	関節痛	水痘性角結膜炎
嫌悪感	悪寒	成人Ｔ細胞白血病リンパ腫・慢性型
二次性僧帽弁閉鎖不全症	僧帽弁閉鎖不全症	全身性アレルギー性皮膚炎
急性大動脈弁閉鎖不全	大動脈弁閉鎖不全症	胸水細菌培養陽性
左心肥大	心肥大	皮膚筋炎性間質性肺炎
腹痛嘔気	嘔気	脳卒中後てんかん
前頭部打撲	頭部打撲	前腕骨折後変形骨癒合
左大腿部骨外性粘液型軟骨肉腫	軟骨肉腫	脳炎
高度異形成相当	子宮頚部高度異形成	人工歯根上部構造不適合
腹緊なし	腹部膨満	肺動脈血栓症
右頚部ＬＮ腫大	リンパ節腫大	下腿挫創
側卵巣嚢腫	卵巣のう腫	先天性肺線維症
哺乳後嘔吐	嘔吐症	核黄疸Ｉ期
右結石性腎盂腎炎	結石性腎盂腎炎	小指中手骨遠位端開放骨折
Ｃｒｏｎｋｈｉｔｅ−Ｃａｎａｄａ症候群	クロンカイト・カナダ症候群	上顎歯牙腫
心嚢液貯留	心膜液貯留	盲腸瘻
臓器限局性前立腺癌	限局性前立腺癌	挺出歯
貧血傾向	貧血	中指挫創
右中大脳動脈梗塞	内頚動脈塞栓症	胃癌検診
日中傾眠	傾眠症	結核性脊柱後弯症
脾臓結核	結核	悪性グルカゴノーマ
食後高血糖	高血糖症	腰椎硬膜外血腫
高浸透圧血症	高血糖高浸透圧症候群	中枢性嘔吐症
両下肢軽度浮腫	下肢浮腫	示指側副靱帯断裂
右間歇性跛行	間欠性跛行	腸骨動脈塞栓症
陰嚢ヘルニア	陰のうヘルニア	家族性パーキンソン病Ｙａｈｒ４
多形紅斑型薬疹	薬疹	網脈絡膜炎
右腋窩リンパ節腫脹	腋窩リンパ節腫脹	統合失調感情障害
静脈内腫瘍栓	腫瘍	盲係蹄症候群
爪甲剥離症	爪剥離症	頚管難産
再度急性腎不全	急性腎不全	壊疽性傍ストーマヘルニア
進行再発大腸癌	大腸癌	母指腱性マレット指
胃接合部癌	胃癌	急産
耳閉塞感	耳閉感	アレルギー性気管支肺カンジダ症
手足しびれ	しびれ感	汗腺腫
内膜損傷	損傷	双胎妊娠
胃小彎側ＬＮ転移	胃周囲リンパ節転移	呼吸促迫
軽度発達遅滞	発達遅滞	ピロプラスム症
非浸潤性膀胱癌	膀胱癌	偽乳頭浮腫
右先天性耳瘻孔	先天性耳瘻孔	肺分画症
脂肪腫摘出	脂肪腫	隅角後退
椎間板ヘルニア有	椎間板ヘルニア	自律神経失調症
扁平ポリープ	ポリープ	頭部損傷
咽頭知覚障害	咽頭異常感症	フォアダイス状態
腸液貯留	体液貯留	肩甲腓骨型脊髄性筋萎縮症
両変形性膝関節症	変形性膝関節症	急性帯状潜在性網膜外層症
急性胆嚢胆管炎	胆管炎	肺動脈形成不全症
扁平上皮癌	癌	急性冠症候群
内痔核脱出	内痔核	糖尿病足病変
びまん性脳浮腫	脳浮腫	肺切除術後
呼気困難	呼吸困難	硬化性卵巣
重症鬱血性心不全	うっ血性心不全	境界型統合失調症
大腸早期癌	大腸癌	ブリッジ不適合
喘鳴聴取	喘鳴	円板状外側半月板
左乳癌特	乳癌	大腿滑膜肉腫
Ａ型溶連菌感染症	溶連菌感染症	手指振戦
悪性副腎外褐色細胞腫	褐色細胞腫	眉毛部裂創
傍隔壁型肺気腫	肺気腫	手掌紅斑
角膜糜爛	角膜びらん	１型糖尿病性そう痒症
骨盤内播種新生	骨盤転移	皮膚エリテマトーデス
急性非代償性心不全	心不全	白色水腫
最近便秘	便秘症	二次性骨粗鬆症・病的骨折あり
右頬部痛	頬部痛	鞍鼻
右肺動静脈瘻	肺動静脈瘻	膨隆虹彩
１型高ウイルスＣ型慢性肝炎	Ｃ型慢性肝炎	結核性骨髄炎
問題なし膀胱直腸障害	膀胱直腸障害	聴覚消失
Ｌｉｓｔｅｒｉａ腸炎	細菌性腸炎	ばち指
右膿胸	膿胸	外傷性肝破裂
ヒリヒリ感	疼痛	毛孔性苔癬
時折胸痛	胸痛	縦隔甲状腺腫
大動脈弁下心室中隔欠損	心室中隔欠損症	足部皮膚癌
右傍矢状静脈洞髄膜腫	髄膜腫	眼角有棘細胞癌
無自覚性低血糖	低血糖	アレルギー性関節炎
両側卵管留血腫	卵管留血腫	回盲部癌
脱水注意	脱水症	脛骨腓骨骨折
心尖部型肥大型心筋症	肥大型心筋症	血栓性痔核
右飛蚊症	飛蚊症	２型糖尿病性神経因性膀胱
腎不全保存期	腎不全	梗塞後狭心症
口腔内炎	口内炎	コルシカ熱
びまん性大細胞	びまん性大細胞型Ｂ細胞性リンパ腫	１型糖尿病性精神障害
大うつ病	単極性うつ病	気管支良性腫瘍
肝門部悪性リンパ腫	肝門部リンパ節転移	リンパ管腫症
精神病性うつ病	うつ病	腎カルチノイド
水疱性類天疱	水疱症	前腕母斑
中枢性低換気	換気量減少	肺胞微石症
右膝ＡＣＬ損傷	前十字靱帯損傷	１型糖尿病性胃腸症
全身倦怠感軽度	全身倦怠感	大腿骨顆上開放骨折
混合難聴	難聴	自律神経炎
毛孔一致性丘疹	丘疹	皮質下脳損傷
先天性巨大色素性母斑	巨大母斑細胞母斑	腰部椎間板ヘルニアによる神経根症
不安大	不安障害	口腔ヘルペス
胸骨下液体貯留	体液貯留	肩甲腓骨型脊髄性筋萎縮症
新出肺転移	転移性肺腫瘍	胸部単純性血管腫
左聴器癌	癌	腎盂ポリープ
多発脳神経障害	多発性脳神経障害	腓骨筋腱脱臼
上腹部リンパ節転移	リンパ節転移	呼吸促迫
被殻梗塞	被殻出血	舌縁癌
直腸Ｒａｂ癌	直腸癌	性器下疳
軽度高血糖	高血糖症	腰椎硬膜外血腫
本日硬便少量	便異常	慢性扁桃炎
２型腫瘤	腫瘤	足関節偽痛風
右腎無形成	腎無形成	モートン病
リンパ節圧痛	圧痛	黄斑萎縮
全身性細菌感染症	細菌感染症	左胃動脈瘤
脳髄膜瘤	髄膜脳瘤	気道狭窄
水頭症症状	水頭症	悪性縦隔腫瘍
小血栓	血液凝固異常	開放性後頭部外傷
右耳失聴	聴覚消失	耳介部腫瘤
統合失調症合併	統合失調症	２型糖尿病性昏睡
胃痛症状	胃痛	肝周囲膿瘍
急性期ＨＩＶ感染症	ＨＩＶ感染症	調節性眼精疲労
右下肢運動障害	四肢運動障害	踵部悪性黒色腫
炎症性脱髄性多発根神経炎	慢性炎症性脱髄性多発神経炎	複合レジン冠破損
上行結腸腫瘤	腫瘤	外傷性てんかん
過食症状	過食症	薬剤性高プロラクチン血症
疾病不安	不安障害	重複精管
肺癌手術	肺癌	眼部外傷性腫脹
色素脱失	炎症後色素脱失	全部金属冠過高
膿貯留	膿瘍	アルツハイマー型初老期認知症
片側副腎腫瘍	副腎腫瘍	後縦隔脂肪肉腫
リンパ節腫脹	リンパ節腫大	レイノー現象
右椎骨動脈巨大血栓化動脈瘤	椎骨動脈瘤	中等症うつ病エピソード
カテ感染	カテーテル感染症	上葉非小細胞肺癌
安心感	心気症	成人Ｔ細胞白血病リンパ腫・慢性型
左鼡径ヘルニア再発	鼡径ヘルニア	体表面積６０−６９％の腐蝕
胃食道静脈瘤破裂	食道静脈瘤破裂	単胞性肝エキノコックス症
左足背蜂窩織炎	足背蜂巣炎	声帯外転筋麻痺
右胸水貯留	胸水貯留	腹部停留精巣
暗青色斑	青色母斑	無舌症
ＨＣＶ陽性	Ｃ型肝炎ウイルス感染	大動脈弁狭窄症兼肺動脈弁閉鎖不全症
疲労感生	疲労感	潜水夫麻痺
感染性静脈血栓症	静脈血栓症	本態性高血圧症
両側腎腫大	腎腫大	関節挫傷
過敏性膀胱炎	膀胱炎	母指痛
包交時出血	出血	鎌状赤血球保因者
右坐骨骨折	坐骨骨折	てんかん単純部分発作
右耳下腺腫脹	耳下腺腫脹	複合性局所疼痛症候群ＩＩ型
進行肺癌	肺癌	結核性軟膜炎
肋骨起始部骨転移	肋骨転移	外傷性髄液鼻漏・頭蓋内に達する開放創合併なし
外傷性変化	外傷	椎骨動脈閉塞症
中等度精神遅滞	中等度知的障害	舌切創
先天性左股関節脱臼	先天性股関節脱臼	心臓の良性腫瘍
リポフスチン沈着	神経セロイドリポフスチン症	下垂体機能低下症
鮮血痰	血痰	ポリオウイルス感染症
壊死性変化	壊死	広範囲顎骨支持型補綴物脱離
溶連菌感染	溶連菌感染症	β−マンノシドーシス
局所発赤	発赤	胎向異常新生児
不整脈チーム	不整脈	体重減少性無月経
中等度ＣＯＰＤ	慢性閉塞性肺疾患	手掌腫脹
胸部圧痛	圧痛	母指球部痛
両上肢痛	上肢痛	殿部皮膚潰瘍
気分不快症状	悪心	結核性中耳炎
右上腕骨近位端粉砕骨折	上腕骨近位端粉砕骨折	小指屈筋腱腱鞘炎
乳突蜂巣	乳様突起炎	血小板放出機構異常症
褥創形成	褥瘡	皮質下のう胞をもつ大頭型白質脳症
ガマ腫	がま腫	小脳虫部腫瘍
膀胱腫瘍再発	膀胱腫瘍	新生児皮膚硬化症
夜間せん妄状態	せん妄	外耳部打撲傷
神経系腫瘍	腫瘍	閉経後萎縮性腟炎
クッシング徴候	クッシング症候群	牽引装置破損
先天性側弯	肋骨異常を伴う先天性側弯症	演技性パーソナリティ障害
非定型抗酸菌肺炎	肺炎	移植人工血管感染
軽度甲状腺腫大	甲状腺腫	腹部悪性黒色腫
手足痺れ	四肢しびれ	クインスランドまだにチフス
節外性濾胞辺縁帯リンパ腫	脾辺縁帯リンパ腫	根側歯周膿瘍
左下葉肺癌	下葉肺癌	強度近視
Ｋｌｅｂｓｉｅｌｌａ　ｐｎｅｕｍｏｎｉａｅ敗血症	新生児クレブシエラ敗血症	肺動脈分岐部狭窄症
若年性認知症	認知症	四肢脱力感
外腸骨域リンパ節腫大	リンパ節腫大	多発骨折
貧血高度	貧血	環指中節骨骨端線損傷
腰部腫瘍	腰椎部腫瘍	吐物嚥下性肺炎
鼠径ヘルニア	鼡径ヘルニア	ＤＩＰ関節部ガングリオン
分化型管状腺癌	癌	体表面積２０−２９％の腐蝕
侵襲性肺アスペルギウス症	侵襲性肺アスペルギルス症	脳ヘルニア
孤発性ＣＪＤ	孤発性クロイツフェルト・ヤコブ病	乳糖不耐性下痢症
右下葉結節影	胸部異常陰影	ＡＬＫ陽性未分化大細胞リンパ腫
軽度左軸偏位	心電図左軸偏位	食道静脈炎
左頚部結核性リンパ節炎	結核性リンパ節炎	頭部皮下血腫
食道がん	食道癌	上肢知覚異常
肛門部発赤	発赤	足底多汗症
脳室拡大進行	脳室拡大	持続性嘔吐による歯酸蝕症
下腿潰瘍	下腿皮膚潰瘍	唾液腺腫瘍
小脳転移	転移性脳腫瘍	胸骨部打撲挫傷
腎盂軽度拡張	腎盂拡張	産褥性乳汁分泌抑制
腫瘍指摘	腫瘍	慢性光線性皮膚炎
心臓原発性悪性リンパ腫	心臓悪性リンパ腫	無症候性ラクナ梗塞
準夜帯嘔気	嘔気	網膜膠腫
成人Ｓｔｉｌｌ病	成人スチル病	下肢慢性動脈閉塞症
脳血管疾患	脳血管障害	足蹠青色母斑
左膝窩部痛	膝窩部痛	人工早産
非浸潤性尿路上皮癌	尿管尿路上皮癌	足関節難治性皮膚潰瘍
下咽頭がん	下咽頭癌	間代性痙攣
両上肢痺れ	上肢しびれ	肘関節挫創
混合性肝癌	肝癌	クレブシェラ腸炎
甲状腺痛	甲状腺炎	転移性口腔癌
少量血便	血便	骨痛
脳梗塞有	脳梗塞	ＸＸＸ症候群
痕発赤	発赤	胎向異常新生児
不消化便	消化不良性下痢	多発性筋炎
末梢性めまい	めまい症	弯曲歯
左上腕骨肉腫	上腕骨骨肉腫	遮断性眼振
四肢型運動失調	運動失調	踵部悪性黒色腫
産生胃癌	胃癌	下顎貫通創
下肢冷感軽度	下肢冷感	予防接種後敗血症
左室内同期不全	左室不全	うっ血乳頭
左脛腓骨骨折	腓骨骨折	坐骨包靱帯ストレイン
漿液性腺腫	卵巣漿液性腺腫	胃体部癌
日本海裂頭条虫	日本海裂頭条虫症	宿便性潰瘍
先天性脳血管異常	脳動静脈奇形	母体窮迫
臀部皮疹	発疹	外転神経根性麻痺
歩行時軽度跛行	跛行	慢性片頭痛
心室中隔扁平化	心室中隔欠損症	心臓電子器具の機械的合併症
フルニエ壊疽	外陰部壊死性筋膜炎	複雑性合趾症
肝芽腫再発	肝芽腫	下肢単純性血管腫
状血管腫	血管腫	乳児肥大性ニューロパチー
卵巣癌破裂	卵巣癌	腹腔内膿瘍
右下腿疼痛	下腿痛	ウルリヒ・ファイヘティガー症候群
軽度眼球突出	眼球突出症	コクシジオイデス症
前頭葉障害	前頭葉症候群	消化管術後後遺症
歯牙損傷	切歯破折	炎症後鼓膜穿孔
両側乳糜胸水	胸水貯留	異形吸虫症
肺門部リンパ節腫大	肺門リンパ節腫脹	高血圧性脳症
麻疹罹患歴	麻疹	嗄声
尿漏れ	尿失禁症	胆のう腺筋腫症
心膜播種	腹膜播種	房室接合部期外収縮
髄液播種	腹膜播種	皮膚エリテマトーデス
左腎動脈狭窄症	腎動脈狭窄症	低酸素性赤血球増加症
体動時創部痛	術創部痛	重症再生不良性貧血
後頭部皮下血腫	頭部皮下血腫	間欠性内斜視
ＭＲＳＡ菌血症	ＭＲＳＡ感染症	びらん性関節症
篩骨蜂巣	篩骨洞炎	眼球熱傷
左退形成性星細胞腫	退形成性星細胞腫	若年性骨軟骨症
仮性動脈瘤切除	偽性動脈瘤	単胞性肝エキノコックス症
鼻中隔血腫	血腫	遺伝性アミロイド腎症
左嗅裂ポリープ	ポリープ	副鼻腔炎術後症
労作時疲労	疲労感	潜水夫麻痺
不定愁訴多	不定愁訴症	包皮切創
軽度失調性構音障害	構音障害	詳細不明精神作用物質使用による急性精神・行動障害
びらんからの出血	出血	主婦湿疹
動揺性精神神経症状	神経症	一胎以上流産後の妊娠継続
過呼吸気味	過換気症	外傷性脳内血腫・頭蓋内に達する開放創合併なし
真菌性感染性心内膜炎	細菌性心内膜炎	淋菌性子宮頚管炎
気道狭窄音	気道狭窄	小児汎発性膿疱性乾癬
未分類関節炎	関節炎	指しゃぶり
左視床出血	視床出血	低形成性貧血
骨突出部発赤	発赤	左上大静脈遺残
神経症性うつ病	抑うつ神経症	先天性胃変形
右浸潤影	胸部異常陰影	前大脳動脈解離
四肢近位筋筋力低下	筋力低下	顔面形成異常
左耳後部腫瘤	耳後部腫瘤	口腔裂創
右乳腺良性腫瘍	乳腺腫瘍	切断
左尿管結石性腎盂腎炎	結石性腎盂腎炎	小指中手骨遠位端開放骨折
イレウス気味	偽性イレウス	急速進行性びまん性管内増殖性糸球体腎炎
筋力低下可能性	筋力低下	腓骨近位部悪性骨腫瘍
咽喉頭違和感	咽喉頭異常感症	副鼻腔ポリープ
前立腺癌死	前立腺癌	アメーバ性非赤痢性大腸炎
再度皮疹	発疹	腋窩圧挫傷
左肩腱板損傷	肩腱板損傷	スパスムス・ヌータンス
低形成	骨髄低形成	Ｔリンパ芽球性白血病
再脱臼	脱臼	病的酩酊
左肺動脈狭窄症	肺動脈狭窄症	特発性下垂体機能低下症
肺動脈弁上狭窄	肺動脈弁上狭窄症	無造影腎
後頸部発赤	発赤	胎向異常新生児
血管原性浮腫	浮腫	足底部第１度熱傷
偽粘液腫	粘液腫	大腿切断術後
毛包向性菌状息肉症	菌状息肉症	急性非化膿性中耳炎
Ｂｌｕｅ　ｔｏｅ　ｓｙｎｄｒｏｍｅ	末梢動脈疾患	上顎歯牙腫
嚢胞様腫瘤像	腫瘤	粘液脂肪腫
右足不随意運動	不随意運動症	距骨腫瘍
婦人科癌	癌	コクサッキーウイルス心内膜炎
両側眼振	眼振	月経随伴性気胸
爪水虫	爪白癬	肋骨弓部挫傷
子宮体癌Ｉａ期	子宮体癌	腹壁蜂巣炎
過活動型せん妄	せん妄	鼻壊疽
左下肢鬱滞性皮膚炎	うっ滞性皮膚炎	心因性舌痛症
ＢＰＳＤ	認知症に重なったせん妄	手骨開放骨折
進行性核上麻痺	進行性核上性麻痺	耳管癌
汎発性水痘感染症	水痘	誇大妄想
えん下障害	嚥下障害	足背ボーエン病
左上腕悪性黒色腫	上腕部悪性黒色腫	晩期梅毒性滑液包炎
左側頭葉挫傷	脳挫傷	鼻部母斑細胞母斑
虚血性肝炎	肝炎	噴門部潰瘍
重症敗血症	敗血症	先天性感染
幽門前部狭窄	幽門狭窄症	間脳症
圧迫移植部ネクローシス	壊死	筋炎
子宮頸癌子宮頚癌	子宮頚癌	ビタミンＢ群欠乏症
舌乾燥	口腔乾燥症	小児丘疹性先端皮膚炎
足痛い	足痛	ピーナッツアレルギー
円形紅斑	紅斑症	異常体重増加
左眼後発性白内障	白内障	疼痛
徐脈気味	徐脈	播種性結核
境界性パーソナリティ障害	境界型パーソナリティ障害	広場恐怖症
鼻骨折	鼻骨骨折	レジン前装金属冠破損
膵尾部腫瘤性病変	膵腫瘤	顔面播種状粟粒性狼瘡
重症腸炎	腸炎	内臓リーシュマニア症
左大腿骨転子下骨折	転子下骨折	水晶体コロボーマ
左低形成腎	低形成腎	人工妊娠中絶の不成功
肺野すりガラス状陰影	肺野異常陰影	興奮型痴愚
アテローム性血栓性脳梗塞	血栓性脳梗塞	寛骨臼骨若年性骨軟骨症
結腸癌肝転移	転移性肝癌	示指悪性黒色腫
診察時皮疹	発疹	老人性貧血
切開関連性心房粗動	心房粗動	気管支真菌症
硬性白斑	白斑	潰瘍性大腸炎再燃
術後不整脈	不整脈	流産後卵管卵巣炎
広範囲脊柱管狭窄症	広範脊柱管狭窄症	母指腫瘤
中～低分化肝細胞癌	肝細胞癌	子宮内膜腺様のう胞性増殖症
起床時咳嗽	咳	腓腹筋痛
腰骨骨折	腰椎骨折	耳介挫傷
血性腹水貯留	腹水症	性器発育異常
心理的不安	不安障害	重複精管
カンジダ肺炎	肺カンジダ症	心臓挫傷・胸腔に達する開放創合併なし
右小細胞癌	小細胞肺癌	粘膜下腫瘍
頬部悪性腫瘍	頬部腫瘍	腓骨近位端骨折
多源性ＰＶＣ散発	心室期外収縮	陥没骨折
原発性甲状腺機能低下	甲状腺機能低下症	男性性器異常
ヨードアレルギー	ヨード過敏症	多発梗塞性認知症
右ＩＣ動脈瘤	内頚動脈脳動脈瘤	股関節滑液包炎
顔面形成	顔面形成異常	椎骨動脈血行不全
活動性肝炎	肝炎	１型糖尿病性壊疽
インフルエンザ陽性	インフルエンザ	のぼせ
眼球結膜浮腫	結膜浮腫	鼻部咬創
排便なし	便秘症	頭頂葉腫瘍
全身性Ｃａｎｄｉｄａ感染症	カンジダ症	誇大妄想
顔面神経痛	三叉神経痛	フューム肺炎
多発肺膿瘍	肺膿瘍	先天性耳管異常
疣贅様構造物	疣贅	肛門括約筋不全
アルコ−ル性肝硬変	肝硬変症	スチル病
皮質層状壊死	壊死	背部皮膚潰瘍
発熱随伴症状	発熱	腸管運動障害
急性肺動脈血栓塞栓症	肺動脈血栓塞栓症	急性歯髄炎
両下肢深部静脈血栓症	下肢静脈血栓症	奇静脈肺葉
右上腕骨近位端骨折	上腕骨近位端骨折	血小板減少症
脳炎脳症	脳症	項部筋肉痛
辺縁性脳炎	脳炎	感染性外耳炎
易疲労性強い	易疲労感	ピルビン酸脱水素酵素複合体欠損症
せん妄生	せん妄	２型自己免疫性膵炎
右第３趾爪囲炎	爪囲炎	一過性菌血症
多発縦隔リンパ節転移	縦隔リンパ節転移	ＭＲＣＮＳ敗血症
家族性ＣＪＤ	家族性クロイツフェルト・ヤコブ病	乳糖不耐性下痢症
圧迫時疼痛	疼痛	びまん性汎細気管支炎
症型Ａ群溶連菌感染症	溶連菌感染症	手指振戦
末梢肺動脈塞栓症	動脈塞栓症	急性歯髄炎
歩容困難	歩行障害	子宮広間膜裂孔ヘルニア嵌頓
脳室出血	出血	小指膿瘍
顔面痺れ	しびれ感	沈下性気管支炎
尿失禁状態	尿失禁症	中毒性肝障害
重度失調性構音障害	構音障害	胸部挫滅
卵巣癌Ⅲｃ期	卵巣癌	乳房脂肪肉腫
低血糖鞘状	低血糖	多発性後部色素上皮症
発赤潰瘍	発赤	内頚動脈瘤
左下肺浸潤影	肺部異常陰影	前大脳動脈解離
右大脳動脈未破裂動脈瘤	脳動脈瘤	頭部多発割創
失語正常	失語症	皮膚硬結
先週頭痛	頭痛	盲腸周囲ヘルニア
ｃｅｌｌ　ｌｅｕｋｅｍｉａ	白血病	中指マレット指
失語持続	失語症	リテイナー脱離
ＧＣＡ	巨細胞動脈炎	脛骨腓骨骨幹部骨折
大動脈弁硬化症	大動脈弁狭窄症	手指神経損傷
多発筋炎	多発性筋炎	大腿骨骨幹部開放骨折
呼吸促迫症状	呼吸促迫	術後てんかん
大腿骨骨頭壊死	大腿骨頭壊死	トリソミー１３
呼気喘鳴	喘鳴	円板状外側半月板
サイトメガロ網膜炎	サイトメガロウイルス網膜炎	下肢出血斑
ＡＣＴＨ非依存性Ｃｕｓｈｉｎｇ症候群	クッシング症候群	上顎歯牙腫
次週左気胸	気胸	ターナー症候群４６ＸＹ
内分泌機能不全	内分泌機能異常	閉鎖性肺挫傷
熱	発熱	腸管運動障害
Ｍａｌｌｏｒｙ−Ｗｅｉｓｓ症候群	マロリ・ワイス症候群	上顎歯牙腫
軽度音声障害	音声障害	着衣失行
緑膿菌腸炎	緑膿菌性腸炎	外陰ポリープ
ドレーン出血	出血	顎関節部裂創
副鼻腔転移	副鼻腔癌	全身痙攣発作
原発不明癌頸部転移	原発不明癌	肺毛細血管腫症
発熱中	発熱	腸管運動障害
再発腫瘤	腫瘤	大腿部外傷性骨化性筋炎
右錐体路障害	錐体路障害	脳卒中後片麻痺
犬吠様咳嗽	咳	弁膜閉鎖不全症
両下肢筋痛	下肢筋肉痛	高線維素血症
左室ブロック波形	心電図異常	過敏性腸症候群
有痛性腫瘤	腫瘤	大腿部外傷性骨化性筋炎
難治性冠攣縮性狭心症	冠攣縮性狭心症	韓国型出血熱
起床時頭痛	頭痛	上小脳動脈閉塞症
Ⅱ型房室ブロック	房室ブロック	心臓移植不全
眼白内障	白内障	先天性のう胞性腺腫様形成異常
慢性下気道感染	急性気管支炎	ミトコンドリア糖尿病
乳頭様腎盂腫瘍	腎盂乳頭状癌	腺熱リケッチア症
喀痰付着	喀痰	空隙歯列弓
両側下腿潰瘍	下腿皮膚潰瘍	唾液腺腫瘍
心肺停止後蘇生	心肺停止	手部淡明細胞肉腫
ＳＣＤ	脊髄小脳変性症	手骨開放骨折
無症候性腸アメーバ症	腸アメーバ症	頭頂葉血管腫
手首痛	手部痛	ピーナッツアレルギー
頸部食道癌	頚部食道癌	癒合椎
症候性てんかん発症	症候性てんかん	腹腔内遊離体
左腎血管腫	腎血管腫	ＰＶシャントカテーテル腹腔内逸脱
地誌的失認	失認	１型糖尿病・腎合併症あり
命令性幻聴	幻聴	毛包母斑
子宮体癌Ⅱ期	子宮体癌	腹壁蜂巣炎
両側副腎腫瘍	副腎腫瘍	しぶり腹
左顔面神経麻痺症状	顔面神経麻痺	先天性前腕変形
左顔面痛覚障害	片側痛覚鈍麻	腸骨稜棘
顎部痛	顎痛	上腕神経叢転位
元々疼痛	疼痛	大転子骨折
粘膿性鼻汁	鼻汁	腎外傷
膣原発横紋筋肉腫	横紋筋肉腫	続発性脳炎
卵巣嚢腫ＯＰ	卵巣のう腫	思春期出血
遅発性ペースメーカー感染症	ペースメーカ植え込み後感染症	コレステロールエステル蓄積症
子宮筋肉腫	子宮肉腫	後大脳動脈血栓症
肺血管陰影増強	肺血管疾患	乳房咬創
頭頸部放線菌症	放線菌症	慢性尿路感染症
腎機能障害	腎機能低下	前腕ガングリオン
Ｈｏｄｇｋｉｎ　Ｌｙｍｐｈｏｍａ	ホジキンリンパ腫	悪性小脳腫瘍
冠動脈−肺動脈瘻	肺動脈瘻	過剰性欲
嚥下時疼痛	嚥下痛	インフルエンザ性喉頭炎
術後創感染	術後膿瘍	三叉神経過敏症
大腸ポリープ後	大腸ポリープ	全子宮内反症
右下葉扁平上皮癌	下葉肺扁平上皮癌	急性冠症候群
咳嗽法	咳	腓腹筋痛
高リスク前立腺癌	前立腺癌	動揺手指関節
門脈圧亢進	門脈圧亢進症	シルビウス裂くも膜のう胞
認知面低下	軽度認知障害	尺骨遠位端骨折
ノカルジア	ノカルジア症	頭蓋底脳瘤
右人工膝関節感染	人工膝関節感染	慢性後天性赤芽球ろう
膿梗塞	脳梗塞	皮膚付属器腫瘍
下大静脈狭窄	大静脈狭窄症	アフタ性咽頭炎
十二指腸穿通性潰瘍	穿通性十二指腸潰瘍	前頭葉退形成性乏突起膠腫
左横隔膜弛緩症	横隔膜弛緩症	１７α−水酸化酵素欠損症
火傷	熱傷	心筋変性症
入眠困難感	不眠症	大腿骨顆上開放骨折
非定型カルチノイド腫瘍	カルチノイド	乾癬性関節炎
軽度食欲低下	食欲不振	肺結核後遺症
尿管結石有	尿管結石症	心因性生理的機能低下
両下腿壊疽性膿皮症様潰瘍	膿皮症	屈曲性対麻痺
冠攣縮型狭心症	冠攣縮性狭心症	韓国型出血熱
恥骨骨髄炎	骨髄炎	デュアン眼球後退症候群
かすみ目	視力低下	若年高血圧症
眩暈消失	めまい	ＨＴＬＶ−１感染症
手指関節腫脹	関節炎	片側性唇・粘膜下口蓋裂
ＳＰＮ	充実性偽乳頭状腫瘍	大動脈弁狭窄症兼肺動脈弁閉鎖不全症
夜間嘔気	嘔気	網膜膠腫
左足背発赤	下腿発赤	胎向異常新生児
女性器クラミジア感染症	クラミジア感染症	頬部血管肉腫
血液凝固障害	血液凝固異常	Ｖ型歯列弓
慢性的な呼吸困難	呼吸困難	鎖骨肩峰部骨折
右肺下葉肺炎	肺炎	胆泥
低酸素虚血性脳症	低酸素性脳症	上交叉性片麻痺
左大葉性肺炎	大葉性肺炎	臍ヘルニア嵌頓
膵臓癌術後再発	膵癌	脊椎骨折
足底湿疹	足湿疹	内反小趾
歩行ふらつき	めまい	慢性片頭痛
結腸縫合不全	縫合不全	劇症型心筋炎
多発肝血管腫	多発性肝血管腫	多血症
紅色腫瘤	腫瘤	軟性線維腫
気管支閉鎖症	気管支閉鎖	紡錘状脳動脈瘤
神経アミロイドーシス	アミロイドーシス	ヒトメタニューモウイルス感染症
夜疼痛	疼痛	大転子骨折
咽頭粘膜発赤	発赤	足底多汗症
時々不整脈	不整脈	体重減少性無月経
多発性リンパ節転移	多部位リンパ節転移	チャンス骨折
新生児死亡	原因不明の死亡	暴力行為
最近花粉症	花粉症	橈骨遠位端粉砕骨折
食道空腸吻合部狭窄	吻合部狭窄	鎖骨下動脈閉塞症
クリオグロブリン性血管炎	クリオグロブリン血症性血管炎	大動脈弁閉鎖症
右頬部擦過傷	頬部擦過創	新生児紅斑
右肺下葉癌	下葉肺癌	強度近視
腎結石多発	腎結石症	結膜脂肪斑
ＥＢウイルス初感染	ＥＢウイルス感染症	痙性扁平足
外表奇形	奇形	炎症性眼窩うっ血
急性膵臓炎	急性膵炎	皮膚粘膜リーシュマニア症
Ｉｓｐポリープ	大腸ポリープ	頭部損傷
咽頭部発赤	発赤	足底多汗症
頭部腫瘍	頭部皮下腫瘍	髄膜炎菌性心筋炎
遅発性発疹	発疹	尿中ステロイド上昇
肺炎悪化	肺炎	陰茎癌
朝痰	喀痰	肉芽腫性鼻炎
子宮体癌Ⅳ期	子宮体癌	腹壁蜂巣炎
骨外腫瘤形成	腫瘤	良性黒色表皮腫
低悪性度Ｂ細胞性リンパ腫	びまん性大細胞型Ｂ細胞性リンパ腫	結核性腹水
視神経脊髄炎（ＮＭＯ）	視神経脊髄炎	皮膚良性リンパ腺腫症
左下副甲状腺腺腫	副甲状腺腺腫	夜間狭心症
単形性ＶＴ	非持続性心室頻拍	中大脳動脈塞栓症
特発性心室細動	心室細動	陰のう良性腫瘍
高脂血症高脂血症	高脂血症	次亜塩素酸ナトリウム中毒
白色調腫瘍	腫瘍	抜歯後感染
左頬部有棘細胞癌	頬部有棘細胞癌	先天性点状白内障
Ｇｏｔｔｒｏｎ徴候	ゴットロン丘疹	上顎歯牙腫
脊柱起立筋膿瘍	筋膿瘍	頭部膿痂疹性湿疹
左踵骨骨折	踵骨骨折	二次性甲状腺機能低下症
胃癌幽門狭窄	幽門狭窄症	慢性リンパ性白血病
拡張能障害	心不全	接合部調律
小腸静脈瘤破裂	食道静脈瘤破裂	原発性全身性関節症
右上肢振戦	一側上肢振戦	化膿性扁桃周囲炎
中枢性甲状腺機能低下症	甲状腺機能低下症	男性性器異常
左肺動脈閉塞	肺動脈狭窄症	脳幹梗塞・慢性期
単純性網膜症	網膜症	頚椎分離症
両眼性複視	複視	腎動脈血栓症
Ｈｅｎｏｃｈ−Ｓｃｈｏｎｌｅｉｎ紫斑病	ＩｇＡ血管炎	上顎歯牙腫
右胸腔内腫瘍	腫瘍	耳介欠損
尿もれ	尿失禁症	気道熱傷
下肢筋力低下自覚	筋力低下	陰茎悪性黒色腫
右足静脈瘤	静脈瘤	気管支漏
上気道浮腫	咽頭浮腫	喉頭蓋軟骨膜炎
複雑型熱性痙攣	熱性痙攣	仙椎神経根損傷
吻合部浮腫	浮腫	外耳道癌
右膀胱側壁部膀胱癌	膀胱側壁部膀胱癌	骨萎縮
Ｃａｐｎｏｃｙｔｏｐｈａｇａ　ｃａｎｉｍｏｒｓｕｓ感染症	グラム陰性菌感染症	根面板破損
子宮頸部頸管狭窄	子宮頚管狭窄症	反抗挑戦性障害
呼吸喘鳴	喘鳴	円板状外側半月板
口腔内乾燥	口腔乾燥症	尿路性器はえ幼虫症
脊椎管狭窄症	脊柱管狭窄症	耳介開放創
ヘルペス髄膜炎	髄膜炎	頚部リンパ節結核
左股関節破壊	股関節症	パントテン酸欠乏症
左前庭障害	前庭障害	管状骨盤
膠原繊維性腸炎	腸炎	ばち指
食道期軽度障害	嚥下障害	腰椎神経根損傷
右外腸骨静脈狭窄	静脈狭窄	上口唇青色母斑
妊娠発覚	妊娠	一側下肢多発開放骨折
両膝関節症	膝関節症	膝関節腫瘍
類もやもや病	もやもや病	特発性頚椎硬膜外血腫
呼内疾患ベース肺炎	肺炎	頚部白癬
左足関節開放性脱臼骨折	足関節開放性脱臼骨折	喉頭蓋前面癌
白色粘性痰	喀痰	後天性腎のう胞
食道癌２病変	食道癌	反復性耳下腺炎
右卵巣奇形腫	卵巣奇形腫	アイゼンメンゲル症候群
感冒罹患	感冒	人工股関節感染
血腫像	血腫	頭頂部切創
ｌｙｍｐｈｏｍａ	悪性リンパ腫	混合型脳性麻痺症候群
左足首骨折	足関節骨折	アレルギー性膀胱炎
慢性血栓性肺高血圧症	慢性血栓塞栓性肺高血圧症	食道胃静脈瘤
眼振誘発	眼振	摂食機能障害
急性ウイルス性脳炎	ウイルス性脳炎	心膜液貯留
掻痒等	そう痒	脳幹部海綿状血管腫
労作時呼吸困難感軽度	労作時呼吸困難	ＭＰ関節痛
逆流性食道炎症状	逆流性食道炎	糖尿病性腎硬化症
非代償性Ｃ型肝硬変	Ｃ型非代償性肝硬変	上腕基底細胞癌
子宮筋腫大	子宮筋腫	頚椎椎体開放骨折
ヘルペス感染症	ヘルペスウイルス感染症	内反肘
抑うつあり	うつ状態	先天性胃変形
出血腫脹	出血	低２倍体性Ｂリンパ芽球性白血病
急性感音性難聴	感音難聴	口蓋ミオクローヌス
肺塞栓既往	肺塞栓症	総指伸筋腱脱臼
リンパ節多発転移	多部位リンパ節転移	中手骨良性腫瘍
ｉｎｖａｓｉｖｅ　ｔｈｙｍｏｍａ	悪性胸腺腫	ビタミン過剰症
イレウスリスク高い	イレウス	パラチフスＡ
左肺下葉扁平上皮癌	下葉肺扁平上皮癌	片側性完全唇裂
分類不能型免疫不全	免疫不全	自律神経過敏症
高度拘束性換気障害	拘束性換気障害	褥瘡・ステージＩＶ
非典型的胸痛	胸痛	腟損傷
ＭＲＳＡ感染	ＭＲＳＡ感染症	誇大妄想
肝多発腫瘤	肝腫瘤	環指切創
左大腿骨病的骨折	大腿骨病的骨折	くも膜のう胞
Ｓ状結腸癌術後肝転移	転移性肝癌	示指悪性黒色腫
棘波	心電図異常	歯科インプラント周囲炎
黄色痰自己喀出	膿性痰	空隙歯列弓
心膜腔内播種	転移性心腫瘍	脛骨顆剥離骨折
耳痛	耳痛症	晩期梅毒性視神経萎縮
四肢末端しびれ	しびれ感	術創部痛
内頸動脈狭窄	内頚動脈狭窄症	ネザートン症候群
胃部分壊死	壊死	肺欠損症
転倒受傷	外傷	小指腱鞘炎
左急性感音難聴	感音難聴	漏出性胸水
タール便少量	黒色便	慢性扁桃炎
切除不能胃癌	胃癌	腸間膜リンパ節腫脹
後頭葉脳出血	脳出血	トリニトロトルエン中毒
隅角結節	虹彩結節	ヒステリー性運動失調症
落ち着かなさ	多動性障害	有痛性拘縮
脊椎多発圧迫骨折	圧迫骨折	皮膚上皮内癌
左傍脊柱筋膿瘍	筋膿瘍	頭部膿痂疹性湿疹
Ⅰ型ＤＭ	糖尿病	乳糖不耐性下痢症
多発ＬＮ転移	多部位リンパ節転移	橈側手根屈筋腱断裂
右角膜ヘルペス	ヘルペス角膜炎	アデノウイルス脳脊髄炎
大腸粘膜癌	癌	慢性顎下腺炎
大動脈損傷	上大動脈損傷	高グリシン血症
仙骨前腫瘤	腫瘤	大転子開放骨折
前頭葉脳出血	脳出血	トリニトロトルエン中毒
社会不安症	不安神経症	全身性ジストニア
左頚部食道傍リンパ節転移	リンパ節転移	網膜色素上皮症
時折物忘れ	健忘症	外傷性多発性切断
左頬部未分化腺癌	癌	反射性瞳孔強直
ＩＩ型ＤＭ	２型糖尿病	乳糖不耐性下痢症
脊椎管狭窄	脊柱管狭窄症	銃創
膨満　グル音正常	腹部膨満	ヘパリン・コファクターＩＩ欠乏症
顔面神経麻痺静的再建	顔面神経麻痺	中等度知的障害・行動機能障害なしか最小限
低分化性扁平上皮癌	癌	急性冠症候群
左房内粘液腫	心臓粘液腫	ステロイド糖尿病・腎合併症あり
重症うつ病	うつ病	気管支良性腫瘍
左肺下葉浸潤影	胸部異常陰影	前大脳動脈解離
中葉舌区症候群	中葉無気肺	閉経後出血
膵管炎	膵炎	橈骨動脈損傷
軟部組織腫瘤	腫瘤	劇症型潰瘍性大腸炎
腫瘤構造	腫瘤	足関節偽痛風
慢性誤嚥	嚥下障害	第ＶＩＩ因子欠乏症
Ｇｍ敗血症	敗血症	直腸間葉系腫瘍
右大腿部蜂窩織炎	大腿部蜂巣炎	口唇粘液のう胞
病的腹水	腹水症	性器発育異常
慢性疲労	疲労感	潜水夫麻痺
膿性喀痰	膿性痰	後天性腎のう胞
Ｃｈｏｌｅｄｏｃｈｏｃｅｌｅ	総胆管のう腫	脛骨腓骨骨幹部骨折
癌再発	癌	アメーバ性非赤痢性大腸炎
胆汁うっ滞型	胆汁うっ滞	足関節部滑膜肉腫
肺門腫瘤	縦隔腫瘍	１型糖尿病性骨症
両膝関節疼痛	膝関節痛	アレキサンダー病
右鎖骨転移	骨転移癌	外傷性髄液鼻漏・頭蓋内に達する開放創合併なし
緑内症	緑内障	真性性腺欠如
夕方痛み	疼痛	流行性多発関節炎
左側副部痛	側腹部痛	頬部挫傷
後腹膜腫瘍上行結腸浸潤	後腹膜腫瘍	結節性紅斑
心窩部自発痛	心窩部痛	頭皮扁平母斑
リンパ節腫大傾向	リンパ節腫大	リンパ球性下垂体炎
時々尿失禁	尿失禁症	中毒性肝障害
左臀部悪性軟部腫瘍	殿部悪性軟部腫瘍	ツースポジショナー破損
低血糖遷延	低血糖	眼瞼脂肪腫
右中大脳動脈閉塞症	中大脳動脈閉塞症	尺側手根屈筋腱不全断裂
重症ＣＭＶ腸炎	サイトメガロウイルス腸炎	ばち指
発熱コントロール	発熱	腸管運動障害
右下腿蜂窩織炎	下腿蜂巣炎	軟産道伸展不良
膿瘍形成	膿瘍	アレナウイルス出血熱
右尿管損傷	尿管損傷	思春期性乳房肥大
感染性心内膜症	感染性心内膜炎	淋菌性子宮頚管炎
ブドウ球菌検出	ぶどう球菌感染症	ハングマン骨折
副腎皮質機能不全	副腎皮質機能低下症	頭部両大腿下腿打撲
Ｅｓｃｈｅｒｉｃｈｉａ　ｃｏｌｉ	大腸菌感染症	中指マレット指
両側網膜剥離	網膜剥離	骨性強直膝
播種性血管内凝固症	播種性血管内凝固	麻痺性側弯症
肺野肺門部異常陰影	肺門部異常陰影	脳室拡大
右房浸潤	乳房悪性腫瘍	肩関節唇損傷
屈筋腱鞘炎	腱鞘炎	子宮留膿症
肺結節陰影	胸部異常陰影	膵うっ血
呼吸困難感等自覚症状	呼吸困難	硬化性卵巣
原発性肺腫瘍	肺腫瘍	１型糖尿病合併妊娠
右下腿コンパートメント症候群	下腿コンパートメント症候群	扁平股
右鎖骨上窩リンパ節腫大	鎖骨上リンパ節腫脹	単純性肺好酸球増加症
右鼡径部腫脹	鼡径部腫脹	予防接種後感染症
低悪性度リンパ腫	ホジキンリンパ腫	ウイルス性心筋炎
右側胸部皮下結節	皮下結節	転移性上顎洞癌
両側卵巣チョコレート嚢胞	チョコレートのう胞	閉経後症候群
回盲部悪性リンパ腫	悪性リンパ腫	子宮性無月経
陰部腫脹	陰のう腫大	口唇創傷
腹水浸出	腹水症	表在性角膜炎
ＴＡＡ	胸部大動脈瘤	乳糖不耐性下痢症
腸管皮膚瘻	腸瘻	尿管膀胱移行部狭窄
ライン感染	カテーテル感染症	頚椎腫瘍
多発擦過傷	擦過創	大腿骨膿瘍
脂質異常	脂質異常症	小腸炎
肺嚢胞感染	肺のう胞	閉鎖性腎破裂
Ｃｈｕｒｇ−Ｓｔｒａｕｓｓ　症候群	好酸球性多発血管炎性肉芽腫症	上顎歯牙腫
脾結核	結核	悪性グルカゴノーマ
潰瘍性大腸炎急性増悪	潰瘍性大腸炎	筋強直性ジストロフィー
肺抗酸菌感染症	肺非結核性抗酸菌症	腋窩乳房
２型大腸癌	大腸癌	ブリッジ不適合
両眼網膜症	網膜症	頚椎分離症
左眼結膜炎	結膜炎	一側下肢多発骨折
右肺原発腺癌	肺腺癌	匙状爪
ＣＲＥＳＴ症候群	クレスト症候群	頚椎炎
感覚神経障害	知覚障害	特発性心筋炎
物忘れ	健忘症	鎖骨痛
脳筋症	ミトコンドリア脳筋症	胸部扁平母斑
駆細胞型急性リンパ性白血病再発	急性リンパ性白血病	滑液包炎
左大腿骨骨腫瘍	大腿骨腫瘍	陰部切創
膿瘍縮小	膿瘍	コカイン乱用
右後頭葉塞栓性脳梗塞	塞栓性脳梗塞	眼裂狭小
肝内転移	転移性肝腫瘍	急性硬膜外血腫
膵管内乳頭粘液腫瘍	膵管内乳頭粘液性腫瘍	内側半月のう腫
胃癌多発骨転移	胃癌骨転移	大腿静脈損傷
僧房弁疣贅	疣贅	趾捻挫
左膝窩動脈瘤	膝窩動脈瘤	良性家族性血尿
腹部背部痛	背部痛	足関節外果剥離骨折
アルコール性ニューロパチー	アルコール性多発ニューロパチー	下腿偽関節
体幹部発赤	発赤	左上大静脈遺残
慢性突発性血小板減少性紫斑病	血小板減少性紫斑病	肩母斑細胞母斑
下部消化管穿孔	腸穿孔	異所性褐色細胞腫
Ｔ字杖歩行可能	歩行障害	母指剥皮創
鎖骨上リンパ節腫大	鎖骨上リンパ節腫脹	単純性肺好酸球増加症
右大腿ヘルニア嵌頓	大腿ヘルニア嵌頓	肛門炎
大腫瘤影	腫瘤	ぶどう球菌性熱傷様皮膚症候群
双極２型障害	２型双極性障害	パラインフルエンザウイルス気管支炎
感染性腹部動脈瘤	感染性腹部大動脈瘤	皮質枝梗塞
ヘルペス性脳炎	サル痘	舌下腺膿瘍
不安症様	不安神経症	口腔ヘルペス
右前額部痛	前頭部痛	坐骨結節部打撲傷
右胸膜播種	胸膜播種	脛骨顆剥離骨折
骨折病変	骨折	殿部悪性末梢神経鞘腫
半月体形成糸球体腎炎	半月体形成性糸球体腎炎	難治性ネフローゼ症候群
筋力低下著明	筋力低下	腓骨近位部悪性骨腫瘍
下肢骨折	骨折	腎性骨異栄養症
付属器圧痛	圧痛	上腕部腫脹
アスピリンアレルギー	アスピリン不耐症	多発梗塞性認知症
固形腫瘍	腫瘍	筋の阻血性梗塞
嘔吐出現	嘔吐症	乳汁分泌抑制
統合失調症残遺状態	統合失調症	大胸筋炎
右上肢不全片麻痺	不全片麻痺	萎縮腎
低血糖生	低血糖	アレルギー性関節炎
劇症型肺炎球菌性敗血症	肺炎球菌性敗血症	コレステリン胸膜炎
左大腿蜂窩織炎	蜂窩織炎	口唇粘液のう胞
発熱有	発熱	腸管運動障害
頭位性回転性めま	体位性めまい	手指ひょう疽
不眠考	不眠症	頚部挫傷後遺症
全失語	全失語症	リテイナー脱離
口唇紅潮	紅潮	結腸間葉系腫瘍
開腹腫瘤	腫瘤	下歯槽神経麻痺
左尺骨神経障害	尺骨神経麻痺	潜函病性骨壊死
外側部乳癌	乳癌	肩関節捻挫
脳幹部神経膠腫	脳幹神経膠腫	三果骨折
両足関節以遠しびれ感	しびれ感	偽膜性扁桃炎
左再発性気胸	続発性気胸	解離性大動脈瘤ＤｅＢａｋｅｙＩＩ
胃のむかつき	悪心	上腕骨近位骨端線離開
気管性喘息	気管支喘息	妊娠性反復性黄疸
痒疹結節散在	痒疹	腰部脊髄症
日中下痢	下痢症	先天性卵巣奇形
骨粗鬆症有	骨粗鬆症	第４・５腰椎椎間板変性
先天性胆管欠損	胆管先天奇形	手指挫滅傷
左深部静脈血栓症	深部静脈血栓症	梅毒性心弁膜炎
冠性Ｔ波	心電図異常	サルコイド関節障害
多発胸膜肥厚斑	胸膜肥厚	重度知的障害
カンジダ眼内炎	眼内炎	足部裂創
副腎転移	転移性副腎腫瘍	後房の先天異常
左緊張性気胸	緊張性気胸	胸骨骨髄炎
度腟壁裂傷	腟裂傷	分娩予定日超過
仙骨部腫瘤	腫瘤	良性黒色表皮腫
帯状疱疹再燃	帯状疱疹	総頚動脈損傷
左前胸部腫瘤	前胸部腫瘤	ウェルシュ菌食中毒
喘息症状	咳喘息	発声困難
ふらつく気	よろめき歩行	急性多発性硬化症
拡張障害型心不全	心不全	大腿皮膚良性腫瘍
アカシジア症状	錐体路障害	頭蓋底脳瘤
間歇的腹痛	腹痛症	脳卒中後てんかん
左肺舌区扁平上皮癌	肺扁平上皮癌	口腔粘膜咬傷
星状細胞腫	星細胞腫	肝動脈門脈瘻
急性腎障害	腎障害	エンテロウイルス脳脊髄炎
左鎖骨上リンパ節腫脹	鎖骨上リンパ節腫脹	単純性肺好酸球増加症
陳旧性脳出血	脳出血	歯肉異物
良性下垂体腫瘍	下垂体腫瘍	食道表在癌
腸雑音聴取可	異常腸音	フランベジア性関節水症
左側頭部帯状疱疹	帯状疱疹	動眼神経不全麻痺
左肺原発性肺癌	原発性肺癌	匙状爪
頭蓋内出血性病変	非外傷性頭蓋内出血	毛包性ムチン沈着症
閉塞性睡眠呼吸障害	睡眠時無呼吸症候群	連鎖球菌性髄膜炎
右披裂部腫瘍	腫瘍	純粋性腺形成異常症
両膝変形	変形性膝関節症	歯根弯曲
表在性腫瘍	腫瘍	統合失調症型障害
左母指多指症	副母趾	手変形
両側側脳室軽度拡大	脳室拡大	持続性嘔吐による歯酸蝕症
脈性右室心筋症	不整脈原性右室心筋症	膝部軟部腫瘍
アルコール性末梢神経障害	アルコール性多発ニューロパチー	眼球陥没
縦隔炎併発	縦隔炎	異所性胃粘膜
暗紅色斑	紅斑症	先天性間葉芽腎腫
骨盤圧痛	骨盤痛	類鼻疽
骨巨細胞腫瘍	骨巨細胞腫	軟口蓋熱傷
Ｌａｎｇｈａｎｓ巨細胞	ランゲルハンス細胞組織球症	急性前壁心尖部心筋梗塞
気管支喘息発症	気管支喘息	妊娠性反復性黄疸
分葉状嚢胞性腫瘤	腫瘤	冠動脈バイパス術後
胆管拡張	胆管拡張症	意識障害
甲状腺肥大	甲状腺疾患	器質性気分障害
患肢発赤	発赤	左上大静脈遺残
好中球浸潤	好中球増加症	先天性肺動脈弁狭窄症
多房性腫瘤	腫瘤	重度知的障害・行動機能障害の言及なし
夜間不安	不安障害	重複精管
右上肢線状強皮症	線状強皮症	須毛毛瘡
左内耳障害	迷路障害	メージュ症候群
左耳介発赤	発赤	胎向異常新生児
朝方倦怠感	倦怠感	後腹膜気腫
後頚部脂肪腫	頚部脂肪腫	めまい症
副腎性クッシング症侯群	クッシング症候群	下顎骨周囲膿瘍
混合性アルカローシス	アルカローシス	頚部血管損傷
痛く	疼痛	腹壁挫傷
皮疹再燃	発疹	腋窩圧挫傷
再発悪性リンパ腫	悪性リンパ腫	ウイルス性心筋炎
子宮筋腫手術	子宮筋腫	卵巣発育不全
時折心窩部痛	心窩部痛	頭皮扁平母斑
右足根骨骨折	足根骨骨折	下咽頭炎
腕頭静脈血栓症	静脈血栓症	皮膚掌紋異常
脊椎病変	脊椎異常	亜急性関節炎
歯状核	歯状核赤核淡蒼球ルイ体萎縮症	腹膜悪性腫瘍
右脛骨骨幹部骨折	脛骨骨幹部骨折	ＶＡシャント機能不全
両側腎盂軽度拡張	腎盂拡張	産褥性乳汁分泌抑制
軽度屈曲拘縮	屈曲拘縮	フォンヒッペル・リンダウ病
左下肺野陰影	下肺野陰影	前大脳動脈解離
ＥＢＶ腸炎	細菌性腸炎	ばち指
左側舌癌	舌癌	回転性めまい
足しびれ	下肢しびれ	中脳水道先天異常
膵内分泌腫瘍肝転移	転移性肝癌	末梢自律神経ニューロパチー