出現形	正解	予測
痰貯留多	喀痰	過剰喀痰
皮膚リンパ腫	菌状息肉症	皮膚良性リンパ腺腫症
左大腿骨顆上骨折	大腿骨外顆骨折	大腿骨顆上骨折
病原性大腸菌Ｏ−１５７感染性腸炎	病原性大腸菌感染症	抗生物質起因性大腸炎
口腔粘膜浮腫	浮腫	内分泌性浮腫
腟粘膜発赤	発赤	扁桃瘢痕
閉塞性膵炎	膵炎	慢性膵炎
多発性脾膿瘍	脾膿瘍	多発性肝膿瘍
間質性肺水腫	肺水腫	急性肺水腫
舌扁平上皮癌	舌癌	舌上皮内癌
両側肺門部浸潤影	胸部異常陰影	下肺野陰影
脳障害	脳症	急性脳症
膵炎併発	膵炎	急性膵炎
ｈｅｍｏｐｈａｇｏｃｙｔｉｃ　ｓｙｎｄｒｏｍｅ	血球貪食症候群	ＨＤＬＳ
抗癌剤漏出	薬剤漏出性皮膚障害	抗癌剤漏出性皮膚障害
ｓｙｓｔｅｍｉｃ　ｍａｓｔｏｃｙｔｏｓｉｓ	肥満細胞腫症	ＡＩＤＳ
発汗多量	多汗症	発汗障害
会陰部発赤	発赤	下腿発赤
ＳＩＡＤ	抗利尿ホルモン不適合分泌症候群	ＡＩＤＳ
左後頭葉梗塞	脳梗塞	急性右室梗塞
大腸菌菌血症	菌血症	大腸菌感染症
右前頭葉出血	脳出血	前房出血
仙椎陳旧性骨折	陳旧性骨折	仙骨骨折
乳癌既往	乳癌	進行乳癌
下肢浮腫圧痕	下肢浮腫	上肢浮腫
心室中隔穿孔	心室中隔欠損症	鼻中隔穿孔
左下葉肺炎悪化	大葉性肺炎	急性肺炎
ぼんやり感持続	反応性低下	こわばり感
右鼠径部痛	鼡径部痛	前胸壁痛
皮疹不変	発疹	全身発疹
腸閉塞歴	イレウス	結腸閉塞
紅斑局面多発	紅斑症	多形紅斑
下部進行食道癌	食道癌	下部食道癌
無γグロブリン血症	無ガンマグロブリン血症	Ｘ連鎖無ガンマグロブリン血症
手首疼痛	疼痛	足痛
ｓｐｌｅｎｉｃ　ｍａｒｇｉｎａｌ　ｚｏｎｅ　ｌｙｍｐｈｏｍａ	脾辺縁帯リンパ腫	ＭＮＧＩＥ
体動時息ぎれ	労作時呼吸困難	関節あつれき音
一部浮腫	浮腫	足部浮腫
ふらつき注意	よろめき歩行	よろめき感
新出肝転移	転移性肝癌	肝移植後
脊椎カリエス	脊椎結核	脊椎カリエス後遺症
行動障害	素行障害	発動性障害
小豆大紅斑	紅斑症	多形紅斑
ＦＳＧＳ	巣状糸球体硬化症	ＨＤＬＳ
腹腔鏡補助下子宮筋腫核	子宮筋腫	壁内子宮平滑筋腫
後鼻汁症候群	後鼻漏	膿性鼻閉
糖尿病性腎症１期	腎性糖尿	１型糖尿病性腎症第１期
左前頭葉心原性脳梗塞	心原性脳塞栓症	心原性小脳梗塞
閉塞性尿路感染	尿路感染症	急性尿路感染
顔面蝶形紅斑	ＬＥ蝶形皮疹	多形紅斑
仙骨部色素沈着	色素異常症	歯の色素沈着
左肩痛み	肩部筋痛	肩部痛
ＰＳＶＴ発作	発作性上室頻拍	ＨＤＬＳ
ＤＭＮ　２期	糖尿病	ＭＮＧＩＥ
労作時胸部絞扼感	胸内苦悶	咽頭絞扼感
右膝変形	変形性膝関節症	足部変形
指趾潰瘍	趾皮膚潰瘍	趾難治性皮膚潰瘍
骨性腫瘤	腫瘤	骨腫瘤
下肢動脈瘤	下肢の動脈瘤	上肢動脈瘤
精神病様症状	精神病	症状精神病
項頸部痛	頚部痛	項部痛
頸部白斑	白斑	黄斑部白斑
左大腿骨転子部粉砕骨折	転子下骨折	大腿骨骨幹部粉砕骨折
最近眠気	非器質性過眠症	過眠
ＶＨＤ	心臓弁膜症	ＨＤＬＳ
重症肺血栓塞栓症	肺塞栓症	慢性肺血栓塞栓症
右乳突蜂巣	乳様突起炎	足蜂巣炎
右肺尖部気胸	気胸	部分無気肺
骨盤内子宮内膜症	子宮内膜症	骨盤子宮内膜症
局麻薬アレルギー	薬物過敏症	食物アレルギー
右肩関節亜脱臼半横指	肩関節亜脱臼	肩関節後方亜脱臼
慢性蕁麻疹	慢性じんま疹	非定型麻疹
高分化型漿液性腺癌	癌	卵巣漿液性腺癌
外側疼痛	疼痛	側胸部痛
卵巣癌再発卵巣癌	卵巣癌	再発卵巣癌
錐体路病変	錐体外路系疾患	錐体路障害
奬液性嚢胞腺腫	膵漿液性のう胞腺腫	卵巣漿液性腺腫
脳血栓塞栓症	脳血管閉塞性脳梗塞	血栓塞栓症
左リウマチ性肘関節症	関節リウマチ・膝関節	関節リウマチ・肘関節
右下腿潰瘍感染	下腿皮膚潰瘍	下腿難治性皮膚潰瘍
気分不快時	悪心	腹部不快感
脂肪性腫瘤	脂肪腫	皮下腫瘤
ウィルス性肺炎	肺炎	ウイルス性肺炎
類円形紅斑	紅斑症	多形紅斑
書字不能	書痙	書字障害
熱型	発熱	熱中症
骨盤内充実性腫瘍	骨盤腫瘍	骨盤内良性軟部腫瘍
両側角乾燥性結膜炎	結膜炎	乾性角結膜炎
微熱持続	微熱	持続熱
夕方浮腫	浮腫	顔面浮腫
眼性疲労	眼精疲労	疲労眼振
直腸肛門奇形	鎖肛	胃腸奇形
右大腿部腫瘍	大腿悪性軟部腫瘍	大腿軟部腫瘍
壊死性遊走性紅斑	遊走性紅斑	慢性遊走性紅斑
睡眠障害招くリスク	睡眠障害	睡眠リズム障害
上大静脈血栓	静脈血栓症	下大静脈血栓症
骨盤内ＬＮ転移	骨盤内リンパ節転移	骨盤転移
ＰＫＤ	多発性のう胞腎	ＨＤＬＳ
分水嶺脳梗塞	脳梗塞	脳幹梗塞
上皮性腫瘍	腫瘤	皮下腫瘍
大球性正色素貧血	大球性貧血	正球性正色素性貧血
肛門周囲びらん	外痔びらん	肛門部びらん
胸部不快	胸内苦悶	胸部不快感
下葉肺炎	肺炎	大葉性肺炎
右足根部粉砕骨折	粉砕骨折	上腕骨粉砕骨折
左大脳陳旧性ラクナ梗塞	陳旧性ラクナ梗塞	多発性ラクナ梗塞
出血多量	急性大量出血	多量出血
腸間膜リンパ管腫	リンパ管腫	腸間膜リンパ節腫脹
右乳腺線維腫症	線維腫	乳腺線維腫
肺野鬱血像	肺野異常陰影	肺野円形陰影
子宮頚上皮内癌	子宮頚部上皮内癌	子宮頚管上皮内癌
難治性非定型性抗酸菌症	非結核性抗酸菌症	ＨＩＶ非結核性抗酸菌症
湿疹様	湿疹	湿疹様発疹
大後頭孔狭窄	軟骨形成不全症	後鼻孔狭窄
熱型変化	発熱	不明熱
月経痛コントロール不十分	月経痛	スルーダー神経痛
右ＤＶＴ	深部静脈血栓症	ＨＤＬＳ
非特異的胸痛	胸痛	反復性胸痛
Ａｅｒｏｍｏｎａｓ　ｈｙｄｒｏｐｈｉｌａ敗血症	敗血症	ＭＲＳＡ敗血症
重症細菌性敗血症	敗血症	連鎖球菌性敗血症
腹直筋膜下血腫	筋肉内血腫	殿部筋肉内血腫
関連腎臓病	腎疾患	慢性腎臓病
高度大動脈弁狭窄	大動脈弁狭窄症	大動脈弁上狭窄症
左腰部疼痛	腰痛症	腰殿部痛
ＨＣＶ重複感染症	Ｃ型肝炎ウイルス感染	ＨＩＶ感染症
非ケトン性高血糖	高血糖高浸透圧症候群	ケトン性低血糖症
Ｙｅｒｓｉｎｉａ腸炎	エルシニア腸炎	ＭＲＳＡ腸炎
声帯浮腫	声帯炎	声門浮腫
咳嗽持続	咳	慢性咳嗽
左側下顎骨嚢胞	顎骨のう胞	上皮性顎骨のう胞
胆管閉鎖症	胆管閉塞症	胆道閉鎖症
シャント吻合部狭窄	透析シャント狭窄	吻合部狭窄
胸骨炎	胸骨周囲炎	胸骨骨髄炎
上肢疼痛	疼痛	上肢痛
Ｔｕｒｎｅｒ症候群	ターナー症候群	ＭＥＲＲＦ症候群
左心不全徴候	心不全	左心不全
ＩＰＭＮ癌化	膵管内乳頭粘液性腺癌	殿部基底細胞癌
後発頚部転移	頚部転移性腫瘍	頚椎転移
蜂窩肺形成	蜂窩織炎	先天性蜂巣状肺
右ＩＣＡ高度狭窄	内頚動脈狭窄症	右室流出路狭窄
膵体部嚢胞	膵のう胞	膵管内管状腫瘍
無症候性ＶＴ	心室頻拍	低Ｔ３症候群
口腔清掃	個人衛生の著しいレベル低下	口腔乾燥症
無石性胆嚢炎	胆のう炎	無症候性原発性胆汁性胆管炎
残像腫瘍	腫瘍	松果体腫瘍
夜間中途覚醒時	睡眠障害	夜間異常知覚症
右母指多指症	多指症	重複母指
薬剤性骨髄抑制	骨髄機能低下	薬剤性骨軟化症
中枢神経悪性リンパ腫再発	悪性リンパ腫	中枢神経系原発びまん性大細胞型Ｂ細胞性リンパ腫
旅行者下痢症	下痢症	習慣性下痢
非Ｂ非Ｃ型肝硬変	肝硬変症	Ｂ型肝硬変
足がむくみ	下肢浮腫	ざんごう足
難治性浮腫	高度浮腫	特発性浮腫
Ｇｒａｎｕｌｏｍａｔｏｓｉｓ　ｗｉｔｈ　ｐｏｌｙａｎｇｉｉｔｉｓ	多発血管炎性肉芽腫症	ＡＩＤＳ
未分化癌	癌	食道未分化癌
両側副腎悪性リンパ腫	悪性リンパ腫	ＮＳＡＩＤ腎症
左膝痛み	膝関節痛	膝窩部痛
炎症性貧血	貧血	症候性貧血
両下肢掻痒感	皮膚そう痒症	老年性そう痒症
右後頭葉脳挫傷	脳挫傷	脳幹挫傷
ｍａｓｓ　ｌｅｓｉｏｎ	腫瘤	ＡＩＤＳ
右大脳半球多発脳梗塞	多発性脳梗塞	多発性小脳梗塞
鎮静困難	興奮状態	鎮静薬による急性精神・行動障害
再発腫瘤近傍	腫瘤	化膿性腫瘤
切除不能多発性肝転移	転移性肝腫瘍	肝移植不全
腹腔内膿瘍形成	膿瘍	腹腔内膿瘍
リンパ腺腫脹	リンパ節腫大	皮膚良性リンパ腺腫症
疼痛時頓用	疼痛	慢性疼痛
多房性膿瘍	膿瘍	水晶体膿瘍
右耳介後部痛	耳痛症	耳下部痛
無呼吸症候群	無呼吸発作	重症急性呼吸器症候群
出血過多	出血	多量出血
甲状腺嚢腫	甲状腺のう胞	甲状腺腫
覚醒度	麻酔覚醒遅延	温度感覚異常
有意弁膜症	弁膜炎	連合弁膜症
右下肺野無気肺	無気肺	上葉無気肺
小脳性失調	小脳性運動失調症	急性小脳性失調症
主幹動脈狭窄	脳動脈狭窄症	動脈狭窄
創部皮下血腫	外傷性皮下血腫	頭部皮下血腫
掻痒感軽減	そう痒	症候性そう痒症
両肺小結節影	肺野異常陰影	肺野円形陰影
造影剤アレルギー歴	薬物過敏症	刺虫アレルギー
慢性的な抑うつ気分	うつ状態	気うつ
鼻部異物肉芽腫	皮膚異物肉芽腫	異物肉芽腫
遠隔ＬＮ転移	リンパ節転移	ＨＤＬＳ
睾丸腫脹	精巣腫脹	鼡径部腫脹
脳実質外腫瘍	腫瘍	脳室内腫瘍
抑鬱感	気うつ	倦怠感
扁桃腺腫大	扁桃肥大	扁桃腫瘍
噴門部狭窄	胃狭窄	噴門狭窄
突発性腎出血	腎出血	特発性腎出血
傍大動脈ＬＮ	大動脈周囲リンパ節転移	解離性大動脈瘤ＳｔａｎｆｏｒｄＡ
左椎骨動脈低形成	骨髄低形成	椎骨動脈血行不全
左房拡張	心拡大	胃拡張
化学物質アレルギー	アレルギー	食物アレルギー
皮膚硬化がまだかなり	新生児皮膚硬化症	皮膚形成異常
口腔内乾燥軽度	口腔乾燥症	口内乾燥
蠕動不良	異常腸音	発動性障害
黒色丘疹	丘疹	紅色丘疹
クモ膜下嚢胞	くも膜のう胞	口腔類表皮のう胞
Ｈａｅｍｏｐｈｉｌｕｓ　ｉｎｆｌｕｅｎｚａｅ敗血症	敗血症	ＭＲＳＡ敗血症
右上葉原発肺小細胞癌	小細胞肺癌	上葉肺大細胞癌
出血源不詳	出血	不正性器出血
浸潤癌化所見	癌	殿部基底細胞癌
痔核脱出	痔核	脱出性内痔核
重症膵炎	膵炎	重症急性膵炎
痛みアリ	疼痛	鈍痛
右足疼痛	疼痛	足痛
増殖前網膜症	網膜症	増殖性網膜症
小腸膀胱瘻	膀胱皮膚瘻	回腸膀胱瘻
少量左胸水	胸水貯留	血性胸水
多発ＨＣＣ再発	肝細胞癌	ＬＨ単独欠損症
結核性嚢腫	結核	結核腫
大腿腫脹	下腿腫脹	大腿部腫脹
全身性ＣＭＶ感染症	サイトメガロウイルス感染症	ＭＲＣＮＳ感染症
多発肝内転移	転移性肝腫瘍	転移性肝癌
両下肢圧痕性浮腫	クインケ浮腫	上肢浮腫
下部腸間膜動脈出血	動脈性出血	腸間膜動脈血栓症
ＩｇＭ型Ｍ蛋白	単クローン性免疫グロブリン血症	ＨＨＶ８多中心性キャッスルマン病随伴大細胞型Ｂ細胞性リンパ腫
喘息発作様症状	気管支喘息発作	運動誘発性喘息
多少便秘気味	便秘症	習慣性便秘
全身皮膚発赤	発赤	下腿発赤
多発肺嚢胞	肺のう胞	肺胞蛋白症
口腔内びらん	口唇びらん	鼻腔内びらん
紅斑熱群リケッチア症	リケッチア感染症	ロッキー山紅斑熱
ＩＴＰ	特発性血小板減少性紫斑病	ＡＩＤＳ
解離性動脈瘤破裂	解離性動脈瘤	大動脈破裂
左眼窩内腫瘍	眼窩腫瘍	眼内腫瘍
肺外小細胞癌	小細胞肺癌	肺門部小細胞癌
ｂｒｅａｋｔｈｒｏｕｇｈ　ｈｅｐａｔｉｔｉｓ	肝炎	Ｅｕｔｈｙｒｏｉｄ　Ｓｉｃｋ症候群
左室圧排	右室肥大	門脈圧亢進症
飲みこみにくさ	嚥下障害	しゅさ
副腎ヒストプラズマ感染症	真菌症	ＨＢウイルス腎症
両松葉杖歩行	歩行障害	単眼症
冠動脈狭窄３枝病変	狭心症３枝病変	冠状動脈狭窄症
遺伝性低尿酸血症	低尿酸血症	無症候性高尿酸血症
小腸皮膚瘻	皮膚瘻	直腸皮膚瘻
重度僧帽弁狭窄症	僧帽弁狭窄症	先天性僧帽弁狭窄症
非細菌性血栓性疣贅	疣贅	化膿性疣贅
特発性腸間膜血腫	血腫	大腸血管腫
肝骨転移	骨転移癌	肝癌骨転移
乳腺線維腫症	線維腫	乳腺線維腫
術後左反回神経麻痺	反回神経麻痺	術後性反回神経麻痺
無症候性髄膜腫	髄膜腫	多発性髄膜腫
表皮内水疱形成	先天性表皮水疱症	栄養障害型表皮水疱症
後頚部圧痛	圧痛	頚背部痛
良性胆道狭窄	胆管狭窄症	術後胆管狭窄
ＣＫＤ　腎硬化症	腎硬化症	ＩｇＡ腎症
前頭葉出血	出血	前房出血
有茎性乳頭状腫瘍	腫瘍	乳房葉状腫瘍
理解困難	言語理解障害	特殊学習困難
スメア異常	腟スメア細胞診陽性	ＣＡＰＤカテーテル位置異常
腹腔内敗血症	敗血症	院内感染敗血症
過呼吸状態	過換気症	呼吸停止
右肺門部原発肺小細胞癌	小細胞肺癌	肺門部小細胞癌
胃癌骨髄癌腫症	骨髄転移	胃体部癌
眼乾燥感	ドライアイ	口唇乾燥
内側縦束症候群	核間性眼筋麻痺	延髄外側症候群
夜低血糖	低血糖	夜間低血糖症
左上下肢軽度麻痺	四肢麻痺	下肢麻痺
下肢痙性	痙性対麻痺	下肢痙攣
皮疹状況	発疹	ＬＥ皮疹
髄外形質細胞腫	骨外性形質細胞腫	形質細胞腫
ｍａｌｉｇｎａｎｔ　ｌｙｍｐｈｏｍａ	悪性リンパ腫	ＣＡＤＡＳＩＬ
重症ＡＧＨＤ	重症成人成長ホルモン分泌不全	高ＩｇＤ血症
湿疹性病変	湿疹	急性湿疹
手内筋萎縮	筋萎縮症	全身性筋萎縮
尾てい骨骨折	尾骨骨折	上腕骨らせん骨折
腓腹筋痙攣	痙攣	四肢筋痙攣
破壊性脊椎症	脊椎症	破壊性脊椎関節症
独歩不可	歩行障害	歩行困難
骨破壊進行	関節リウマチ	骨壊死
下肢白癬	白癬	四肢白癬
左鼓膜発赤	発赤	青色鼓膜
熱苦症状	発熱	熱疲労
シャイドレジャー症候群	シャイ・ドレーガー症候群	グッドパスチャー症候群
肺動脈弁閉鎖症	肺動脈弁閉鎖	肺動脈弁閉鎖不全症
脾摘施行Ｃ型肝炎	Ｃ型肝炎	Ｄ型肝炎
右肺上葉すりガラス影	胸部異常陰影	下肺野陰影
Ｆｏｌｌｉｃｕｌａｒ　ｌｙｍｐｈｏｍａ	濾胞性リンパ腫	ＣＡＤＡＳＩＬ
腫瘍性ＤＩＣ	線溶亢進	ＣＲＨ産生腫瘍
左肘関節亜脱臼	亜脱臼	手関節亜脱臼
左肺感染性嚢胞	肺のう胞	侵襲性肺炎球菌感染症
右足趾壊疽	下肢壊疽	足壊疽
残遺癌	癌	残胃癌
不安大きく	不安障害	不安うつ病
ＭＳ再発	多発性硬化症	ＨＤＬＳ
強直間代性痙攣発作	間代性痙攣	間代強直性痙攣
一過性意識消失発作	一過性脳虚血発作	部分的意識喪失
乳児白血病	白血病	乳児偽白血病
筋委縮	筋萎縮症	非定型筋萎縮症
左鼠経ヘルニア	鼡径ヘルニア	会陰ヘルニア
体幹掻痒感	そう痒	症候性そう痒症
糖尿病神経症	糖尿病性神経痛	糖尿病
古典的肝細胞癌再発	肝細胞癌	原発性肝癌
左室低形成	左心低形成症候群	右室低形成
劇症肝炎亜急性型	劇症肝炎	Ｅ型劇症肝炎
分岐部動脈瘤	内頚動脈後交通動脈分岐部動脈瘤	大動脈瘤
腫瘍感染	腫瘍	付属器腫瘍
悪性腫瘍スクリーニング	悪性腫瘍	悪性グロームス腫瘍
右踵骨折	骨折	踵骨骨折
ＰＰＨ	肺高血圧症	ＰＣＷＨ
子宮間質肉腫	肉腫	子宮内膜間質肉腫
右主気管支膜様部壊死	壊死	気管支損傷
右下肺野スリガラス影	胸部異常陰影	下肺野陰影
胆嚢腺扁平上皮癌	癌	上部胆管癌
突発性血小板減少性紫斑病	血小板減少性紫斑病	続発性血小板減少性紫斑病
意識変動	意識障害	意識消失
左閉鎖リンパ節転移	リンパ節転移	鎖骨上リンパ節転移
両側小脳梗塞	小脳梗塞	多発性小脳梗塞
左前腕浮腫	浮腫	上腕浮腫
赤紫斑	紫斑病	色素性紫斑
偽腔閉塞型大動脈解離	解離性大動脈瘤	腹腔動脈解離
高度感音性難聴	感音難聴	高度難聴
胆嚢腫瘍	胆のう腫瘍	胆管腫瘍
胃がん	胃癌	胃びらん
左中大脳動脈梗塞	中大脳動脈塞栓症	脳外主幹動脈閉塞脳梗塞
Ｓｏｔｏｓ症候群	ソトス症候群	ＳＡＰＨＯ症候群
挿入部出血	出血	口腔出血
多発性腎梗塞	腎梗塞	外傷性腎梗塞
変動一過性徐脈	徐脈	徐脈発作
四肢色素沈着	皮膚色素沈着	角膜色素沈着
三角圧痛	肩部筋痛	圧痛
乳癌局所再発	乳癌	乳癌再発
痛みきつい	疼痛	鈍痛
両側顎下腺腫大	顎下腺肥大	上口唇皮下腫瘍
日中下痢便	下痢症	食事性下痢
胸郭低形成	胸郭異常	胸郭変形
肺スリガラス陰影	胸部異常陰影	肺門部異常陰影
口蓋腫瘤	腫瘤	口腔内腫瘤
パーキンソン病関連疾患	パーキンソン病	若年性パーキンソン病
グラム陰性桿菌菌血症	グラム陰性桿菌敗血症	グラム陰性桿菌感染症
開腹子宮筋腫核	子宮筋腫	子宮有茎筋腫
白内障手術	白内障	白内障術後
直腸癌Ｒａ	直腸癌	ＫＲＡＳ遺伝子野生型直腸癌
カルボプラチンアレルギー	薬物過敏症	ラテックスアレルギー
肺原発ホジキンリンパ腫	ホジキンリンパ腫	肺ＭＡＬＴリンパ腫
循環障害	末梢循環障害	急性循環不全
重度精神運動発達遅滞	混合性特異的発達障害	自閉性精神発達遅滞
筋緊張高く	筋強直	筋緊張性障害
母指潰瘍治癒遅延	皮膚潰瘍	手指難治性皮膚潰瘍
歩行時呼吸困難感	労作時呼吸困難	呼吸困難
痰症状	喀痰	喀痰検査異常
腸管血流障害	末梢循環障害	腸管運動障害
全身性単純ヘルペスウイルス感染症	ヘルペスウイルス感染症	先天性ヘルペスウイルス感染症
劇症型腸アメーバ症	腸アメーバ症	慢性腸アメーバ症
不適応行動	適応障害	異常行動
緑色痰	喀痰	膿性痰
ポンプポケット内血腫	血腫	モンロー孔海綿状血管腫
尿量低下	乏尿	低張尿
むつかぶれ	おむつ皮膚炎	しびれ感
水平亜脱臼	亜脱臼	水晶体亜脱臼
早期癌	癌	末期癌
吻合部出血	出血	抜歯後出血
子宮頸がん	子宮頚癌	子宮頚部びらん
腺扁平上皮癌	癌	卵巣扁平上皮癌
喉頭蓋サルコイドーシス	サルコイドーシス	鼻腔サルコイドーシス
声門部狭窄	喉頭狭窄症	処置後声門下狭窄
頭蓋底髄膜腫	髄膜腫	中頭蓋窩髄膜腫
膵全体癌	膵癌	膵体部癌
両側血気胸	血気胸	外傷性血気胸
穿刺部位出血	出血	点状出血
手掌黄色腫	黄色腫症	手掌部悪性黒色腫
皮膚湿疹	湿疹	頭部湿疹
非吻合部多発胆管狭窄	胆管狭窄症	術後胆管狭窄
軽度肥満歴	肥満症	症候性肥満
左腎嚢胞不変	腎のう胞	膿腎症
軽度発赤腫脹	発赤	顔面腫脹
左手関節変形	変形性手関節症	股関節変形
蛋白尿（３＋）	蛋白尿	食事性蛋白尿
左手首痛	手部痛	手関節痛
続発性赤芽球癆	赤芽球ろう	慢性後天性赤芽球ろう
インフルエンザ菌	インフルエンザ	インフルエンザ菌感染症
左舌区小細胞癌	小細胞肺癌	下口唇基底細胞癌
成人発症Ｓｔｉｌｌ病（ＡＯＳＤ）	成人スチル病	ＣＡＤＡＳＩＬ
大球性正色素性貧血	正色素性貧血	正球性正色素性貧血
限局型全身性強皮症	全身性強皮症	限局性強皮症
Ｓ状結腸高分化腺癌	Ｓ状結腸癌	Ｓ状結腸神経内分泌細胞癌
両下肢痛み	疼痛	下肢痛
ＳＭＡ浸潤	膵癌	ＡＶＭ
微小癌	癌	非浸潤性小葉癌
慢性疼痛性障害	慢性疼痛	身体型疼痛障害
高Ｃｌ血症	高クロール血症	高ＬＤＬ血症
乳頭状腺癌	癌	甲状腺乳頭癌
帯状疱疹ウイルス脊髄炎	ウイルス脊髄炎	帯状疱疹性脊髄炎
内臓播種性ＶＺＶ感染症	汎発性帯状疱疹	ＨＴＬＶ−１感染症
様皮疹	発疹	ＬＥ皮疹
左帯状疱疹	帯状疱疹	眼部帯状疱疹
骨形成不全症Ⅲ型	骨形成不全症	骨形成不全症２型
高度肥満症	病的肥満症	肥満症
右前頭葉脳内血腫	血腫	外傷性脳内血腫
四肢関節腫脹	関節炎	足関節腫脹
右腸骨静脈血栓症	腸骨静脈圧迫症候群	腸骨動脈血栓症
眼瞼結膜軽度貧血	貧血	眼瞼結膜出血
子宮頸癌Ⅲｂ期	子宮頚癌	子宮頚部微小浸潤癌
肝内腫瘤性病変	腫瘤	肝腫瘤
ＡＳＤ	心房中隔欠損症	ＡＩＤＳ
緑膿菌肺感染症	緑膿菌肺炎	緑膿菌感染症
ふらつきあり転倒リスク高い	めまい	全身こむらがえり病
食道癌術後リンパ節転移	リンパ節転移	食道癌骨転移
亜急性期小脳梗塞	小脳梗塞	多発性小脳梗塞
喘息コントロール	咳喘息	アトピー性喘息
中高分化型腺癌	癌	前立腺小細胞癌
軽度脳梗塞	脳梗塞	小脳梗塞
神経根性痛	疼痛	神経痛
白色壊死組織付着	壊死	中毒性表皮壊死症
夜間中途覚醒	睡眠障害	夜間狭心症
軽度肺動脈弁狭窄	肺動脈弁狭窄症	肺動脈弁下狭窄症
無涙症	涙液分泌不全	症候性流涙症
ｃｒｉｔｉｃａｌ　ｉｌｌｎｅｓｓ　ｐｏｌｙｎｅｕｒｏｐａｔｈｙ	多発ニューロパチー	ＣＡＤＡＳＩＬ
水疱瘡	水疱症	水疱性類天疱瘡
軽度高Ｋ血症	高カリウム血症	高ＨＤＬ血症
水様便流出	下痢症	便潜血
浮腫傾向	浮腫	特発性浮腫
骨Ｐａｇｅｔ病	骨パジェット病	若年性骨パジェット病
Ｅｎｔａｍｏｅｂａ　ｈｉｓｔｏｌｙｔｉｃａ	アメーバ赤痢	ＣＡＤＡＳＩＬ
大腿筋横紋筋肉腫	横紋筋肉腫	大腿横紋筋肉腫
腸炎性関節炎	関節炎	腸チフス性関節炎
ＰＭＳ	月経前症候群	ＨＤＬＳ
腓腹部圧痛	腹部圧痛	腓腹部痛
非チフス性Ｓａｌｍｏｎｅｌｌａ菌血症	菌血症	一過性菌血症
微小多発肝膿瘍	肝膿瘍	多発性肝膿瘍
胸部大動脈解離	急性大動脈解離	慢性大動脈解離
輪状披裂関節炎	関節炎	輪状披裂関節捻挫
咽頭残留	嚥下障害	咽頭腐蝕
大量水様下痢	下痢症	食事性下痢
処方右乳癌	乳癌	進行乳癌
弧発性古典的ＣＪＤ	孤発性クロイツフェルト・ヤコブ病	ＡＩＤＳ
右大腿リンパ節転移	リンパ節転移	頚部リンパ節転移
左第３趾潰瘍	趾皮膚潰瘍	陰唇潰瘍
膝関節水腫	膝関節水症	肘関節水腫
好酸球性胆嚢炎	胆のう炎	急性胆細管炎
左下腿骨幹部骨折	骨折	大腿骨骨幹部骨折
ふらつき有	めまい	こむら返り
閉塞性睡眠時無呼吸症侯群	睡眠時無呼吸症候群	閉塞性睡眠時無呼吸
結核性ブドウ膜炎	結核性ぶどう膜炎	結核性硬膜炎
痙直型四肢麻痺	四肢麻痺	痙性四肢麻痺
角化性紅斑散在	紅斑症	環状紅斑
左側頭葉皮質化出血	出血	皮質脳内出血
右足底腱膜炎	足底筋膜炎	膝部腱膜炎
高～中分化型管状腺癌	癌	前立腺小細胞癌
Ｌａｍｉｖｕｄｉｎｅ耐性Ｂ型肝硬変	Ｂ型肝硬変	Ｂ型非代償性肝硬変
湿疹化	湿疹	急性湿疹
下肢対麻痺	対麻痺	下肢麻痺
脈管奇形	奇形	脳静脈奇形
可動時痛	疼痛	一次性運動時頭痛
痰がからみ	喀痰	過剰喀痰
朝出血	出血	後出血
右鼠経ヘルニア修復術	鼡径ヘルニア	非還納性腹壁瘢痕ヘルニア
腎前性脱水	脱水症	萎縮性水腎症
頸部皮下膿瘍	皮膚膿瘍	頚部膿瘍
ウイルス性感冒	感冒	ウイルス感染症
腹部自発痛	腹痛症	側腹部痛
中分化型前立腺癌	前立腺癌	前立腺小細胞癌
褥瘡形成リスク高い	褥瘡	褥瘡・ステージＩ
手術高血圧	高血圧症	術中異常高血圧症
嚥下下困難	嚥下障害	嚥下困難
てんかん脳波	異常脳波	脳卒中後てんかん
巨大血腫	血腫	巨大産道血腫
腹水多量貯留	腹水症	胸水貯留
ＣＭＶ胃腸炎	サイトメガロウイルス腸炎	ＭＲＳＡ腸炎
瘢痕痙性	瘢痕	萎縮性瘢痕
両Ｔ字杖歩行	歩行障害	内転歩行
便性状変化	便異常	排便習慣の変化
右血栓閉塞	血栓塞栓症	冠状動脈血栓塞栓症
出血付着程度	出血	点状出血
右海綿静脈洞髄膜腫	髄膜腫	海綿静脈洞部海綿状血管腫
虚血性心疾患合併	虚血性心疾患	急性虚血性心疾患
壊死性筋炎	筋炎	壊死性筋膜炎
両下腿紅斑	紅斑症	手掌紅斑
低Ｃａ血症	低カルシウム血症	高ＩｇＤ血症
二次性副腎不全	副腎クリーゼ	慢性腎不全
一週間程度眠気	非器質性過眠症	過眠
子宮内腔癒着	子宮内膜症	子宮付属器癒着
右母指陳旧性尺側側副靱帯損傷	靱帯損傷	母指ＭＰ関節尺側側副靱帯損傷
皮膚型ＰＮ	結節性多発動脈炎	ＭＮＧＩＥ
副鼻腔軽度粘膜肥厚	副鼻腔炎	滑膜肥厚
昨晩低血糖	低血糖	夜間低血糖症
前回貧血	貧血	慢性貧血
骨粗鬆症性圧迫骨折	骨粗鬆症・病的骨折あり	脊椎圧迫骨折
右肺原発肺腺癌	肺腺癌	肺門部肺癌
脊髄原発悪性リンパ腫	悪性リンパ腫	頚部悪性リンパ腫
手指浮腫	浮腫	足部浮腫
皮質性認知症	皮質下認知症	皮質認知症
後縦隔腫瘤	縦隔腫瘍	横隔膜腫瘤
頚椎症性脊椎症	脊椎症	頚椎症性脊髄症
中部延髄右外側脳梗塞	脳梗塞	急性下側壁心筋梗塞
仙骨部瘻孔	難治性瘻孔	術後瘻孔形成
右傍気管リンパ節転移	リンパ節転移	気管支リンパ節転移
ｓｍａｌｌ　ｃｅｌｌ　ｃａｒｃｉｎｏｍａ	癌	ＣＡＤＡＳＩＬ
遺伝性出血性毛細血管拡張症	オスラー病	毛細血管拡張症
間質性肺炎評価	間質性肺炎	特発性間質性肺炎
右肺門部原発	原発性肺癌	肺門部異常陰影
瘢痕様変化	瘢痕	肥厚性瘢痕
元々頻尿	頻尿症	希釈尿
浮腫対策	浮腫	特発性浮腫
核下性顔面神経麻痺	顔面神経麻痺	中枢性顔面神経麻痺
皮膚原発悪性リンパ腫	悪性リンパ腫	皮膚Ｔ細胞リンパ腫
乾性咳嗽頻回	乾性咳	慢性咳嗽
首痛	頚部痛	足痛
右側頭部紫斑	紫斑病	側頭部青色母斑
薬剤過敏性症候群	薬物過敏症	薬剤性過敏症症候群
紫斑形成軽度	紫斑病	色素性紫斑
子宮筋腫核出後妊娠	妊娠	子宮頚部腫瘍合併妊娠
ＡＲＤＳ合併	急性呼吸窮迫症候群	ＡＩＤＳ
軟骨損傷	肋軟骨損傷	鎖骨損傷
右副腎原発	副腎腫瘍	副腎異常
ｋｌｅｂｓｉｅｌｌａ　ｐｎｅｕｍｏｎｉａｅ感染症	クレブシェラ属感染	ＢＬＮＡＲ感染症
めまい軽度	めまい	めまい症
右横隔膜筋欠損	筋欠損	横隔膜欠損
脳症後遺症	脳症	脳手術後遺症
漿膜損傷	損傷	硬膜損傷
ふらつき目立	めまい	顔面せつ
近位筋痛	筋肉痛	肩部筋痛
ノカルジア脳膿瘍	ノカルジア症	フェオミコーシス性脳膿瘍
右前腕皮疹	発疹	四肢発疹
後腹膜浸潤	後腹膜悪性腫瘍	腹膜転移
網状紫斑	紫斑病	網状皮斑
胚細胞腫瘍	腫瘍	胚細胞腫
類円形腫大	リンパ節腫大	松果体細胞腫
中枢性気管支拡張像	気管支拡張症	限局性気管支拡張症
小股歩行	歩行異常	小刻み歩行
脳血管傷害	脳血管障害	脳外傷後遺症
糖尿病末梢神経障害	糖尿病性単ニューロパチー	糖尿病性末梢神経障害
ルンバール後頭痛	腰椎穿刺後頭痛	典型的前兆に頭痛を伴う片頭痛
急性重症Ｂ型肝炎	Ｂ型肝炎	Ｂ型急性肝炎
下垂時疼痛	疼痛	慢性疼痛
頚部蜂窩織炎	頚部蜂巣炎	蜂窩織炎
腹満不変	腹部膨満	小腹不仁
一過性心筋虚血	心筋虚血	無症候性心筋虚血
日勤帯発熱	発熱	予防接種後発熱
結核性喉頭狭窄	喉頭狭窄症	吻合部狭窄
両側鼻内ポリープ	鼻茸	後鼻孔ポリープ
手掌潮紅	紅潮	手掌紅斑
低血糖歴何年	低血糖	低血糖発作
離床時眩暈	めまい	起立性眩暈
ＳＬＥ発症	全身性エリテマトーデス	ＨＤＬＳ
体熱感	不明熱	熱中症
両側大腰筋血腫	血腫	腰椎硬膜外血腫
ＰＳＬＮ転移	大動脈周囲リンパ節転移	ＨＤＬＳ
咽頭部疼痛	咽頭痛	慢性咽頭痛
肺腫瘍塞栓症	肺腫瘍	肺塞栓症
筋肉痛症状	筋肉痛	多発性筋肉痛
圧迫性脊髄症	脊髄症	脊髄圧迫症
出血源不明	出血	不正性器出血
椎間板突出	椎間板症	椎間板変形
カルチノイド腫瘍	カルチノイド	プロラクチン産生腫瘍
心臓内腫瘤	腫瘤	精巣上体腫瘤
日中気分不快	悪心	腹部不快感
けいれん再発	痙攣	てんかん様発作
手指痺れ	しびれ感	手指こわばり
左卵管水腫	卵管留水症	胎児水腫
歩行時呼吸困難	労作時呼吸困難	呼吸困難
ガーゼ出血	出血	ワルデンストレーム高ガンマグロブリン血症
右被殻脳梗塞	被殻出血	小脳梗塞
子宮頚部嚢胞	子宮頚部腫瘍	子宮頚部上皮内腫瘍
腺腫内癌	癌	甲状腺癌
膣転移	腟癌	腹膜転移
左小脳陳旧性梗塞	陳旧性脳梗塞	陳旧性小脳梗塞
淡黄色粘稠痰	喀痰	膿性痰
左末梢性肺動脈狭窄	肺動脈狭窄症	末梢性肺動脈狭窄症
骨代謝異常	代謝障害	骨発達障害
心陰影拡大	胸部異常陰影	肺野円形陰影
腎動脈下腹部大動脈瘤	腹部大動脈瘤	腎動脈瘤
腸管壁内気腫	皮下気腫	口腔粘膜下気腫
慢性活動性ＥＢＶ感染症	ＥＢウイルス感染症	ＨＩＶ感染症
足関節圧痛	関節痛	足関節痛
顔面紅班	紅斑症	顔面紅潮
排便痛	排便障害	嚥下痛
両下肢リンハ゜浮腫	下肢リンパ浮腫	上肢リンパ浮腫
左頸部ＬＮ腫脹	肘リンパ節腫脹	眼部外傷性腫脹
肺門部リンパ節腫脹	リンパ節腫大	肺門リンパ節腫脹
呼吸困難感軽度	呼吸麻痺	呼吸困難
左膝窩動脈血栓症	動脈血栓症	大腿静脈血栓症
開口制限	開口不全	開口障害
変形性関節炎	変形性関節症	多発性関節炎
鼠径部血腫	血腫	眉部血腫
暗赤色嘔吐	嘔吐症	習慣性嘔吐
左増殖性糖尿病網膜症	糖尿病網膜症	増殖性糖尿病性網膜症
レム睡眠行動異常	異常行動	レム睡眠行動障害
声帯癌	声門癌	仮声帯癌
左大腿部疼痛	大腿痛	大腿内側部痛
中枢神経浸潤	中枢神経系損傷	中枢神経ループス
直腸皮下瘻孔	難治性瘻孔	直腸瘻
胆嚢腫大	胆のう肥大	膵腫大
Ｈｅｅｒｆｏｒｄｔ症候群	ぶどう膜耳下腺熱	ＭＥＲＲＦ症候群
ダグラス窩腹水	腹水症	腹水細胞診陽性
ツツガムシ感染症	つつが虫病	アニサキス幼虫感染症
前立腺浮腫	浮腫	上肢浮腫
胞性腫瘤	腫瘤	化膿性腫瘤
右鼠径リンパ節腫脹	鼡径部リンパ節腫脹	顎下リンパ節腫脹
ＡＡＡ破裂	腹部大動脈瘤	眼球破裂
夜間覚醒	不眠症	睡眠障害
右迷走神経鞘腫	神経鞘腫	馬尾神経鞘腫
機会誤嚥	嚥下障害	異物誤嚥
大腿静脈血栓	静脈血栓症	大腿静脈血栓症
新生血管緑内障	緑内障	血管新生緑内障
アメーバ肝膿瘍	肝アメーバ症	アメーバ性肝膿瘍
先天性真珠腫	真珠腫	仮性真珠腫
右肺門部浸潤影	胸部異常陰影	下肺野陰影
食道悪性腫瘍	食道癌	食道良性腫瘍
レントゲン異常	胸部異常陰影	フィブリノゲン異常症
低酸素症状	低酸素性脳症	低酸素血症
粘稠痰少量	喀痰	過剰喀痰
ダンベル型腫瘍	腫瘍	良性腫瘍
催不整脈作用	不整脈	抗不整脈剤副作用
左腋窩汗腺癌	汗腺癌	腋窩癌
感染性仮性嚢胞	仮性膵のう胞	髄液細菌培養陽性
乳房熱感	ほてり	乳房熱傷
大腸穿孔	腸穿孔	小腸穿孔
腎瘢痕	瘢痕	腎瘻
進行性顔面片側萎縮症	顔面痙攣症	顔面半側萎縮症
右鼠径部腫脹	鼡径部腫脹	眼部外傷性腫脹
非逆流性食道炎	食道炎	逆流性食道炎
甲状腺萎縮	後天性甲状腺萎縮	先天性甲状腺萎縮
呼吸苦自覚症状	呼吸困難	呼吸困難発作
多発単神経障害	多発性単ニューロパチー	多発性単神経炎
右肺上葉結節影	胸部異常陰影	下肺野陰影
リステリア感染症	リステリア症	リケッチア感染症
アルコール性脂肪性肝炎	アルコール性脂肪肝	非アルコール性脂肪性肝炎
脳室穿破	脳出血	血腫脳室内穿破
鼠径部リンパ節腫大	鼡径部リンパ節腫脹	リンパ節腫大
吐気治	嘔気	化学療法に伴う嘔吐症
重度右片麻痺	片麻痺	一過性片麻痺
両側乳房腫瘤	乳房腫瘤	乳房皮下腫瘤
原発不明癌頸部リンパ節転移	頚部リンパ節転移	多発性癌転移
右下葉原発扁平上皮癌	下葉肺扁平上皮癌	転移性扁平上皮癌
便秘悪化	便秘症	習慣性便秘
潜血３	顕微鏡的血尿	便潜血
アレルギー性血管浮腫	浮腫	アレルギー性浮腫
顕微的血尿	血尿	顕微鏡的血尿
日中痛み	疼痛	習慣性頭痛
眼球運動痛	疼痛	一次性運動時頭痛
Ｙｅｒｓｉｎｉａ　ｅｎｔｅｒｏｃｏｌｉｔｉｃａ感染症	エルシニア菌食中毒	ＭＲＣＮＳ感染症
多発肺内転移	転移性肺癌	肺移植後
左下葉肺癌断端再発	下葉肺癌	ＡＬＫ融合遺伝子陽性非小細胞肺癌
右顔面打撲	顔面打撲傷	頭部打撲
糖尿病性自律神経障害	糖尿病性自律神経ニューロパチー	糖尿病性末梢神経障害
抗原血症	サイトメガロウイルス感染症	ＨＢｅ抗原検査陽性
潜在性副腎皮質機能低下症	副腎皮質機能低下症	続発性副腎皮質機能低下症
眼球陷凹	眼球陥没	眼瞼瘻孔
両足趾潰瘍	趾皮膚潰瘍	手指皮膚潰瘍
左鎖骨下リンパ節転移	リンパ節転移	鎖骨上リンパ節転移
両眼糖尿病性網膜症	糖尿病網膜症	２型糖尿病性網膜症
肝臓病変	肝疾患	肝障害
右第１趾潰瘍	趾皮膚潰瘍	趾難治性皮膚潰瘍
踵部発赤	発赤	下腿発赤
両側ぶどう膜炎	ぶどう膜炎	急性前部ぶどう膜炎
痔疾患	痔核	咀嚼障害
吐き気軽度	嘔気	習慣性嘔吐
非結核性抗酸菌性人工関節感染症	非結核性抗酸菌症	非結核性抗酸菌性股関節炎
両下肢不随意運動	不随意運動症	四肢運動障害
結腸皮膚瘻	皮膚瘻	直腸皮膚瘻
患肢熱感	ほてり	下肢冷感
両側腎膿瘍	腎膿瘍	腎周囲膿瘍
潜血	顕微鏡的血尿	便潜血
右鼡径部皮下出血	皮下出血	眼部皮下出血
右下腿筋肉内出血	筋肉内血腫	大腿部皮下出血
痒感	そう痒	症候性そう痒症
術後出血	後出血	術後貧血
遠位弓部嚢状動脈瘤	動脈瘤	弓部大動脈瘤
尿潜血遷延	顕微鏡的血尿	反射性無尿
造骨性骨転移	骨転移癌	骨髄転移
失調性構音障害	構音障害	発達性構音障害
皮疹拡大傾向	発疹	全身発疹
依然浮腫	浮腫	特発性浮腫
右足底部蜂窩織炎	足蜂巣炎	蜂窩織炎
急性期脳血管障害	脳血管障害	閉塞性脳血管障害
軽度すりガラス影	胸部異常陰影	コイン状陰影
二次性血小板増多症	血小板増加症	二次性血小板増加症
胃膵嚢胞	膵のう胞	腫瘍性膵のう胞
最近浮腫	浮腫	高度浮腫
労作時頻脈	頻脈症	術中頻脈発作
重症胆管炎	胆管炎	急性胆管炎
右側胸部痛	胸痛	側胸部痛
右上肢発赤	発赤	下腿発赤
呂律のまわりにくさ	構音障害	排便習慣の変化
アミオダロン誘発性甲状腺中毒症	薬剤性甲状腺機能障害	人為的甲状腺中毒症
左胸部痛	胸痛	前胸部痛
左下腿ＤＶＴ	下腿静脈血栓症	下大静脈フィルター留置状態
紫斑	紫斑病	色素性紫斑
致死性不整脈出現	不整脈	術中不整脈
一瞬痛み	疼痛	鈍痛
難治性皮膚非定型抗酸菌症	非結核性抗酸菌症	皮膚非結核性抗酸菌症
頚部鈍痛	鈍痛	頭頚部痛
右肺上葉陰影	胸部異常陰影	下肺野陰影
右上葉肺結節	結節性肺結核	肺の副葉
空腹時高血糖	高血糖症	夜間低血糖症
右麻痺	片麻痺	対麻痺
味覚変化	味覚障害	味覚消失
凝固異常症	血液凝固異常	消費性凝固障害
右側頭葉脳梗塞	脳梗塞	小脳梗塞
両側下顎骨折	下顎骨骨折	下顎正中部骨折
多発性肝腫瘤	肝腫瘍	肝腫瘤
意味性錯語	文意失語症	錯味
ｃｏａｒｓｅ　ｃｒａｃｋｌｅｓ	湿性ラ音	ＣＡＲＡＳＩＬ
緑色下痢便	下痢症	食事性下痢
ＡＶブロック	房室ブロック	ＡＶＭ
前縦隔ＬＮ転移	縦隔リンパ節転移	横隔膜転移
外側脱臼	脱臼	前方脱臼
両足しびれ	下肢しびれ	四肢しびれ
膜性増殖性	膜性増殖性糸球体腎炎	複雑型子宮内膜増殖症
頻脈性心房粗動	心房粗動	頻脈性心房細動
実質外腫瘤	腫瘤	多発性皮下腫瘤
関節炎悪化	関節炎	慢性関節炎
両手指浮腫	浮腫	足部浮腫
浸潤癌化	癌	甲状腺未分化癌
就寝後呼吸困難	呼吸困難	夜間呼吸困難
訪室時疼痛	疼痛	慢性疼痛
転移性膵癌	膵癌	転移性肝癌
間歇跛行	間欠性跛行	跛行
動脈瘤コイル塞栓術	動脈瘤	冠状動脈塞栓症
紅斑散在	紅斑症	環状紅斑
右膝疼痛	膝関節痛	膝窩部痛
皮内腫瘍	腫瘍	皮下腫瘍
左前床突起部髄膜腫	髄膜腫	前頭髄膜腫
軽度腹部痛	腹痛症	上腹部痛
多発毛細血管拡張	オスラー病	毛細血管拡張症
不整脈誘発	不整脈	術中不整脈
左肺動脈ＰＥ	肺動脈血栓塞栓症	肺動脈血栓症
胃潰瘍再発	胃潰瘍瘢痕	再発性胃潰瘍
境界域精神発達遅滞	知的障害	心因反応精神遅滞
外陰部ｐａｇｅｔ癌	外陰部パジェット病	外陰部有棘細胞癌
リウマチ様症状	関節リウマチ	リウマチ反応陽性
肺癌性リンパ管症	癌性リンパ管症	肺ＭＡＬＴリンパ腫
骨盤位妊娠	骨盤位	骨盤位分娩
左椎間孔狭窄	結合組織性椎間孔狭窄症	骨性椎間孔狭窄症
前立腺軽度腫大	前立腺肥大症	前立腺良性腫瘍
大腸憩室症	多発性大腸憩室症	小腸憩室症
右腹痛	腹痛症	下腹痛
嚥下耳痛	耳痛症	嚥下痛
茶色出血	出血	点状出血
左下葉扁平上皮癌	下葉肺扁平上皮癌	転移性扁平上皮癌
原発性ヘモクロマトーシス	ヘモクロマトーシス	続発性ヘモクロマトーシス
逆行性Ｐ波	心電図異常	異常脳波
臀部圧痛	圧痛	腹部圧痛
多発皮下転移	皮下腫瘍	腹膜転移
副鼻腔病変	副鼻	副鼻腔異物
安静時呼吸苦	呼吸困難	夜間呼吸困難
陰嚢疼痛	陰のう痛	陰茎部疼痛
上眼瞼腫脹	眼瞼浮腫	眼瞼外傷性腫脹
右下肢複雑骨折	開放骨折	下肢多発骨折
可動性良好腫瘤	腫瘤	化膿性腫瘤
両頬部発赤	発赤	下腿発赤
感染性肝嚢胞	肝のう胞	寄生虫性肝疾患
皮下出血斑	皮下出血	下肢出血斑
右下腿骨髄炎	大腿骨骨髄炎	下腿骨骨髄炎
平行機能障害	平衡異常	知的障害・行動機能障害なしか最小限
元々杖歩行	歩行障害	内転歩行
毎回失禁	尿失禁症	便失禁
下腿血腫	血腫	下腿部皮下血腫
逆流性膀胱炎	膀胱尿管逆流	反復性膀胱炎
覚醒時疼痛	疼痛	睡眠時頭痛
左大転子部発赤	発赤	下腿発赤
リンパ腫再発	悪性リンパ腫	リンパ腫
重度運動障害性構音障害	構音障害	運動障害性構音障害
腎性急性腎障害	腎障害	急性腎性腎不全
喉頭嚢胞	喉頭のう胞	喉頭蓋のう胞
左上下肢しびれ	半身しびれ	下肢しびれ
心筋傷害	心筋疾患	心臓外傷
胆嚢胆石	胆泥	胆のう胆管結石症
悪性細胞	癌	悪性組織球症
Ｌｉｓｔｅｒｉａ　ｍｏｎｏｃｙｔｏｇｅｎｅｓ敗血症	敗血症	ＭＲＣＮＳ敗血症
パニック症侯群	パニック障害	チェディアック・東症候群
アレルギー性肺アスペルギルス症	アレルギー性気管支肺アスペルギルス症	侵襲性肺アスペルギルス症
左下肢原発性リンパ浮腫	リンパ浮腫	上下肢リンパ浮腫
落ち着かない	多動性障害	落ち込み
薬剤性副腎不全	副腎皮質機能低下症	慢性腎不全
乳がん	乳癌	乳頭びらん
右手関節尺側部痛	手関節痛	手指関節痛
右上顎洞真菌症	上顎洞炎	外耳道真菌症
鮮血便	血便	粘血便
右足滑液包炎	滑液包炎	足関節滑液包炎
左大腿部痛	大腿痛	大腿内側部痛
隆起性病変	胃ポリープ症	前足部変形
細菌性赤痢感染症	赤痢	ボイド菌赤痢
多数骨折	骨折	多発骨折
３型進行癌	癌	重複癌
全頭脱毛症	脱毛症	全身性脱毛症
ｆａｎ症候群	マルファン症候群	ＣＦＣ症候群
脊椎椎間板炎	椎間板炎	頚椎椎間板炎
起始異常	冠動脈起始異常	異常行動
介助　疼痛	疼痛	身体型疼痛障害
ふらつき感自覚	よろめき歩行	よろめき感
腎嚢胞出血	傍腎盂のう胞	腎出血
無症候性キャリア	ＨＴＬＶ−１キャリア	ＨＥＶキャリア
中等度腹水	腹水症	異常腹水
肛門部軽度発赤	肛門部周囲炎	咽頭発赤
側方リンパ節転移	リンパ節転移	多部位リンパ節転移
肺腫瘤影	胸部異常陰影	肺腫瘤陰影
複雑型異型子宮内膜増殖症	腺腫性子宮内膜増殖症	複雑型子宮内膜増殖症
肝肥大	肝型糖原病	肝腫大
紅斑腫脹	紅斑症	多形滲出性紅斑
腰部圧痛	腰痛症	腰殿部痛
肺血症性ショック	敗血症性ショック	ショック肺
異所性静脈瘤	静脈瘤	先天性静脈瘤
腫瘍崩壊	腫瘍	腫瘍崩壊症候群
破壊性甲状腺炎	甲状腺炎	急性甲状腺炎
右腸骨ＬＮ転移	腸骨リンパ節転移	直腸癌骨転移
右腎被膜下血腫	血腫	外傷性腎被膜下血腫
非機能性下垂体腫瘍	下垂体腫瘍	悪性下垂体腫瘍
小人症	低身長症	小頭症
右臼蓋転移	骨盤転移	腹膜転移
右頭頂葉脳梗塞	脳梗塞	小脳梗塞
足趾壊疽	趾壊死	足壊疽
左肺尖部腺癌	肺腺癌	肺門部腺癌
潰瘍型間質性膀胱炎	間質性膀胱炎	潰瘍性膀胱炎
紅色皮疹	発疹	紅斑性湿疹
頚管狭窄	子宮頚管狭窄症	頚部脊柱管狭窄症
脳梗塞後後遺症	脳梗塞	脳梗塞後遺症
紅斑熱	日本紅斑熱	温熱性紅斑
多発頭蓋骨転移	骨転移癌	転移性頭蓋骨腫瘍
Ｄａｎｌｏｓ症候群	エーラス・ダンロス症候群	ＭＥＬＡＳ症候群
運動低下性構音障害	構音障害	運動障害性構音障害
両側腸腰筋血腫	血腫	腸腰筋膿瘍
肝嚢胞感染	肝のう胞	巨大肝蛭感染症
顔面骨圧痛	圧痛	坐骨部痛
会陰部疼痛	外陰部痛	陰茎部疼痛
２次性副甲状腺機能亢進症	副甲状腺機能亢進症	続発性副甲状腺機能亢進症
右前大脳動脈未破裂動脈瘤	前大脳動脈瘤	未破裂脳動脈瘤
リウマチ性胸水	リウマチ性肺疾患	胸水貯留
右眼白内障手術	白内障	白内障術後
右基底核梗塞	脳梗塞	陳旧性側壁心筋梗塞
境界型耐糖能障害	耐糖能異常	遺伝性果糖不耐症
リウマチ疾患	関節リウマチ	回帰性リウマチ
心房細動停止	心房細動	心房静止
ＶＨＬ病	フォンヒッペル・リンダウ病	ＨＤＬＳ
陰嚢部腫脹	陰のう腫大	胸部腫脹
高分化型腺癌	癌	前立腺小細胞癌
Ｍｙｃｏｂａｃｔｅｒｉｕｍ　ｓｈｉｇａｅｎｓｅ感染症	非結核性抗酸菌症	ＭＲＣＮＳ感染症
肺転移発覚	転移性肺腫瘍	肺移植後
両側肺動脈血栓塞栓	動脈血栓症	肺動脈血栓塞栓症
左耳耳鳴	耳鳴症	頚性耳鳴
鼠経ヘルニア	鼡径ヘルニア	食道ヘルニア
日中掻痒感	そう痒	症候性そう痒症
薬剤性腎不全	薬剤性腎障害	慢性腎不全
腫瘍増悪	腫瘍	悪性腫瘍
完全型ベーチェット病	ベーチェット病	不全型ベーチェット病
筋肉痙攣	痙攣	四肢筋痙攣
癌性髄膜腫症	悪性髄膜腫	髄膜癌腫症
化膿性脊椎椎間板炎	化膿性椎間板炎	頚椎化膿性椎間板炎
呼吸性雑音	胸部音異常	発作性呼吸困難
両肩関節圧痛	圧痛	肩関節痛症
多発肝細胞癌	肝腫瘍	肝細胞癌
右腎小嚢胞	傍腎盂のう胞	副腎のう胞
上腫瘍	腫瘍	上顎腫瘍
左踵部痛	踵痛	膝窩部痛
ポリープ様隆起	ポリープ	胃体部ポリープ
刺激性皮膚炎	皮膚炎	虫刺性皮膚炎
慢性緑膿菌感染	緑膿菌感染症	多剤耐性緑膿菌感染症
回腸閉塞	回腸狭窄	回腸閉鎖
尾部嚢胞	膵のう胞	傍鞍部類表皮のう胞
虫刺症	蜂刺症	刺虫症
膵仮性嚢胞破裂	仮性膵のう胞	膵臓破裂
シェーンラインヘノッホ紫斑病	ＩｇＡ血管炎	ナイミーヘン染色体不安定症候群
チャーグ－ストラウス症候群	好酸球性多発血管炎性肉芽腫症	アダムス・ストークス症候群
低ＡＴⅢ血症	アンチトロンビン欠乏症	ＰＩＶＫＡ−ＩＩ高値
超皮質性感覚性失語	皮質下感覚性失語症	超皮質性失語
ＮＯＭＩ	腸壊死	ＭＮＧＩＥ
左踵骨裂離骨折	踵骨骨折	裂離骨折
慢性糸球体炎	糸球体腎炎	連鎖球菌気管炎
左眼結膜下出血	結膜下出血	眼瞼結膜出血
四肢圧痛	圧痛	四肢痛
関節変形	関節奇形	股関節変形
気分変動	気分変調症	気分異常
立位バランス練習重症筋無力症	重症筋無力症	若年型重症筋無力症
食道カンジタ症合併ＨＩＶ感染症	ＨＩＶカンジダ病	ＨＩＶ感染症
固縮無動	こわばり	多発性拘縮
小体認知症	認知症	レビー小体型認知症
生検部感染徴候	創傷感染症	生検後感染
痛風症状	痛風	痛風発作
右眼下鼻側視野異常	視野障害	眼内斜視
右肺Ｓ４原発腺癌	肺腺癌	ＲＯＳ１融合遺伝子陽性非小細胞肺癌
喘息コントロール不良	咳喘息	アトピー性喘息
腹部大動脈狭窄症	大腿動脈狭窄症	腹部大動脈閉塞症
大腸疾患	腸疾患	胃腸疾患
頚部血腫	頚部表在損傷	頭部血腫
皮下浮腫	浮腫	下肢浮腫
低活動型せん妄	せん妄	認知症に重なったせん妄
右内頸動脈血栓閉塞	動脈血栓症	内頚動脈閉塞症
ＣＮＩ腎症	薬剤性腎障害	ＮＳＡＩＤ腎症
胃液様	嘔吐症	胃液欠乏
右鼡径部出血	出血	腟断端出血
右肺上葉肺炎	肺炎	急性肺炎
門亢症	門脈圧亢進症	口蓋垂過長症
創内異物	外傷性異物	殿部異物
膀胱内尿貯留	後腹膜尿貯留	尿膀胱神経症
肢痛	疼痛	上肢痛
腸管内血腫	血腫	肝内血腫
臀部紅斑	紅斑症	手掌紅斑
末節骨骨折	骨折	指節骨骨折
脊椎症性変化	脊椎症	変形性脊椎症
腸閉塞気味	イレウス	直腸閉鎖
浅呼吸	呼吸困難	口呼吸
右顎下リンパ節腫脹	顎下リンパ節腫脹	下顎リンパ節腫脹
痛覚消失	異常知覚	片側痛覚消失
肘頭部潰瘍	前腕皮膚潰瘍	亀頭部潰瘍
反復性腸閉塞	イレウス	結腸閉塞
胎児腹水	胎児水腫	胎児胸水
皮膚ツルゴール低下	脱水症	皮膚ムコール症
右肩悪性軟部腫瘍	悪性軟部腫瘍	肩部悪性軟部腫瘍
右中指スワンネック変形肩関節	スワンネック変形	人工肩関節のゆるみ
腹部肥満	肥満症	腹部膨満
Ｓ状結腸粘膜下腫瘤	腫瘤	Ｓ状結腸粘膜下腫瘍
両側下腿圧痕性浮腫	下腿浮腫	遺伝性下腿浮腫
出血軽度	出血	多量出血
不眠時２錠	不眠症	睡眠薬依存
胸水排出	胸水貯留	漏出性胸水
ＡＩＤＳ非定型抗酸菌症	非結核性抗酸菌症	ＨＩＶ非結核性抗酸菌症
尺側神経麻痺	尺骨神経麻痺	両側性反回神経麻痺
てんかんの発作	てんかん	てんかん様発作
腹部大動脈石灰化	大動脈石灰化症	冠動脈石灰化
コレステロールポリープ	ポリープ	胆のうコレステロールポリープ
１型糖尿除	糖尿	１型糖尿病
肺多型癌	癌	肺癌
気分不快出現	悪心	腹部不快感
内腸骨静脈血栓症	静脈血栓症	腸骨動脈血栓症
舌根扁桃炎	扁桃炎	舌扁桃炎
右肺上葉小細胞癌	上葉小細胞肺癌	上葉肺大細胞癌
ＣＭＶ網膜症	サイトメガロウイルス網膜炎	ＨＩＶ網膜症
悪心Ｇ１	悪心	ＡＦＰ高値
脊髄視神経炎	視神経炎	視神経脊髄炎
印環細胞癌	癌	殿部基底細胞癌
６月肝転移	転移性肝腫瘍	肝移植後
左内頸動脈中等度狭窄	頚動脈硬化症	頚動脈ステント狭窄
右鼡径部ヘルニア	鼡径ヘルニア	外鼡径ヘルニア
ＭＬＦ症候群	核間性眼筋麻痺	ＣＦＣ症候群
肩関節疼痛	肩関節痛症	肩関節痛風
右手痺れ	上肢しびれ	手変形
逆流感	胃食道逆流症	三尖弁逆流
左尿管導管吻合部狭窄	吻合部狭窄	尿管回腸導管吻合部狭窄
時折不整	不整脈	不器用
僧帽弁狭窄症兼閉鎖不全症	僧帽弁狭窄症	僧帽弁狭窄兼閉鎖不全症
伸筋腱脱臼	脱臼	総指伸筋腱脱臼
内転障害	眼球運動痙攣	内転足
足首骨折	足関節骨折	足背骨折
高Ｂｉｌ血症	高ビリルビン血症	高ＬＤＬ血症
第一腰椎破裂骨折	腰椎破裂骨折	第３頚椎破裂骨折
パニック	パニック障害	パニック発作
ＡＰＳ	抗リン脂質抗体症候群	ＡＩＤＳ
脳圧亢進症状	頭蓋内圧亢進症	非外傷性低脳圧症
二次性ヘモクロマトーシス	ヘモクロマトーシス	続発性ヘモクロマトーシス
潜在性副甲状腺機能低下症	副甲状腺機能低下症	特発性副甲状腺機能低下症
右内腸骨動脈狭窄	動脈狭窄	外腸骨動脈狭窄
Ⅱａ型高脂血症	高脂血症	混合型高脂質血症
右睾丸痛	精巣痛	鼡径部痛
回腸出血	腸出血	小腸出血
後頭蓋下髄膜腫	髄膜腫	後頭蓋窩髄膜腫
尿道口発赤	発赤	尿道口膿瘍
肺上葉原発性肺癌	原発性肺癌	上葉肺癌
労作時胸部不快	労作時呼吸困難	胸部不快感
Ｓａｌｍｏｎｅｌｌａ　ｅｎｔｅｒｉｔｉｄｉｓ敗血症	サルモネラ敗血症	ＭＲＳＡ敗血症
グル音異常	異常腸音	心音図異常
鉄吸収障害	鉄欠乏症	鉄代謝障害
本日右眼白内障	白内障	併発白内障
胆管内結石	胆管結石症	総胆管結石
処置後膵炎	膵炎	術後膵炎
ｗｉｄｅ　ＱＲＳ頻拍	頻拍症	上室頻拍
両側性末梢性顔面神経麻痺	末梢性顔面神経麻痺	特発性末梢性顔面神経麻痺
息苦しく	呼吸困難	口苦
無菌性腸炎	非感染性腸炎	細菌性腸炎
骨盤内リンパ嚢腫	骨盤部感染性リンパのう胞	骨盤内リンパ節の悪性腫瘍
平坦Ｔ波	心電図異常	低Ｔ３症候群
ペーシング不全	両室ペーシング機能付き植込型除細動器不全	ペースメーカ不全
ふらつきあり	めまい	全身こむらがえり病
右鼡径ヘルニア	鼡径ヘルニア	外鼡径ヘルニア
職業性ストレス	急性ストレス反応	重度ストレス反応
卵管水腫	卵管留水症	胎児水腫
左下葉原発性肺扁平上皮癌	肺扁平上皮癌	下葉肺扁平上皮癌
外気胸	気胸	外傷性気胸
外陰部血腫	外陰血腫	会陰部血腫
左乳突蜂巣炎	乳様突起炎	足蜂巣炎
未破裂左内頸動脈瘤	内頚動脈瘤	破裂性胸部大動脈瘤
中咽頭側壁扁平上皮癌	癌	中咽頭側壁癌
ＥＶＡＮＳ症候群	エバンス症候群	ＭＥＬＡＳ症候群
両肺多発結節性陰影	胸部異常陰影	肺門部異常陰影
脾臓腫瘤	腫瘤	膵腫瘤
腫瘍感染合併	腫瘍	ＣＲＨ産生腫瘍
ＩＰ合併	間質性肺炎	ＡＩＤＳ
ゾメタ骨髄炎	骨髄炎	ＭＲＳＡ骨髄炎
右胸膜原発血管肉腫	血管肉腫	胸壁血管肉腫
拘縮気味	筋拘縮症	多発性拘縮
手関節圧痛	圧痛	手関節痛
浮腫残存	浮腫	全身性浮腫
非てんかん性心因性発作	てんかん	アトニー性非特異性てんかん発作
下腸間膜動脈閉塞	腸間膜動脈塞栓症	急性上腸間膜動脈閉塞症
右中大脳動脈領域梗塞	中大脳動脈閉塞症	脳外主幹動脈閉塞脳梗塞
消化管腫瘤	腫瘤	化膿性腫瘤
脛骨前面圧痕性浮腫	浮腫	外傷性脳浮腫
多少眠気	非器質性過眠症	過眠
高濃度腫瘤	腫瘤	多発性皮下腫瘤
ＤＧＥ症状	消化管術後後遺症	ＭＮＧＩＥ
過形成性ポリープ	胃過形成ポリープ	ポリープ
日光アレルギー	光線過敏症	刺虫アレルギー
慢性炎症性腸疾患	腸炎	炎症性腸疾患
尺骨頭脱臼	脱臼	橈骨頭脱臼
けいれん症状	痙攣	てんかん
肺炎併発	肺炎	急性肺炎
右下肢感覚鈍麻	感覚異常症	片側感覚鈍麻
慢性進行性肺アスペルギルス症	肺アスペルギルス症	侵襲性肺アスペルギルス症
ヒステリー	ヒステリー反応	ヒステリー球
手指皮疹	発疹	手指湿疹
残尿	残尿感	乏尿
両肺気胸	気胸	上葉無気肺
廃用	廃用症候群	廃用性弱視
浮動感	めまい	体感消失
強制換気	人工呼吸器装着状態	過換気症
左下肢ガス壊疽	ガス壊疽	下肢壊疽
喚語障害	不全失語症	発声障害
右手背浮腫	限局性浮腫	足部浮腫
足趾しびれ	下肢しびれ	手指先しびれ
足底痺れ	しびれ感	足底角化症
細菌性食道炎	食道炎	感染性食道炎
術後肺転移	転移性肺腫瘍	肺移植後
転移性腫瘤	転移性腫瘍	化膿性腫瘤
夜間尿意	夜間頻尿症	夜間多尿
神経性疼痛	神経痛	神経障害性疼痛
房室接合部調律	異所性調律	接合部調律
帯状疱疹拡大	帯状疱疹	汎発性帯状疱疹
左尾状核ラクナ硬塞	ラクナ梗塞	陳旧性ラクナ梗塞
ＳＭＡ閉塞	急性上腸間膜動脈閉塞症	透析シャント閉塞
めまいの発作	めまい	めまい発作
呼吸切迫	急性呼吸窮迫症候群	呼吸促迫
劇症型連鎖球菌感染症	連鎖球菌感染症	劇症型Ａ群連鎖球菌感染症
腹部疝痛	仙痛	腹部圧痛
胆嚢多発ポリープ	胆のうポリープ	胆管ポリープ
柑皮症	カロチン血症	瓜実条虫症
両側眼球外転障害	眼球運動障害	先天性眼球運動障害
元々浮腫	浮腫	全身性浮腫
夜間失禁	尿失禁症	老人性夜間せん妄
褥瘡発生リスク低い	褥瘡	褥瘡・ステージＩ
Ⅱ度熱傷	熱傷	第４度熱傷
重度感覚障害	体感異常	感覚異常症
両側肺尖部進行性胸膜肥厚	胸膜肥厚	びまん性胸膜肥厚
婦人入院脳梗塞	脳梗塞	陳旧性脳梗塞
炎症性ポリープ多発	ポリープ	若年性ポリープ
右坐骨結節転移再発	転移性腫瘍	坐骨結合体
右上肢痺れ	しびれ感	上肢麻痺
ＭＣＴＤ	混合性結合組織病	ＨＤＬＳ
昨日水様便	下痢症	無汗性日射病
気分不快増強	悪心	全身倦怠感
拡張期高血圧	高血圧症	内分泌性高血圧症
左頸部リンパ節腫大	薬剤性自己免疫性溶血性貧血	リンパ節腫大
右低音部感音難聴	感音難聴	一側性感音難聴
ＰＨＴ	肺高血圧症	ＰＣＷＨ
夜間失見当	見当識障害	夜間めまい
物忘れ気	健忘症	食後悪心
右手関節滑膜炎	滑膜炎	膝関節滑膜炎
声門上喉頭癌	喉頭癌	声門下癌
右膝メルケル細胞癌	メルケル細胞癌	膝部メルケル細胞癌
加害妄想	妄想反応	被害妄想
急性乳突洞炎	急性中耳炎	急性乳様突起炎
舌内リンパ節転移	リンパ節転移	腋窩リンパ節転移
左肺下葉腫瘤影	肺腫瘤	肺腫瘤陰影
左感音性難聴	感音難聴	両側性感音難聴
ＣＯＰＤＩ期	慢性閉塞性肺疾患	ＡＩＤＳ
転倒歴多数	よろめき歩行	卒倒
ＤＩＨＳ	薬疹	ＡＩＤＳ
夜勤帯下血	下血	夜間性喘息
インスリン依存性糖尿病	１型糖尿病	インスリン抵抗性糖尿病
拍動性疼痛	疼痛	急性疼痛
ＤＭ性腎不全	糖尿病性腎不全	急性腎不全
膝関節軽度屈曲拘縮	屈曲拘縮	膝関節屈曲拘縮
ＡＴＬ	成人Ｔ細胞白血病リンパ腫	ＨＤＬＳ
肺動脈弁閉鎖不全	肺動脈弁閉鎖	肺動脈弁閉鎖不全症
熱感軽度	ほてり	温度感覚過敏
術後肝転移	転移性肝癌	肝移植後
朝低血糖	低血糖	夜間低血糖症
喘息疑い	咳喘息	外因性喘息
顔皮疹	発疹	顔面真菌性湿疹
再出血徴候	出血	第３期出血
アシネトバクター敗血症	敗血症	ＭＲＳＡ敗血症
高度肥満２型糖尿病	２型糖尿病	安定型糖尿病
左腎盂腎炎治癒後	腎盂腎炎	術後腎盂腎炎
二次性水頭症	外傷後水頭症	交通性水頭症
ダグラス窩播種	腹膜播種	播種性ブラストミセス症
左室拡張能低下	左室不全	Ｗタイプ拡大装置不適合
異常帯下	帯下	帯下過多
上半身掻痒感	そう痒	老年性そう痒症
動揺性めまい	めまい	回転性めまい
水分摂取困難	嚥下障害	経口摂取困難
右下葉原発低分化腺癌	癌	甲状腺未分化癌
右副腎腫瘍摘出術	副腎腫瘍	腎摘出術後
細菌性扁桃炎	扁桃炎	連鎖球菌性扁桃炎
正常圧緑内障	緑内障	正常眼圧緑内障
副睾丸炎	精巣炎	腟断端炎
慢性アレルギー性鼻炎	季節性アレルギー性鼻炎	アレルギー性鼻炎
夕食前低血糖	低血糖	夜間低血糖症
単頸双角子宮	双角子宮	単頚双角子宮
原発性肺高血圧症	肺高血圧症	二次性肺高血圧症
左鎖骨リンパ節転移	リンパ節転移	鎖骨上リンパ節転移
殿部色素沈着	色素異常症	鉄色素沈着
舌浮腫	浮腫	脳浮腫
舌損傷	損傷	鼻損傷
腹部大動脈狭窄	大動脈狭窄症	腹部大動脈閉塞症
軽度痺れ	しびれ感	調節麻痺
星芒状血管腫	血管腫	星状芽細胞腫
右房内腫瘤	腫瘤	胸腔内腫瘤
Ｓ状結腸転移	転移性消化器腫瘍	Ｓ状結腸瘻
全身掻痒感	そう痒	症候性そう痒症
肉芽腫性腸疾患	腸疾患	直腸Ｓ状部悪性腫瘍
両足圧痕性浮腫	浮腫	足部浮腫
虫垂粘液嚢胞腺腫	虫垂粘液のう胞	卵巣粘液性腺腫
若年性リウマチ	関節リウマチ	回帰性リウマチ
体陽性脳炎	脳炎	慢性脳炎
境界域ＤＭ	糖尿病	ＡＶＭ
劇症敗血症	敗血症	類丹毒性敗血症
慢性血腫	血腫	多発性血腫
骨破壊病変	関節リウマチ	骨壊死
眼窩部痛	眼痛	腋窩部痛
口腔内発赤腫脹	発赤	口腔悪性黒色腫
中咽頭再発腫瘍	咽頭腫瘍	中咽頭良性腫瘍
腹部軽度膨隆	腹部膨満	腹部板状硬
リンパ管症	癌性リンパ管症	リンパ節症
遷延性抑うつ状態	うつ状態	遷延性抑うつ反応
結核性強膜炎	結核性胸膜炎	結核性硬膜炎
下腿筋萎縮	筋萎縮症	下肢筋萎縮
膵頭癌	癌	膵頭部癌
ＶＡＨＳ	ウイルス関連血球貪食症候群	ＰＣＷＨ
痰中等量引ける	喀痰	喀痰検査異常
放射線障害	放射線宿酔	放射線外傷
浅眠	不眠症	過眠
脳溢血	脳卒中	貧血
右下肢深部静脈血栓症	下肢静脈血栓症	上肢静脈血栓症
背部筋緊張高い	筋強直	筋緊張性障害
全身紅斑	紅斑症	環状紅斑
脳腫瘍切除	脳腫瘍	脳腫瘍摘出術後遺症
右側下顎骨体部骨折	下顎骨骨折	下顎正中部骨折
微小多発脳梗塞	多発性脳梗塞	多発性小脳梗塞
糸球体血尿	血尿	糸球体性血尿
パニック様症状	全般性不安障害	パニック障害
胆嚢充満結石	胆のう結石症	総胆管結石
意識レベル低	意識障害	部分的意識喪失
爪囲紅斑	爪囲炎	環状紅斑
子宮頸癌Ｉｂ１期	子宮頚癌	子宮頚部微小浸潤癌
両側鎖骨上窩リンパ節腫大	リンパ節腫大	鎖骨上リンパ節腫脹
関節滑膜炎	滑膜炎	膝関節滑膜炎
立位保持困難	四肢筋力低下	体力低下
左足痺れ	しびれ感	麻痺性内反足
Ｒｉｅｄｅｌ甲状腺炎	線維性甲状腺腫	急性化膿性甲状腺炎
鼻腔化膿性肉芽腫	細菌性肉芽腫症	化膿性口腔粘膜肉芽腫
右脛骨内果骨折	足関節内果骨折	脛骨骨折
左胸膜転移	胸膜播種	腹膜転移
右肺中葉転移	転移性肺癌	肺野異常陰影
下腿筋痛	下肢筋肉痛	大腿筋痛
右大腰筋血腫	血腫	殿部筋肉内血腫
十二指腸潰瘍再発	慢性十二指腸潰瘍	再発性十二指腸潰瘍
Ａｆ不変	心室細動	ＣＦＣ症候群
左下腿部帯状疱疹	帯状疱疹	胸部帯状疱疹
外陰部湿疹	湿疹	頭部湿疹
左肘頭開放骨折	開放骨折	尺骨肘頭開放骨折
若干硬結	硬結	板状硬結
発作性３度房室ブロック	第３度房室ブロック	高度房室ブロック
身体損傷	損傷	足損傷
慢性胆嚢炎	慢性胆のう炎	慢性胆細管炎
偽性高Ｋ血症	高カリウム血症	高ＩｇＥ血症
元々痛み	疼痛	鈍痛
肝形質細胞腫	形質細胞腫	肝良性腫瘍
躁病相	躁状態	軽躁病
ジューリング疱疹状皮膚炎	ジューリング病	湿疹状アレルギー性接触性皮膚炎
副腎偶発腫	良性副腎皮質腫瘍	副腎腺腫
右下腿紅斑	紅斑症	手掌紅斑
腸管通過障害	消化管狭窄	腸管運動障害
努力様呼吸	起坐呼吸	努力性呼吸
発赤皮疹	発疹	赤色湿疹
赤痢アメーバ大腸炎	アメーバ赤痢	アメーバ性非赤痢性大腸炎
Ｇｒａｄｅ　３肝障害	肝障害	中毒性肝障害
低ＡＬＢ血症	低アルブミン血症	高ＨＤＬ血症
関節痛症状	関節痛	痛風性関節症
総肺静脈還流異常症	肺静脈還流異常症	総肺静脈還流異常
左橈骨頭脱臼骨折	脱臼骨折	中足骨脱臼骨折
正中創感染	創傷感染症	ＭＲＳＡ術後創部感染
左網膜分枝動脈閉塞症	動脈閉塞症	網膜動脈分枝閉塞症
頸部浮腫	浮腫	足部浮腫
低血圧自覚症状	低血圧症	特発性低血圧症
常時痛み	疼痛	習慣性頭痛
多発肝転移増大	転移性肝癌	転移性肝腫瘍
左鼠径部疼痛	鼡径部痛	外陰部痛
円盤状皮疹	円板状エリテマトーデス	ＬＥ皮疹
夜間痙攣	痙攣	常性痙攣
膵体部小嚢胞	腫瘍性膵のう胞	膵管内管状腫瘍
耳介脂漏性湿疹少	脂漏性皮膚炎	外耳湿疹
両側急性硬膜下出血	急性硬膜下血腫	開放性外傷性くも膜下出血
喉頭蓋腫脹	喉頭蓋炎	喉頭蓋腫瘍
深部感覚鈍麻	感覚異常症	触覚鈍麻
痙攣重積後脳症	痙攣重積型二相性急性脳症	痙攣重積型急性脳症
小腸大腸型	小腸大腸クローン病	大腸重積症
インフルエンザＡ型感染症	インフルエンザＡ型	インフルエンザ菌ｂ型感染症
顕微鏡的大腸炎	大腸炎	細菌性大腸炎
直腸Ｒａ癌	直腸癌	ＫＲＡＳ遺伝子野生型直腸癌
苔癬局面	苔癬	類苔癬
足趾爪混濁肥厚	ころもじらみ寄生症	爪甲肥厚
ＣＭＶ肺炎	サイトメガロウイルス肺炎	ＭＲＣＮＳ肺炎
右ＩＣＡ狭窄	内頚動脈狭窄症	右室流出路狭窄
痰貯留	喀痰	過剰喀痰
足趾蜂窩織炎	足蜂巣炎	蜂窩織炎
僧帽弁狭窄兼逆流症	僧帽弁狭窄症	僧帽弁逆流症
歯槽膿漏	歯周炎	耳膿漏
左肘関節破壊	関節リウマチ・肘関節	人工肘関節の破損
皮下石灰化	皮膚石灰沈着症	足部石灰化上皮腫
薬剤性発熱	発熱	薬物熱
軽度ＡＤＨＤ	注意欠陥多動障害	ＡＤＨ異常
両心房拡大	心肥大	巨大左心房
上転障害	眼球運動障害	過外転症候群
腫瘍性	腫瘍	良性腫瘍
嫌悪感	悪寒	悪心
二次性僧帽弁閉鎖不全症	僧帽弁閉鎖不全症	先天性僧帽弁閉鎖不全症
腹痛嘔気	嘔気	腹痛症
左大腿部骨外性粘液型軟骨肉腫	軟骨肉腫	大腿骨軟骨肉腫
高度異形成相当	子宮頚部高度異形成	歯の形成異常
右頚部ＬＮ腫大	リンパ節腫大	ＣＲＨ産生腫瘍
側卵巣嚢腫	卵巣のう腫	卵巣甲状腺腫
哺乳後嘔吐	嘔吐症	新生児嘔吐
Ｃｒｏｎｋｈｉｔｅ−Ｃａｎａｄａ症候群	クロンカイト・カナダ症候群	Ｅｕｔｈｙｒｏｉｄ　Ｓｉｃｋ症候群
貧血傾向	貧血	症候性貧血
右中大脳動脈梗塞	内頚動脈塞栓症	脳外主幹動脈閉塞脳梗塞
脾臓結核	結核	肝結核
高浸透圧血症	高血糖高浸透圧症候群	低浸透圧血症
両下肢軽度浮腫	下肢浮腫	上肢浮腫
多形紅斑型薬疹	薬疹	紫斑型薬疹
静脈内腫瘍栓	腫瘍	静脈性血管腫
進行再発大腸癌	大腸癌	遺伝性大腸癌
胃接合部癌	胃癌	食道胃接合部癌
手足しびれ	しびれ感	手指先しびれ
内膜損傷	損傷	硬膜損傷
胃小彎側ＬＮ転移	胃周囲リンパ節転移	腹腔リンパ節転移
非浸潤性膀胱癌	膀胱癌	転移性膀胱癌
脂肪腫摘出	脂肪腫	胃脂肪腫
咽頭知覚障害	咽頭異常感症	咽喉頭知覚麻痺
急性胆嚢胆管炎	胆管炎	急性胆管炎
扁平上皮癌	癌	転移性扁平上皮癌
内痔核脱出	内痔核	脱出性内痔核
重症鬱血性心不全	うっ血性心不全	慢性うっ血性心不全
左乳癌特	乳癌	多発乳癌
Ａ型溶連菌感染症	溶連菌感染症	Ｂ群溶連菌感染症
悪性副腎外褐色細胞腫	褐色細胞腫	副腎皮質の悪性腫瘍
傍隔壁型肺気腫	肺気腫	一側性肺気腫
角膜糜爛	角膜びらん	角膜瘢痕
骨盤内播種新生	骨盤転移	脊髄播種
急性非代償性心不全	心不全	急性心不全
最近便秘	便秘症	習慣性便秘
１型高ウイルスＣ型慢性肝炎	Ｃ型慢性肝炎	急性ウイルス性肝炎
Ｌｉｓｔｅｒｉａ腸炎	細菌性腸炎	ＭＲＳＡ腸炎
ヒリヒリ感	疼痛	ピリピリ感
大動脈弁下心室中隔欠損	心室中隔欠損症	筋性部心室中隔欠損
右傍矢状静脈洞髄膜腫	髄膜腫	傍矢状洞髄膜腫
心尖部型肥大型心筋症	肥大型心筋症	心尖部肥大型心筋症
腎不全保存期	腎不全	末期腎不全
口腔内炎	口内炎	口腔粘膜炎
びまん性大細胞	びまん性大細胞型Ｂ細胞性リンパ腫	びまん性星細胞腫
大うつ病	単極性うつ病	うつ病
肝門部悪性リンパ腫	肝門部リンパ節転移	肝脾Ｔ細胞リンパ腫
精神病性うつ病	うつ病	反復性精神病性うつ病
水疱性類天疱	水疱症	水疱性類天疱瘡
中枢性低換気	換気量減少	心因性過換気
右膝ＡＣＬ損傷	前十字靱帯損傷	膝窩血管損傷
混合難聴	難聴	混合性難聴
毛孔一致性丘疹	丘疹	ピンタ性丘疹
先天性巨大色素性母斑	巨大母斑細胞母斑	非新生物性母斑
新出肺転移	転移性肺腫瘍	肺移植後
左聴器癌	癌	内耳癌
上腹部リンパ節転移	リンパ節転移	腹腔リンパ節転移
被殻梗塞	被殻出血	甲状腺梗塞
直腸Ｒａｂ癌	直腸癌	ＫＲＡＳ遺伝子野生型直腸癌
本日硬便少量	便異常	大量便
リンパ節圧痛	圧痛	ＭＰ関節痛
小血栓	血液凝固異常	脳血栓症
右耳失聴	聴覚消失	無難聴性耳鳴
炎症性脱髄性多発根神経炎	慢性炎症性脱髄性多発神経炎	多発性脊髄神経根炎
上行結腸腫瘤	腫瘤	大腸腫瘤
疾病不安	不安障害	不安うつ病
肺癌手術	肺癌	肺癌検診
膿貯留	膿瘍	卵管留膿症
片側副腎腫瘍	副腎腫瘍	男性化副腎腫瘍
リンパ節腫脹	リンパ節腫大	後頭部リンパ節腫脹
右椎骨動脈巨大血栓化動脈瘤	椎骨動脈瘤	鎖骨下動脈瘤
安心感	心気症	悪心
左鼡径ヘルニア再発	鼡径ヘルニア	再発性鼡径ヘルニア
暗青色斑	青色母斑	黄色斑眼底
ＨＣＶ陽性	Ｃ型肝炎ウイルス感染	ＰＣＷＨ
感染性静脈血栓症	静脈血栓症	急性静脈血栓症
過敏性膀胱炎	膀胱炎	急性膀胱炎
包交時出血	出血	性交後出血
外傷性変化	外傷	多発性外傷
中等度精神遅滞	中等度知的障害	自閉性精神発達遅滞
リポフスチン沈着	神経セロイドリポフスチン症	ムチン沈着症
中等度ＣＯＰＤ	慢性閉塞性肺疾患	ＳＣＣ高値
胸部圧痛	圧痛	腹部圧痛
気分不快症状	悪心	腹部不快感
乳突蜂巣	乳様突起炎	頭皮蜂巣炎
褥創形成	褥瘡	腟開放創
ガマ腫	がま腫	ゴム腫
夜間せん妄状態	せん妄	夜間せん妄
神経系腫瘍	腫瘍	神経細胞腫瘍
先天性側弯	肋骨異常を伴う先天性側弯症	特発性側弯症
非定型抗酸菌肺炎	肺炎	細菌性肺炎
手足痺れ	四肢しびれ	手足症候群
節外性濾胞辺縁帯リンパ腫	脾辺縁帯リンパ腫	原発性皮膚濾胞中心リンパ腫
Ｋｌｅｂｓｉｅｌｌａ　ｐｎｅｕｍｏｎｉａｅ敗血症	新生児クレブシエラ敗血症	ＭＲＳＡ敗血症
外腸骨域リンパ節腫大	リンパ節腫大	腸間膜リンパ節腫脹
貧血高度	貧血	慢性貧血
分化型管状腺癌	癌	前立腺小細胞癌
孤発性ＣＪＤ	孤発性クロイツフェルト・ヤコブ病	ＡＩＤＳ
食道がん	食道癌	食道びらん
肛門部発赤	発赤	咽頭発赤
小脳転移	転移性脳腫瘍	小脳疾患
腫瘍指摘	腫瘍	脳腫瘍摘出術後遺症
非浸潤性尿路上皮癌	尿管尿路上皮癌	尿道尿路上皮癌
両上肢痺れ	上肢しびれ	上肢麻痺
混合性肝癌	肝癌	混合型肝癌
甲状腺痛	甲状腺炎	前立腺痛
不消化便	消化不良性下痢	排便習慣の変化
末梢性めまい	めまい症	末梢性めまい症
四肢型運動失調	運動失調	四肢運動障害
左脛腓骨骨折	腓骨骨折	脛骨腓骨骨折
先天性脳血管異常	脳動静脈奇形	先天性脳異常
臀部皮疹	発疹	腰殿部帯状疱疹
歩行時軽度跛行	跛行	よろめき歩行
心室中隔扁平化	心室中隔欠損症	鏡像型心房配列
フルニエ壊疽	外陰部壊死性筋膜炎	ガス壊疽
卵巣癌破裂	卵巣癌	卵巣腫瘍破裂
歯牙損傷	切歯破折	眼損傷
両側乳糜胸水	胸水貯留	胎児胸水
尿漏れ	尿失禁症	混濁尿
髄液播種	腹膜播種	脊髄播種
後頭部皮下血腫	頭部皮下血腫	側頭部皮下血腫
ＭＲＳＡ菌血症	ＭＲＳＡ感染症	ＭＲＳＡ保菌者
篩骨蜂巣	篩骨洞炎	篩骨洞のう胞
仮性動脈瘤切除	偽性動脈瘤	食道静脈瘤破裂
鼻中隔血腫	血腫	鼻中隔出血
左嗅裂ポリープ	ポリープ	上顎洞ポリープ
軽度失調性構音障害	構音障害	発達性構音障害
びらんからの出血	出血	点状出血
動揺性精神神経症状	神経症	精神神経症
過呼吸気味	過換気症	口呼吸
真菌性感染性心内膜炎	細菌性心内膜炎	感染性心内膜炎
未分類関節炎	関節炎	ＤＩＰ関節炎
骨突出部発赤	発赤	下腿発赤
右浸潤影	胸部異常陰影	下肺野陰影
四肢近位筋筋力低下	筋力低下	四肢筋力低下
右乳腺良性腫瘍	乳腺腫瘍	乳房良性腫瘍
イレウス気味	偽性イレウス	機械的イレウス
前立腺癌死	前立腺癌	前立腺癌再発
再度皮疹	発疹	ＬＥ皮疹
低形成	骨髄低形成	舌低形成
血管原性浮腫	浮腫	血管神経性浮腫
Ｂｌｕｅ　ｔｏｅ　ｓｙｎｄｒｏｍｅ	末梢動脈疾患	Ｅｕｔｈｙｒｏｉｄ　Ｓｉｃｋ症候群
嚢胞様腫瘤像	腫瘤	顎下腺腫瘤
婦人科癌	癌	女性性器癌
両側眼振	眼振	特発性眼振
爪水虫	爪白癬	眼虫症
過活動型せん妄	せん妄	認知症に重なったせん妄
左下肢鬱滞性皮膚炎	うっ滞性皮膚炎	自家感作性皮膚炎
ＢＰＳＤ	認知症に重なったせん妄	ＨＤＬＳ
汎発性水痘感染症	水痘	ＭＲＳＡ感染症
えん下障害	嚥下障害	てんかん
左側頭葉挫傷	脳挫傷	前頭部挫傷
虚血性肝炎	肝炎	慢性肝炎
幽門前部狭窄	幽門狭窄症	術後幽門狭窄
圧迫移植部ネクローシス	壊死	ペースメーカ植え込み後皮膚圧迫壊死
舌乾燥	口腔乾燥症	口唇乾燥
円形紅斑	紅斑症	多形紅斑
左眼後発性白内障	白内障	先天性白内障
膵尾部腫瘤性病変	膵腫瘤	膵体尾部腫瘍
重症腸炎	腸炎	急性腸炎
左大腿骨転子下骨折	転子下骨折	大腿骨転子部骨折
肺野すりガラス状陰影	肺野異常陰影	肺野円形陰影
アテローム性血栓性脳梗塞	血栓性脳梗塞	アテローム血栓性脳梗塞
診察時皮疹	発疹	皮膚過敏症
切開関連性心房粗動	心房粗動	一過性心房粗動
術後不整脈	不整脈	術中不整脈
起床時咳嗽	咳	慢性咳嗽
血性腹水貯留	腹水症	血性腹水
心理的不安	不安障害	不安うつ病
右小細胞癌	小細胞肺癌	殿部基底細胞癌
多源性ＰＶＣ散発	心室期外収縮	周期性ＡＣＴＨ・ＡＤＨ放出症候群
原発性甲状腺機能低下	甲状腺機能低下症	原発性甲状腺機能低下症
ヨードアレルギー	ヨード過敏症	アレルギー
右ＩＣ動脈瘤	内頚動脈脳動脈瘤	大動脈瘤
活動性肝炎	肝炎	活動性慢性肝炎
排便なし	便秘症	排便障害
全身性Ｃａｎｄｉｄａ感染症	カンジダ症	ＭＲＳＡ感染症
顔面神経痛	三叉神経痛	頭部神経痛
疣贅様構造物	疣贅	化膿性疣贅
アルコ−ル性肝硬変	肝硬変症	アルコール性肝硬変
皮質層状壊死	壊死	皮膚壊死
両下肢深部静脈血栓症	下肢静脈血栓症	上肢静脈血栓症
脳炎脳症	脳症	慢性脳炎
辺縁性脳炎	脳炎	辺縁系脳炎
家族性ＣＪＤ	家族性クロイツフェルト・ヤコブ病	ＡＩＤＳ
圧迫時疼痛	疼痛	慢性疼痛
症型Ａ群溶連菌感染症	溶連菌感染症	Ｂ群溶連菌感染症
末梢肺動脈塞栓症	動脈塞栓症	肺動脈血栓塞栓症
歩容困難	歩行障害	歩行困難
脳室出血	出血	脳室内出血
顔面痺れ	しびれ感	顔面痙攣症
重度失調性構音障害	構音障害	機能性構音障害
卵巣癌Ⅲｃ期	卵巣癌	卵巣胎児性癌
低血糖鞘状	低血糖	髄液糖値低下
発赤潰瘍	発赤	陰唇潰瘍
左下肺浸潤影	肺部異常陰影	下肺野陰影
右大脳動脈未破裂動脈瘤	脳動脈瘤	未破裂脳動脈瘤
ｃｅｌｌ　ｌｅｕｋｅｍｉａ	白血病	ＣＡＲＡＳＩＬ
失語持続	失語症	全失語症
ＧＣＡ	巨細胞動脈炎	ＨＣＡＨＣ
大動脈弁硬化症	大動脈弁狭窄症	大動脈弁弁膜症
ＡＣＴＨ非依存性Ｃｕｓｈｉｎｇ症候群	クッシング症候群	Ｅｕｔｈｙｒｏｉｄ　Ｓｉｃｋ症候群
次週左気胸	気胸	新生児気胸
Ｍａｌｌｏｒｙ−Ｗｅｉｓｓ症候群	マロリ・ワイス症候群	Ｅｕｔｈｙｒｏｉｄ　Ｓｉｃｋ症候群
ドレーン出血	出血	後出血
副鼻腔転移	副鼻腔癌	副鼻腔異物
原発不明癌頸部転移	原発不明癌	多発性癌転移
再発腫瘤	腫瘤	化膿性腫瘤
犬吠様咳嗽	咳	アトピー咳嗽
左室ブロック波形	心電図異常	心室内ブロック
有痛性腫瘤	腫瘤	化膿性腫瘤
起床時頭痛	頭痛	一次性頭痛
Ⅱ型房室ブロック	房室ブロック	モビッツ２型第２度房室ブロック
慢性下気道感染	急性気管支炎	連鎖球菌性上気道感染
乳頭様腎盂腫瘍	腎盂乳頭状癌	腎盂乳頭腫
喀痰付着	喀痰	過剰喀痰
ＳＣＤ	脊髄小脳変性症	ＨＤＬＳ
無症候性腸アメーバ症	腸アメーバ症	慢性腸アメーバ症
手首痛	手部痛	足痛
地誌的失認	失認	病態失認
両側副腎腫瘍	副腎腫瘍	非機能性副腎腫瘍
左顔面痛覚障害	片側痛覚鈍麻	非定型顔面痛
粘膿性鼻汁	鼻汁	粘液性鼻漏
膣原発横紋筋肉腫	横紋筋肉腫	精巣横紋筋肉腫
卵巣嚢腫ＯＰ	卵巣のう腫	卵巣門細胞腫
子宮筋肉腫	子宮肉腫	子宮平滑筋肉腫
肺血管陰影増強	肺血管疾患	肺門部異常陰影
頭頸部放線菌症	放線菌症	顎放線菌症
Ｈｏｄｇｋｉｎ　Ｌｙｍｐｈｏｍａ	ホジキンリンパ腫	ＭＮＧＩＥ
術後創感染	術後膿瘍	術後創部感染
右下葉扁平上皮癌	下葉肺扁平上皮癌	転移性扁平上皮癌
咳嗽法	咳	慢性咳嗽
高リスク前立腺癌	前立腺癌	進行性前立腺癌
膿梗塞	脳梗塞	全膿胸
下大静脈狭窄	大静脈狭窄症	静脈狭窄
火傷	熱傷	外傷
入眠困難感	不眠症	全身倦怠感
非定型カルチノイド腫瘍	カルチノイド	異所性ＡＣＴＨ産生腫瘍
軽度食欲低下	食欲不振	神経性食欲異常
両下腿壊疽性膿皮症様潰瘍	膿皮症	下腿難治性皮膚潰瘍
恥骨骨髄炎	骨髄炎	恥骨骨炎
かすみ目	視力低下	爪かみ
眩暈消失	めまい	起立性眩暈
手指関節腫脹	関節炎	足関節腫脹
ＳＰＮ	充実性偽乳頭状腫瘍	ＰＣＷＨ
左足背発赤	下腿発赤	発赤
慢性的な呼吸困難	呼吸困難	発作性呼吸困難
低酸素虚血性脳症	低酸素性脳症	新生児低酸素性虚血性脳症
膵臓癌術後再発	膵癌	膵管癌
歩行ふらつき	めまい	よろめき歩行
結腸縫合不全	縫合不全	結腸回転不全
紅色腫瘤	腫瘤	皮膚腫瘤
神経アミロイドーシス	アミロイドーシス	神経サルコイドーシス
咽頭粘膜発赤	発赤	咽頭発赤
新生児死亡	原因不明の死亡	新生児仮死
腎結石多発	腎結石症	多発性腎結石
外表奇形	奇形	外鼻奇形
Ｉｓｐポリープ	大腸ポリープ	ポリープ
咽頭部発赤	発赤	咽頭発赤
頭部腫瘍	頭部皮下腫瘍	足部腫瘍
遅発性発疹	発疹	特発性発疹
肺炎悪化	肺炎	急性肺炎
骨外腫瘤形成	腫瘤	骨腫瘤
低悪性度Ｂ細胞性リンパ腫	びまん性大細胞型Ｂ細胞性リンパ腫	高齢者ＥＢＶ陽性びまん性大細胞型Ｂ細胞性リンパ腫
単形性ＶＴ	非持続性心室頻拍	ＴＳＨ単独欠損症
特発性心室細動	心室細動	一過性心室細動
白色調腫瘍	腫瘍	結節性黄色腫
Ｇｏｔｔｒｏｎ徴候	ゴットロン丘疹	Ｅｕｔｈｙｒｏｉｄ　Ｓｉｃｋ症候群
脊柱起立筋膿瘍	筋膿瘍	高位筋間膿瘍
胃癌幽門狭窄	幽門狭窄症	胃幽門部癌
拡張能障害	心不全	急速拡大装置不適合
小腸静脈瘤破裂	食道静脈瘤破裂	胃静脈瘤破裂
中枢性甲状腺機能低下症	甲状腺機能低下症	原発性甲状腺機能低下症
左肺動脈閉塞	肺動脈狭窄症	肺動脈弁閉鎖
単純性網膜症	網膜症	慢性網膜症
Ｈｅｎｏｃｈ−Ｓｃｈｏｎｌｅｉｎ紫斑病	ＩｇＡ血管炎	Ｅｕｔｈｙｒｏｉｄ　Ｓｉｃｋ症候群
右胸腔内腫瘍	腫瘍	胸壁腫瘍
尿もれ	尿失禁症	残尿感
下肢筋力低下自覚	筋力低下	上肢筋力低下
右足静脈瘤	静脈瘤	下肢静脈瘤
上気道浮腫	咽頭浮腫	声門上浮腫
吻合部浮腫	浮腫	足部浮腫
Ｃａｐｎｏｃｙｔｏｐｈａｇａ　ｃａｎｉｍｏｒｓｕｓ感染症	グラム陰性菌感染症	ＭＲＣＮＳ感染症
口腔内乾燥	口腔乾燥症	口内乾燥
ヘルペス髄膜炎	髄膜炎	ヘルペスウイルス髄膜炎
左股関節破壊	股関節症	股関節損傷
膠原繊維性腸炎	腸炎	ＭＲＳＡ腸炎
食道期軽度障害	嚥下障害	食道通過障害
右外腸骨静脈狭窄	静脈狭窄	外腸骨動脈狭窄
呼内疾患ベース肺炎	肺炎	人工呼吸器関連肺炎
白色粘性痰	喀痰	膿性痰
血腫像	血腫	頭部血腫
ｌｙｍｐｈｏｍａ	悪性リンパ腫	ＡＶＭ
左足首骨折	足関節骨折	足背骨折
掻痒等	そう痒	症候性そう痒症
子宮筋腫大	子宮筋腫	巨大子宮筋腫
抑うつあり	うつ状態	抑うつ神経症
出血腫脹	出血	腟血腫
急性感音性難聴	感音難聴	騒音性難聴
リンパ節多発転移	多部位リンパ節転移	リンパ節転移
ｉｎｖａｓｉｖｅ　ｔｈｙｍｏｍａ	悪性胸腺腫	ＣＡＤＡＳＩＬ
イレウスリスク高い	イレウス	コンポジットレジンインレー過高
分類不能型免疫不全	免疫不全	分類不能免疫不全症
非典型的胸痛	胸痛	反復性胸痛
棘波	心電図異常	伏針
黄色痰自己喀出	膿性痰	過剰喀痰
心膜腔内播種	転移性心腫瘍	胸膜播種
四肢末端しびれ	しびれ感	四肢端しびれ
胃部分壊死	壊死	腸壊死
転倒受傷	外傷	卒倒
タール便少量	黒色便	大量便
切除不能胃癌	胃癌	残胃癌
後頭葉脳出血	脳出血	小脳出血
隅角結節	虹彩結節	隅角癒着
落ち着かなさ	多動性障害	落ち込み
脊椎多発圧迫骨折	圧迫骨折	胸椎多発圧迫骨折
左傍脊柱筋膿瘍	筋膿瘍	高位筋間膿瘍
Ⅰ型ＤＭ	糖尿病	ＡＩＤＳ
多発ＬＮ転移	多部位リンパ節転移	ＮＬＲＣ４異常症
大腸粘膜癌	癌	大腸粘液癌
大動脈損傷	上大動脈損傷	動脈損傷
仙骨前腫瘤	腫瘤	骨盤内腫瘤
前頭葉脳出血	脳出血	小脳出血
社会不安症	不安神経症	社会不安障害
左頚部食道傍リンパ節転移	リンパ節転移	腋窩リンパ節転移
時折物忘れ	健忘症	不器用
左頬部未分化腺癌	癌	甲状腺未分化癌
ＩＩ型ＤＭ	２型糖尿病	ＡＩＤＳ
脊椎管狭窄	脊柱管狭窄症	頚部脊柱管狭窄症
膨満　グル音正常	腹部膨満	発達性異常
顔面神経麻痺静的再建	顔面神経麻痺	術後顔面神経麻痺
低分化性扁平上皮癌	癌	転移性扁平上皮癌
左房内粘液腫	心臓粘液腫	左心房粘液腫
左肺下葉浸潤影	胸部異常陰影	下肺野陰影
中葉舌区症候群	中葉無気肺	中葉症候群
軟部組織腫瘤	腫瘤	足関節部軟部腫瘤
慢性誤嚥	嚥下障害	異物誤嚥
Ｇｍ敗血症	敗血症	ＧＢＳ敗血症
病的腹水	腹水症	血性腹水
Ｃｈｏｌｅｄｏｃｈｏｃｅｌｅ	総胆管のう腫	ＨＣＡＨＣ
癌再発	癌	前立腺癌再発
肺門腫瘤	縦隔腫瘍	肺腫瘤
右鎖骨転移	骨転移癌	肋骨転移
夕方痛み	疼痛	顔面痛
左側副部痛	側腹部痛	側胸部痛
後腹膜腫瘍上行結腸浸潤	後腹膜腫瘍	上行結腸粘膜下腫瘍
低血糖遷延	低血糖	低血糖発作
重症ＣＭＶ腸炎	サイトメガロウイルス腸炎	ＭＲＳＡ腸炎
ブドウ球菌検出	ぶどう球菌感染症	ＥＳＢＬ産生菌感染症
副腎皮質機能不全	副腎皮質機能低下症	副腎皮質機能亢進症
Ｅｓｃｈｅｒｉｃｈｉａ　ｃｏｌｉ	大腸菌感染症	ＣＡＲＡＳＩＬ
両側網膜剥離	網膜剥離	胞状網膜剥離
肺野肺門部異常陰影	肺門部異常陰影	肺野異常陰影
右房浸潤	乳房悪性腫瘍	前房異物残留
屈筋腱鞘炎	腱鞘炎	手屈筋腱腱鞘炎
肺結節陰影	胸部異常陰影	肺部異常陰影
原発性肺腫瘍	肺腫瘍	転移性肺腫瘍
低悪性度リンパ腫	ホジキンリンパ腫	悪性リンパ腫
回盲部悪性リンパ腫	悪性リンパ腫	眼窩悪性リンパ腫
陰部腫脹	陰のう腫大	胸部腫脹
ＴＡＡ	胸部大動脈瘤	ＡＩＤＳ
腸管皮膚瘻	腸瘻	直腸皮膚瘻
ライン感染	カテーテル感染症	ドライブライン感染
多発擦過傷	擦過創	角膜擦過傷
肺嚢胞感染	肺のう胞	侵襲性肺炎球菌感染症
Ｃｈｕｒｇ−Ｓｔｒａｕｓｓ　症候群	好酸球性多発血管炎性肉芽腫症	Ｅｕｔｈｙｒｏｉｄ　Ｓｉｃｋ症候群
脾結核	結核	肝結核
潰瘍性大腸炎急性増悪	潰瘍性大腸炎	急性潰瘍性大腸炎
肺抗酸菌感染症	肺非結核性抗酸菌症	肺炎球菌感染症
両眼網膜症	網膜症	慢性網膜症
左眼結膜炎	結膜炎	眼瞼結膜炎
右肺原発腺癌	肺腺癌	原発性肺癌
ＣＲＥＳＴ症候群	クレスト症候群	ＶＡＴＥＲ症候群
感覚神経障害	知覚障害	感覚運動障害
脳筋症	ミトコンドリア脳筋症	心筋症
駆細胞型急性リンパ性白血病再発	急性リンパ性白血病	Ｂ細胞性前リンパ球性白血病
膿瘍縮小	膿瘍	脳膿瘍
右後頭葉塞栓性脳梗塞	塞栓性脳梗塞	塞栓性小脳梗塞
肝内転移	転移性肝腫瘍	肝移植後
僧房弁疣贅	疣贅	尋常性疣贅
体幹部発赤	発赤	下腿発赤
慢性突発性血小板減少性紫斑病	血小板減少性紫斑病	慢性特発性血小板減少性紫斑病
下部消化管穿孔	腸穿孔	根管穿孔
Ｔ字杖歩行可能	歩行障害	内転歩行
大腫瘤影	腫瘤	肺腫瘤陰影
ヘルペス性脳炎	サル痘	ヘルペス脳炎
不安症様	不安神経症	不安障害
右前額部痛	前頭部痛	側頭部痛
骨折病変	骨折	病的骨折
下肢骨折	骨折	上肢骨折
アスピリンアレルギー	アスピリン不耐症	アレルギー
固形腫瘍	腫瘍	葉状腫瘍
統合失調症残遺状態	統合失調症	残遺型統合失調症
右上肢不全片麻痺	不全片麻痺	上肢不全麻痺
左大腿蜂窩織炎	蜂窩織炎	大腿部蜂巣炎
頭位性回転性めま	体位性めまい	頭位変換性めまい
口唇紅潮	紅潮	顔面紅潮
開腹腫瘤	腫瘤	後腹膜腫瘤
外側部乳癌	乳癌	乳房上外側部乳癌
両足関節以遠しびれ感	しびれ感	全身のしびれ感
胃のむかつき	悪心	胃びらん
痒疹結節散在	痒疹	結節性痒疹
先天性胆管欠損	胆管先天奇形	先天性胆のう欠損
冠性Ｔ波	心電図異常	非特異的ＳＴ−Ｔ変化
多発胸膜肥厚斑	胸膜肥厚	石綿性胸膜斑
カンジダ眼内炎	眼内炎	カンジダ性口内炎
仙骨部腫瘤	腫瘤	骨腫瘤
帯状疱疹再燃	帯状疱疹	汎発性帯状疱疹
喘息症状	咳喘息	外因性喘息
ふらつく気	よろめき歩行	気うつ
拡張障害型心不全	心不全	特発性拡張型心筋症
アカシジア症状	錐体路障害	ノカルジア症
左肺舌区扁平上皮癌	肺扁平上皮癌	肺門部扁平上皮癌
陳旧性脳出血	脳出血	脳出血後遺症
良性下垂体腫瘍	下垂体腫瘍	下垂体良性腫瘍
左側頭部帯状疱疹	帯状疱疹	後頭部帯状疱疹
頭蓋内出血性病変	非外傷性頭蓋内出血	頭蓋内占拠性病変
閉塞性睡眠呼吸障害	睡眠時無呼吸症候群	閉塞性睡眠時無呼吸
右披裂部腫瘍	腫瘍	眼窩偽腫瘍
両膝変形	変形性膝関節症	前足部変形
表在性腫瘍	腫瘍	良性腫瘍
左母指多指症	副母趾	母指三指節症
アルコール性末梢神経障害	アルコール性多発ニューロパチー	アルコール性神経筋障害
分葉状嚢胞性腫瘤	腫瘤	精巣上体腫瘤
甲状腺肥大	甲状腺疾患	顎下腺肥大
患肢発赤	発赤	下腿発赤
多房性腫瘤	腫瘤	多発性皮下腫瘤
夜間不安	不安障害	不安うつ病
左内耳障害	迷路障害	外耳道異物感
副腎性クッシング症侯群	クッシング症候群	副腎性器症候群
痛く	疼痛	鈍痛
皮疹再燃	発疹	ＬＥ皮疹
子宮筋腫手術	子宮筋腫	子宮筋腫術後
腕頭静脈血栓症	静脈血栓症	前腕静脈血栓症
脊椎病変	脊椎異常	脊椎障害
歯状核	歯状核赤核淡蒼球ルイ体萎縮症	殻状歯
軽度屈曲拘縮	屈曲拘縮	小指屈曲拘縮
ＥＢＶ腸炎	細菌性腸炎	ＭＲＳＡ腸炎
足しびれ	下肢しびれ	しびれ感
膵内分泌腫瘍肝転移	転移性肝癌	転移性肝腫瘍