出現形	正解	予測
副腎原発神経芽腫	副腎神経芽腫	外傷早期てんかん
Ｗｅｎｃｋｅｂａｃｈ型房室ブロック	ウェンケバッハ型第２度房室ブロック	肘部絞扼性神経障害
痰貯留多	喀痰	先天性円錐水晶体
皮膚リンパ腫	菌状息肉症	低カリウム血症
個細胞壊死	壊死	須毛偽毛包のう炎
左大腿骨顆上骨折	大腿骨外顆骨折	胸椎偽関節
病原性大腸菌Ｏ−１５７感染性腸炎	病原性大腸菌感染症	先天性肘脱臼
口腔粘膜浮腫	浮腫	サルコイド筋炎
腟粘膜発赤	発赤	皮膚色異常
レム睡眠行動異常症	レム睡眠行動障害	難治性口内炎
閉塞性膵炎	膵炎	高蛋白血症
脱髄性疾患	脱髄疾患	神経原性壊疽
多発性脾膿瘍	脾膿瘍	鼻前庭せつ
間質性肺水腫	肺水腫	腸瘻
無動性無言	無動性無言症	肺腫瘍
舌扁平上皮癌	舌癌	脳軟化症
両側肺門部浸潤影	胸部異常陰影	ＩＣＵ症候群
軽度悪心	悪心	ビタミンＫ欠乏による凝固因子欠乏
慢性活動性ＥＢウルス感染症	ＥＢウイルス感染症	前額部打撲傷
蛋白尿減少	蛋白尿	急性錯乱状態
脳障害	脳症	歯肉裂創
中心性奬液性網脈絡膜症	中心性漿液性網脈絡膜症	滑膜断裂
左一側性反回神経麻痺	一側性反回神経麻痺	緩徐進行１型糖尿病・関節合併症あり
イレウス様	イレウス	母指切断
膵炎併発	膵炎	続発性血小板減少性紫斑病
ｈｅｍｏｐｈａｇｏｃｙｔｉｃ　ｓｙｎｄｒｏｍｅ	血球貪食症候群	急性腎前性腎不全
抗癌剤漏出	薬剤漏出性皮膚障害	骨盤内軟骨腫
水痘帯状疱疹	帯状疱疹	卵巣損傷
ｓｙｓｔｅｍｉｃ　ｍａｓｔｏｃｙｔｏｓｉｓ	肥満細胞腫症	足どり不安定
発汗多量	多汗症	インレー不適合
早発黄疸	早発性黄疸	エプスタイン病
急性細菌性気管支炎	急性気管支炎	尿道断裂・骨盤腔に達する開放創合併なし
右上葉肺小細胞癌	上葉肺大細胞癌	化学性食道炎
腟癌１期	腟癌	上腕前腕骨折
会陰部発赤	発赤	黄斑障害
嚥下時痛軽度	嚥下痛	強膜化角膜
左顔面血管腫	顔面血管腫	足蹠青色母斑
鼻汁多く	鼻汁	慢性子宮留膿症
口腔内出血痕	口腔出血	陰茎腫瘤
ＳＩＡＤ	抗利尿ホルモン不適合分泌症候群	足どり不安定
夜両足痛	足痛	下腿筋腱移行部損傷
左後頭葉梗塞	脳梗塞	副卵管捻転
左内眼角基底細胞癌	眼角基底細胞癌	侏小骨盤による分娩停止
難治性イレウス	イレウス	母指切断
副鼻腔腫瘍	鼻副鼻腔腫瘍	ぶどう球菌性扁桃炎
大腸菌菌血症	菌血症	副甲状腺先天奇形
右前頭葉出血	脳出血	特発性じんま疹
左膝部痛	膝窩部痛	脳脊髄炎
仙椎陳旧性骨折	陳旧性骨折	ピンタ性角化症
乳癌既往	乳癌	先天性白内障
軽度咽頭発赤	咽頭発赤	後縦隔脂肪肉腫
痙攣起	痙攣	腹痛症
下肢浮腫圧痕	下肢浮腫	恥骨部打撲
左側頬部腫脹	頬部腫脹	心超音波検査異常
心室中隔穿孔	心室中隔欠損症	鼻背基底細胞癌
四肢浮腫軽度	四肢浮腫	出血性外痔核
大腸ポリープ　ポリペク後	大腸ポリープ	肝線維症
腰椎椎体椎間板炎	腰椎椎間板炎	息切れ
左下葉肺炎悪化	大葉性肺炎	開放性矢状洞部硬膜外血腫
ぼんやり感持続	反応性低下	鎖骨下静脈狭窄
右鼠径部痛	鼡径部痛	顎下腺膿瘍
皮疹不変	発疹	斑状歯
創部痛	術創部痛	大転子開放骨折
軽度右気胸	気胸	臍帯卵膜付着
腸閉塞歴	イレウス	テント上下髄膜腫
左大腿骨骨折	大腿骨骨折	小腸出血
紅斑局面多発	紅斑症	大腸腫瘤
下部進行食道癌	食道癌	単純型統合失調症
無γグロブリン血症	無ガンマグロブリン血症	低カリウム血性ミオパチー
子宮頸管ポリープ切除	子宮頚管ポリープ	眼瞼蜂巣炎
手首疼痛	疼痛	下腿筋腱移行部損傷
ｓｐｌｅｎｉｃ　ｍａｒｇｉｎａｌ　ｚｏｎｅ　ｌｙｍｐｈｏｍａ	脾辺縁帯リンパ腫	瞳孔不同症
体動時息ぎれ	労作時呼吸困難	肺扁平上皮癌
一部浮腫	浮腫	片頭痛
ふらつき注意	よろめき歩行	脂腺腫
左中耳炎	中耳炎	新生児クラミジア感染症
胃食道逆流症状	胃食道逆流症	腋窩多汗症
両側卵巣子宮内膜症性嚢胞	卵巣子宮内膜症のう胞	未破裂椎骨動脈解離
新出肝転移	転移性肝癌	小脳橋角部髄膜腫
脊椎カリエス	脊椎結核	趾節間関節捻挫
行動障害	素行障害	耳小骨融合
妊娠性糖尿病	妊娠糖尿病	既往子宮術後分娩
小豆大紅斑	紅斑症	大腸腫瘤
ＦＳＧＳ	巣状糸球体硬化症	急性腎前性腎不全
左寛骨臼骨折	寛骨臼骨折	橈側手根屈筋腱不全断裂
原発性両眼内悪性リンパ腫	眼窩悪性リンパ腫	新生児気胸
腹腔鏡補助下子宮筋腫核	子宮筋腫	心因性頻脈
両下肢静脈血栓	下肢静脈血栓症	小指ＰＩＰ関節捻挫
神経根障害	神経根炎	先天性僧帽弁狭窄兼閉鎖不全症
クモ膜下出血	くも膜下出血	顎骨インプラント予後不良
後鼻汁症候群	後鼻漏	肝脾腫
糖尿病性腎症１期	腎性糖尿	鼻部第３度熱傷
左臀部慢性膿皮症	慢性膿皮症	鎮静薬による急性精神・行動障害
メサンギウム増殖性腎炎	メサンギウム増殖性糸球体腎炎	漿膜下子宮平滑筋腫
左前頭葉心原性脳梗塞	心原性脳塞栓症	開放性脾損傷
閉塞性尿路感染	尿路感染症	心室中隔欠損を伴う肺動脈閉鎖症
顔面蝶形紅斑	ＬＥ蝶形皮疹	大腸腫瘤
上行結腸癌肝転移	転移性肝癌	ヘモジデリン沈着症
仙骨部色素沈着	色素異常症	足関節ガングリオン
肥満糖尿病	糖尿病	下腿多発性開放創
左肩痛み	肩部筋痛	肩甲腓骨型脊髄性筋萎縮症
ＰＳＶＴ発作	発作性上室頻拍	急性腎前性腎不全
顎変形症術後顎変形症	顎変形症	地方病性クレチン病
ＤＭＮ　２期	糖尿病	瞳孔不同症
労作時胸部絞扼感	胸内苦悶	尿道瘻開口部に対する手当て
右膝変形	変形性膝関節症	腸回転異常
指趾潰瘍	趾皮膚潰瘍	慢性化膿性中耳炎
２型食道癌	食道癌	皮膚萎縮症
骨性腫瘤	腫瘤	総腸骨動脈損傷
外傷性脊髄損傷	脊髄損傷	ＭＲＳＡ保菌者
下肢結節性紅斑	結節性紅斑	胸壁蜂巣炎
左動眼神経麻痺	動眼神経麻痺	肺好酸球性肉芽腫症
家族性海綿状血管腫	海綿状血管腫	閉経後骨粗鬆症・骨盤部病的骨折あり
術中直腸損傷	直腸損傷	妊娠中の麻酔による脳無酸素症
下肢動脈瘤	下肢の動脈瘤	オロプーシェウイルス病
精神病様症状	精神病	骨腫瘤
項頸部痛	頚部痛	下肢静止不能症候群
頸部白斑	白斑	胸部交感神経損傷
左大腿骨転子部粉砕骨折	転子下骨折	股関節部開放創
最近眠気	非器質性過眠症	水痘髄膜炎
ＶＨＤ	心臓弁膜症	急性腎前性腎不全
夜頻尿	夜間頻尿症	ウイルス性扁桃炎
回盲部炎	回盲部憩室炎	手青色母斑
重症肺血栓塞栓症	肺塞栓症	コンポジットレジン粗造
左歯痛	歯痛	大動脈石灰化症
腹膜播種切除	腹膜播種	外耳部割創
右乳突蜂巣	乳様突起炎	上咽頭後壁癌
右肺尖部気胸	気胸	上肢脱出
骨盤内子宮内膜症	子宮内膜症	幻肢
左頬部痛	頬部痛	老人性眼瞼外反症
局麻薬アレルギー	薬物過敏症	急性出血性膀胱炎
肺クリプトコックス症	急性肺クリプトコッカス症	多発胃潰瘍
右肩関節亜脱臼半横指	肩関節亜脱臼	示指痛
慢性蕁麻疹	慢性じんま疹	多源性心室期外収縮
マラセチア毛嚢炎	マラセチア毛包炎	頭部基底細胞癌
高分化型漿液性腺癌	癌	随意性脱臼
腫瘍床	腫瘍	中毒性好中球減少症
左膀胱尿管逆流症	膀胱尿管逆流	ハッサル・ヘンレ疣
外側疼痛	疼痛	膀胱外反症
卵巣癌再発卵巣癌	卵巣癌	胸椎軟骨肉腫
錐体路病変	錐体外路系疾患	胸椎結核
リンパ球性白血病	リンパ性白血病	心房粗動
クラミジア感染	クラミジア感染症	滲出型加齢黄斑変性
奬液性嚢胞腺腫	膵漿液性のう胞腺腫	多乳頭症
夜間倦怠感	倦怠感	全部性歯髄炎
脳血栓塞栓症	脳血管閉塞性脳梗塞	ベルナール・スーリエ症候群
左リウマチ性肘関節症	関節リウマチ・膝関節	健忘性失語症
右下腿潰瘍感染	下腿皮膚潰瘍	急性側壁心筋梗塞
気分不快時	悪心	角結膜擦過傷
問題なし前立腺肥大	前立腺肥大症	示指屈筋腱損傷
急性パルボウイルスＢ１９感染症	パルボウイルス感染症	外傷性血管攣縮性症候群
脂肪性腫瘤	脂肪腫	急性脛骨骨髄炎
ウィルス性肺炎	肺炎	記憶障害
類円形紅斑	紅斑症	大腸腫瘤
書字不能	書痙	耳介後部腫脹
肺動脈狭窄	肺動脈狭窄症	足底角化症
夜間不眠状態	不眠症	遊走性紅斑
熱型	発熱	シトリン欠損症
骨盤内充実性腫瘍	骨盤腫瘍	急性間欠性ポルフィリン症
夢遊病	夢遊症	新生児皮膚硬化症
脊髄小脳変性症６型	脊髄小脳変性症	一絨毛膜二羊膜性双胎
左内頚動脈閉塞	内頚動脈閉塞症	回腸憩室症
両側角乾燥性結膜炎	結膜炎	環指屈筋腱癒着
脳虚血症状	脳虚血症	多発性期外収縮
微熱持続	微熱	尺骨遠位部骨髄炎
夕方浮腫	浮腫	切歯破折
眼性疲労	眼精疲労	腸動静脈奇形
直腸肛門奇形	鎖肛	テント下脳腫瘍
右大腿部腫瘍	大腿悪性軟部腫瘍	肛門結核
頚椎症神経根症	頚椎症性神経根症	肘関節外側側副靱帯損傷
壊死性遊走性紅斑	遊走性紅斑	左室肥大
睡眠障害招くリスク	睡眠障害	眼窩筋炎
上大静脈血栓	静脈血栓症	上行結腸神経内分泌腫瘍
骨盤内ＬＮ転移	骨盤内リンパ節転移	前眼部形成異常
ＰＫＤ	多発性のう胞腎	急性腎前性腎不全
分水嶺脳梗塞	脳梗塞	角膜軟化
上皮性腫瘍	腫瘤	若年性骨粗鬆症
大球性正色素貧血	大球性貧血	麻痺性股関節脱臼
挙上空腸穿孔	腸穿孔	肝疾患に伴う貧血
腸管アメーバ感染症	腸アメーバ症	頚動脈小体良性腫瘍
放射線性皮膚炎	放射線皮膚炎	翼状頚
肛門周囲びらん	外痔びらん	急性熱性皮膚リンパ節症候群
髄膜炎徴候	髄膜炎	ワンサン気管支炎
胸部不快	胸内苦悶	貧血母斑
下葉肺炎	肺炎	先天性尿道奇形
右足根部粉砕骨折	粉砕骨折	声帯不全麻痺
蛋白漏出胃腸症	蛋白漏出性胃腸症	セクショナルアーチ破損
左大脳陳旧性ラクナ梗塞	陳旧性ラクナ梗塞	晩発閉経
出血多量	急性大量出血	クロム親和性芽細胞腫
腹水多量	腹水症	胎児発育過度
腸間膜リンパ管腫	リンパ管腫	飛び込み自殺
右卵巣悪性腫瘍	卵巣悪性腫瘍	ゴナドトロピン単独欠損症
糖尿病（２型）	２型糖尿病	硬膜下血腫・頭蓋内に達する開放創合併なし
化膿性胸鎖関節炎	化膿性関節炎・胸鎖関節	上斜筋腱鞘症候群
右乳腺線維腫症	線維腫	子宮体部筋腫
肺野鬱血像	肺野異常陰影	外傷性脳圧迫・頭蓋内に達する開放創合併なし
児嘔気	嘔気	三尖弁閉鎖症
尿閉歴	尿閉	晩期梅毒性聴神経炎
陰嚢びらん	陰のうびらん	上腕神経根炎
精神的ショック	ショック	巨赤芽球性貧血
右上腕骨外側上顆炎	外側上顆炎	間欠性外斜視
子宮頚上皮内癌	子宮頚部上皮内癌	フェナセチン中毒
難治性非定型性抗酸菌症	非結核性抗酸菌症	大脳石灰沈着症
軽度腹水	腹水症	胎児発育過度
湿疹様	湿疹	悪性虫垂粘液瘤
大後頭孔狭窄	軟骨形成不全症	ベネズエラ出血熱
熱型変化	発熱	前胸部摩擦音
右無機能腎	無機能腎	薬物誘発性筋強直症
月経痛コントロール不十分	月経痛	反応性てんかん
左鎖骨下動脈閉塞	鎖骨下動脈閉塞症	肥大性歯肉炎
右ＤＶＴ	深部静脈血栓症	急性腎前性腎不全
非特異的胸痛	胸痛	急性本態性浮腫
Ａｅｒｏｍｏｎａｓ　ｈｙｄｒｏｐｈｉｌａ敗血症	敗血症	赤外線白内障
重症細菌性敗血症	敗血症	後発白内障
逆行性健忘	逆向性健忘	陳旧性尺骨茎状突起骨折
腹直筋膜下血腫	筋肉内血腫	尿道下裂
関連腎臓病	腎疾患	コフィン・ローリー症候群
認知症様症状	認知症	ＭＬＬ再構成型Ｂリンパ芽球性白血病／リンパ腫
顎骨骨折	下顎骨骨折	ネラトン症候群
高度大動脈弁狭窄	大動脈弁狭窄症	骨盤ストレイン
右顔面骨骨折	顔面骨骨折	外耳道皮膚良性腫瘍
炎症性粉瘤	粉瘤	喉頭狭窄症
左腰部疼痛	腰痛症	手指多発骨折
ＨＣＶ重複感染症	Ｃ型肝炎ウイルス感染	外耳道異物
脂質異常症（＋）	脂質異常症	若年性パーキンソン病Ｙａｈｒ４
上腹部圧痛	腹部圧痛	スティフ・マン症候群
両側椎骨動脈瘤	椎骨動脈瘤	舌咬傷
非ケトン性高血糖	高血糖高浸透圧症候群	頚腕捻挫
Ｙｅｒｓｉｎｉａ腸炎	エルシニア腸炎	バベシア症
声帯浮腫	声帯炎	インフルエンザ菌性先天性肺炎
誤嚥性肺炎併発	誤嚥性肺炎	塩素ガス中毒
咳嗽持続	咳	マーデルング変形
左側下顎骨嚢胞	顎骨のう胞	筋無力症
右末梢前庭障害	末梢前庭障害	絶対緑内障
胆管閉鎖症	胆管閉塞症	鎖骨骨幹部骨折
閉塞性動脈硬化症　症状	閉塞性動脈硬化症	前胸部第２度熱傷
洞不全	洞不全症候群	ジュベール症候群
特発性リンパ浮腫	リンパ浮腫	結膜熱傷
シャント吻合部狭窄	透析シャント狭窄	食道リンパ管腫
無気力	無力症	小指ＰＩＰ関節側副靱帯損傷
胸骨炎	胸骨周囲炎	人工肘関節置換術後
ナッツアレルギー	ピーナッツアレルギー	背部蜂巣炎
甲状腺乳頭癌術後再発	甲状腺乳頭癌	乳児内斜視
上肢疼痛	疼痛	上腕骨変形治癒骨折
Ｔｕｒｎｅｒ症候群	ターナー症候群	唾液瘻
肝臓機能障害用	肝機能障害	耳部丹毒
左心不全徴候	心不全	半椎症
ＩＰＭＮ癌化	膵管内乳頭粘液性腺癌	嗄声
後発頚部転移	頚部転移性腫瘍	解離性健忘
下痢治	下痢症	片側感覚消失
朝方疼痛	疼痛	甲状腺悪性リンパ腫
蜂窩肺形成	蜂窩織炎	頚部リンパ節転移
右ＩＣＡ高度狭窄	内頚動脈狭窄症	外傷性小脳血腫・頭蓋内に達する開放創合併あり
膵体部嚢胞	膵のう胞	ベーチェット病
右気管支狭窄	気管支狭窄症	視神経膠腫
非ヘルペス性辺縁系脳炎	辺縁系脳炎	小指ＰＩＰ関節橈側側副靱帯損傷
無症候性ＶＴ	心室頻拍	陰部神経症
好酸球増多	好酸球増加症	心血管梅毒
口腔清掃	個人衛生の著しいレベル低下	多発性海綿状血管腫
両下腿皮膚潰瘍	下腿皮膚潰瘍	リステリア性脳動脈炎
無石性胆嚢炎	胆のう炎	踵骨腫瘍
ｓ型ポリープ	ポリープ	下咽頭異物
時折頭痛	頭痛	先天性巨爪
関節リウマチ発症	関節リウマチ	腸間膜リンパ節陳旧性結核
残像腫瘍	腫瘍	脳底動脈先端症候群
両顎下腺腫大	顎下腺肥大	先天性直腸瘻
夜間中途覚醒時	睡眠障害	肺コクシジオイデス症
今朝頭痛	頭痛	先天性巨爪
眼球偏移	眼球偏位	薬物誘発性ミエロパチー
腹腔内癒着高度	腹膜癒着	殿部せつ
右母指多指症	多指症	精管狭窄症
薬剤性骨髄抑制	骨髄機能低下	膀胱肉腫
肥満	肥満症	直腸切断術後後遺症
網膜中心動脈閉塞	網膜中心動脈閉塞症	前腕第２度熱傷
中枢神経悪性リンパ腫再発	悪性リンパ腫	白色水腫
旅行者下痢症	下痢症	前腕多発性損傷
右声帯ポリープ	声帯ポリープ	関節内骨折
非Ｂ非Ｃ型肝硬変	肝硬変症	術後冠動脈攣縮症
頭部皮下結節	皮下結節	前胸壁痛
足がむくみ	下肢浮腫	頬部皮下血腫
下肢潰瘍	下肢皮膚潰瘍	大腿骨頚部基部骨折
難治性胸腹水	難治性腹水	肘関節外側側副靱帯捻挫
幻覚症状	幻覚	副腎梗塞
異常腫瘤	腫瘤	胃結核
未破裂脳動脈瘤コイル塞栓	未破裂脳動脈瘤	唾液腺萎縮
左下顎骨慢性骨髄炎	慢性顎骨骨髄炎	小児型筋ジストロフィー
左側頭葉膠芽腫	側頭葉膠芽腫	胃平滑筋肉腫
脳血管障害性パーキンソニズム	脳血管障害性パーキンソン症候群	食道拡張症
右後角脳室内出血	脳室内出血	子宮損傷・骨盤腔に達する開放創合併なし
難治性浮腫	高度浮腫	急性膀胱炎
Ｇｒａｎｕｌｏｍａｔｏｓｉｓ　ｗｉｔｈ　ｐｏｌｙａｎｇｉｉｔｉｓ	多発血管炎性肉芽腫症	足どり不安定
再発脊索腫	脊索腫	小脳のう腫
Ｃ型肝硬変症	Ｃ型肝硬変	家族性地中海熱
左踵部悪性黒色腫	踵部悪性黒色腫	心臓横紋筋肉腫
未分化癌	癌	陳旧性後壁心筋梗塞
両側副腎悪性リンパ腫	悪性リンパ腫	ウィリス動脈輪周囲炎
帯状疱疹無	帯状疱疹	卵巣損傷
左膝痛み	膝関節痛	脳脊髄炎
右下腿痛	下腿痛	髄膜炎菌性球後視神経炎
気管支喘息症状	気管支喘息	乳房よう
大腿骨内顆骨壊死	特発性大腿骨内顆骨壊死	後腹膜膿瘍
炎症性貧血	貧血	関節脱臼後遺症
両下肢掻痒感	皮膚そう痒症	精巣萎縮
右後頭葉脳挫傷	脳挫傷	糸球体腎炎
女性化乳房	女性化乳房症	虫刺性皮膚炎
ｍａｓｓ　ｌｅｓｉｏｎ	腫瘤	足どり不安定
右大脳半球多発脳梗塞	多発性脳梗塞	腋窩神経損傷
大動脈弁膜症	大動脈弁弁膜症	腰椎椎間板断裂
鎮静困難	興奮状態	涙道閉塞症
再発腫瘤近傍	腫瘤	耳介外傷性皮下異物
右下腿麻痺	下肢麻痺	人工歯根上部構造不適合
切除不能多発性肝転移	転移性肝腫瘍	頭皮損傷
腹腔内膿瘍形成	膿瘍	陳旧性塞栓性脳梗塞
発作性上室性頻拍	発作性上室頻拍	薬物禁断症候群
筋肉痛生	筋肉痛	膵頭十二指腸切除後膵液瘻
腰椎滑り症	腰椎すべり症	ムチランス変形
淡血性胸水	血性胸水	エルシニア腸炎
腎被膜下出血	外傷性腎被膜下血腫	萎縮性喉頭気管炎
仙骨部褥瘡痕	仙骨部褥瘡	精巣胎児性癌
左肝腫瘍	肝腫瘍	カプスラーツム肺ヒストプラスマ症
非Ｃｌｏｓｔｒｉｄｉｕｍ性ガス壊疽	ガス壊疽	肘部ガングリオン
リンパ腺腫脹	リンパ節腫大	低カリウム血症
心室二段脈	心室性二段脈	成長ホルモン産生下垂体腺腫
鼻腔腫瘍摘出	鼻腔腫瘍	両側性唇裂
疼痛時頓用	疼痛	月経中間期出血
多房性膿瘍	膿瘍	網膜前出血
右耳介後部痛	耳痛症	外傷性肝破裂・腹腔に達する開放創合併あり
左胸壁腫瘍切除	胸壁腫瘍	高ＬＤＬ血症
無呼吸症候群	無呼吸発作	内因性うつ病
右尿管癌	尿管癌	一過性滑膜炎
出血過多	出血	クロム親和性芽細胞腫
甲状腺嚢腫	甲状腺のう胞	手指中節骨骨折
両側浸出性中耳炎	滲出性中耳炎	輪状軟骨欠損
覚醒度	麻酔覚醒遅延	突発性発熱
高血糖	高血糖症	口唇虫刺傷
有意弁膜症	弁膜炎	下肢弛緩性麻痺
胸痛無	胸痛	ループスアンチコアグラント
右下肺野無気肺	無気肺	喉頭挫滅損傷
小脳性失調	小脳性運動失調症	特発性巨大結腸症
好酸球増多症	好酸球増加症	心血管梅毒
右腎明細胞肉腫	腎明細胞肉腫	下大静脈拡張
甲状腺左葉濾胞腺腫	濾胞性甲状腺腺腫	急性甲状腺炎
下位運動ニューロン徴候	運動ニューロン疾患	ショパール関節離断術後
主幹動脈狭窄	脳動脈狭窄症	転座トリソミー２１
創部皮下血腫	外傷性皮下血腫	新生児吸引症候群
掻痒感軽減	そう痒	股関節後方脱臼
両肺小結節影	肺野異常陰影	外傷性脳圧迫・頭蓋内に達する開放創合併なし
造影剤アレルギー歴	薬物過敏症	初期う蝕小窩裂溝填塞材破損
左眼鼻涙管閉塞症	鼻涙管閉鎖症	妊娠性肝斑
慢性的な抑うつ気分	うつ状態	先天性卵巣奇形
鼻部異物肉芽腫	皮膚異物肉芽腫	尺側手根屈筋腱不全断裂
遠隔ＬＮ転移	リンパ節転移	急性腎前性腎不全
子宮がん	子宮癌	家族性パーキンソン病Ｙａｈｒ１
Ｂｉｃｋｅｒｓｔａｆｆ型脳幹脳炎	ビッカースタッフ脳幹脳炎	新生児一過性頻呼吸
睾丸腫脹	精巣腫脹	尿管結石症
右中皮腫	中皮腫	良性移動性舌炎
ジベル薔薇色粃糠疹	ジベルばら色粃糠疹	金属の毒作用
脳実質外腫瘍	腫瘍	硬膜下水腫
抑鬱感	気うつ	全部性歯髄炎
扁桃腺腫大	扁桃肥大	ＴＥＬ−ＡＭＬ１陽性Ｂリンパ芽球性リンパ腫
口内出血	口腔出血	陰茎腫瘤
右上方視野欠損	視野欠損	烏口肩峰靱帯捻挫
両側臼蓋形成不全症	臼蓋形成不全	筋ジストロフィー
進行肝癌	肝癌	胎児敗血症
噴門部狭窄	胃狭窄	転移性蝶形骨洞癌
突発性腎出血	腎出血	発作性上室頻拍
前股関節症	股関節症	新生児るいそう
多発肝嚢胞	多発性肝のう胞	発音障害
過換気状態	過換気症	左室右房交通症
傍大動脈ＬＮ	大動脈周囲リンパ節転移	機能的幽門狭窄
左椎骨動脈低形成	骨髄低形成	本態性自律神経症
左房拡張	心拡大	第５趾ボーエン病
サルモネラ菌感染症	サルモネラ感染症	口蓋挫傷
両側性多発性嚢胞腎	多発性のう胞腎	全身型若年性特発性関節炎・股関節
化学物質アレルギー	アレルギー	急性出血性膀胱炎
右手指腫脹	手指腫脹	眼瞼挫傷
右足背発赤	発赤	手背皮膚癌
脊柱管高度狭窄	脊柱管狭窄症	クロード症候群
右急性網膜壊死	急性網膜壊死	閉塞性肝硬変
皮膚硬化がまだかなり	新生児皮膚硬化症	陰唇挫傷
口腔内乾燥軽度	口腔乾燥症	溶連菌敗血症
下肢筋痛	下肢筋肉痛	慢性大腸炎
蠕動不良	異常腸音	耳小骨融合
四肢腱反射亢進	反射亢進	運動失調性脳性麻痺
黒色丘疹	丘疹	広汎型若年性歯周炎
胸部陰影	胸部異常陰影	腰椎炎
クモ膜下嚢胞	くも膜のう胞	マリー失調症
２次性糖尿病	二次性糖尿病	片側感覚異常
Ｈａｅｍｏｐｈｉｌｕｓ　ｉｎｆｌｕｅｎｚａｅ敗血症	敗血症	赤外線白内障
慢性期疼痛	慢性疼痛	月経中間期出血
右上葉原発肺小細胞癌	小細胞肺癌	化学性食道炎
出血源不詳	出血	産褥血栓症
一般細菌感染	細菌感染症	脳幹性前兆を伴う片頭痛
急性小脳失調症	急性小脳性失調症	特発性巨大結腸症
浸潤癌化所見	癌	嗄声
痔核脱出	痔核	先天性無トランスフェリン血症
重症膵炎	膵炎	腎破裂
痛みアリ	疼痛	過酸症
左心室内血栓症	心室内血栓症	気管気管支ジスキネジア
右足疼痛	疼痛	下腿筋腱移行部損傷
増殖前網膜症	網膜症	インフルエンザＢ型
傍神経節腫瘍	傍神経節腫	中指不全切断
小腸膀胱瘻	膀胱皮膚瘻	下腿部第１度熱傷
左小細胞肺癌	小細胞肺癌	感応性妄想性障害
少量左胸水	胸水貯留	エルシニア腸炎
多発ＨＣＣ再発	肝細胞癌	披裂軟骨脱臼
結核性嚢腫	結核	軟口蓋多形腺腫
右大腿骨外顆骨折	大腿骨外顆骨折	散在性表層角膜炎
巨大膵仮性嚢胞	仮性膵のう胞	分娩前出血
大腿腫脹	下腿腫脹	透析シャント静脈高血圧症
全身性ＣＭＶ感染症	サイトメガロウイルス感染症	進行性血管性白質脳症
多発肝内転移	転移性肝腫瘍	ヘモジデリン沈着症
右外耳道炎	外耳炎	歯根近接
両下肢圧痕性浮腫	クインケ浮腫	恥骨部打撲
下部腸間膜動脈出血	動脈性出血	気管支喘息
ＩｇＭ型Ｍ蛋白	単クローン性免疫グロブリン血症	全失語症
喘息発作様症状	気管支喘息発作	正中神経上腕部損傷
分食道癌	食道癌	皮膚萎縮症
多少便秘気味	便秘症	胸水結核菌陽性
ポリープ状病変	ポリープ	下咽頭異物
既往高血圧	高血圧症	母指ＭＰ関節橈側側副靱帯損傷
右リウマチ性膝関節症	関節リウマチ・膝関節	高血圧性眼底
急性骨髄性白血病（ＡＭＬ）	急性骨髄性白血病	先天性肝のう胞
腹水大量	腹水症	胎児発育過度
全身皮膚発赤	発赤	黄斑障害
多発肺嚢胞	肺のう胞	手掌刺創
右小脳橋角部腫瘍	小脳橋角部腫瘍	両側下肢多発骨折
右眼網膜静脈分枝閉塞症	網膜静脈分枝閉塞症	外耳道奇形
右脛骨腓骨開放骨折	脛骨腓骨開放骨折	感染性膵壊死
左側卵巣腫瘍	卵巣腫瘍	足関節第３度熱傷
口腔内びらん	口唇びらん	若年性パーキンソン病Ｙａｈｒ５
紅斑熱群リケッチア症	リケッチア感染症	孔脳症
ＩＴＰ	特発性血小板減少性紫斑病	足どり不安定
気管支喘息小発作	気管支喘息発作	大腿骨骨折後骨癒合不全
解離性動脈瘤破裂	解離性動脈瘤	閉鎖性耳硬化症
左眼窩内腫瘍	眼窩腫瘍	一過性虚血性難聴
肺外小細胞癌	小細胞肺癌	食道異物
高度大動脈弁狭窄症	大動脈弁狭窄症	橈骨動脈断裂
ｂｒｅａｋｔｈｒｏｕｇｈ　ｈｅｐａｔｉｔｉｓ	肝炎	上顎石灰化上皮性歯原性腫瘍
左室圧排	右室肥大	頬部切創
両側声帯外転障害	声帯外転筋麻痺	浮腫性声帯炎
一部水疱形成	水疱症	関節奇形
糖尿病潰瘍	糖尿病性潰瘍	心膜中皮腫
飲みこみにくさ	嚥下障害	亜鉛欠乏性味覚障害
左腎低形成	低形成腎	下腿開放創
左母趾疼痛	母趾痛	迷路機能低下症
副腎ヒストプラズマ感染症	真菌症	足挫創
右眼糖尿病網膜症	糖尿病網膜症	冠状動脈血栓塞栓症
下肢浮腫左	下肢浮腫	関節血症
両松葉杖歩行	歩行障害	胸部皮膚良性腫瘍
冠動脈狭窄３枝病変	狭心症３枝病変	下腿損傷
遺伝性低尿酸血症	低尿酸血症	腸管組織侵襲性大腸菌感染症
低アルドステロン血症	低アルドステロン症	遺伝性ニューロパチー
小腸皮膚瘻	皮膚瘻	大腿切断
重度僧帽弁狭窄症	僧帽弁狭窄症	ノルウェー疥癬
非細菌性血栓性疣贅	疣贅	習慣および衝動の障害
特発性腸間膜血腫	血腫	心臓血管神経症
脳原発性悪性リンパ腫	脳悪性リンパ腫	口唇外傷性腫脹
抜管後両側反回神経麻痺	両側性反回神経麻痺	色素性緑内障
肝骨転移	骨転移癌	結節性晩期フランベジア
乳腺線維腫症	線維腫	子宮体部筋腫
術後左反回神経麻痺	反回神経麻痺	非還納性横隔膜ヘルニア
無症候性髄膜腫	髄膜腫	ケーキ様腎
左肺下葉肺癌	下葉肺癌	外傷性耳小骨脱臼
アルコール離脱症候群	アルコール離脱状態	悪性軟部腫瘍
左腸骨骨肉腫	腸骨軟骨肉腫	無症候性耳鳴
脳梁低形成	脳梁形成不全	Ｅ２Ａ−ＰＢＸ１陽性Ｂリンパ芽球性リンパ腫
表皮内水疱形成	先天性表皮水疱症	本態性高ナトリウム血症
後頚部圧痛	圧痛	自家末梢血幹細胞移植後
不定愁訴様	不定愁訴症	皮膚リーシュマニア症
良性胆道狭窄	胆管狭窄症	悪性褐色細胞腫
左下葉非小細胞肺癌	下葉非小細胞肺癌	大理石骨病
ＣＫＤ　腎硬化症	腎硬化症	乳び性陰のう水瘤
前頭葉出血	出血	特発性じんま疹
有茎性乳頭状腫瘍	腫瘍	腎損傷・骨盤腔に達する開放創合併なし
理解困難	言語理解障害	連鎖球菌性喉頭気管炎
スメア異常	腟スメア細胞診陽性	子宮内処置の合併症
腹腔内敗血症	敗血症	頚部有棘細胞癌
膵尾部腫大	膵腫大	中枢性眼球運動障害
過呼吸状態	過換気症	乏汗症
右肺門部原発肺小細胞癌	小細胞肺癌	食道異物
胃癌骨髄癌腫症	骨髄転移	触覚鈍麻
眼乾燥感	ドライアイ	子癇発作
内側縦束症候群	核間性眼筋麻痺	足関節骨折
両足関節炎	足関節炎	頭頂葉悪性腫瘍
夜低血糖	低血糖	脳卒中後遺症
左上下肢軽度麻痺	四肢麻痺	人工歯根上部構造不適合
下肢痙性	痙性対麻痺	非復位性顎関節円板障害
皮疹状況	発疹	大腸憩室出血
不適応	適応障害	脊髄神経根損傷
陰茎部痛	陰茎部疼痛	頚髄星細胞腫
髄外形質細胞腫	骨外性形質細胞腫	前立腺上皮内腫瘍
ｍａｌｉｇｎａｎｔ　ｌｙｍｐｈｏｍａ	悪性リンパ腫	脳良性腫瘍
重症ＡＧＨＤ	重症成人成長ホルモン分泌不全	根性坐骨神経症
両白内障	白内障	肩関節異所性骨化
腎結石	腎結石症	永久歯萌出不全
湿疹性病変	湿疹	下垂体微小腺腫
穿刺部発赤	発赤	手背皮膚癌
時々背部痛	背部痛	食事性高脂血症
手内筋萎縮	筋萎縮症	シャルコー・マリー・トゥース病
腎機能悪化	腎機能低下	精巣除去後機能低下症
尾てい骨骨折	尾骨骨折	アルカプトン尿性関節症
高度視力障害	視力障害	前腕皮膚線維腫
周期性クッシング症候群	クッシング症候群	鼓膜外傷後遺症
昨夜微熱	微熱	急性汎発性発疹性膿疱症
腓腹筋痙攣	痙攣	破水
左肋骨打撲	肋骨部打撲	老人性嚥下性肺炎
破壊性脊椎症	脊椎症	慢性薬物性肝炎
胆嚢破裂	胆のう管破裂	陰茎線維腫
独歩不可	歩行障害	Ｓ状結腸腺腫
骨破壊進行	関節リウマチ	肋間静脈損傷
下肢白癬	白癬	腓骨骨肉腫
左鼓膜発赤	発赤	芳香族アミノ酸代謝障害
潜在結核	結核	中心性出血性肝壊死
熱苦症状	発熱	前頭骨陥没骨折
シャイドレジャー症候群	シャイ・ドレーガー症候群	暫間固定装置脱離
肺動脈弁閉鎖症	肺動脈弁閉鎖	足関節打撲傷
脾摘施行Ｃ型肝炎	Ｃ型肝炎	皮質下運動性失語症
胸水セルブロック	胸水貯留	偽緑内障
右肺上葉すりガラス影	胸部異常陰影	ＩＣＵ症候群
Ｆｏｌｌｉｃｕｌａｒ　ｌｙｍｐｈｏｍａ	濾胞性リンパ腫	脳良性腫瘍
腫瘍性ＤＩＣ	線溶亢進	聴覚失認
右精巣上体炎	精巣上体炎	播種性結核
左肘関節亜脱臼	亜脱臼	黒色素皮症
左聴神経腫瘍	聴神経腫瘍	膝部難治性皮膚潰瘍
左肺感染性嚢胞	肺のう胞	アセトン血性嘔吐症
母体出血	出血	上腕良性軟部腫瘍
右足趾壊疽	下肢壊疽	切痕性鼻
胃腸障害	急性胃腸障害	脳梗塞後の片麻痺
残遺癌	癌	小指伸筋腱断裂
不安大きく	不安障害	ざんごう熱
ＭＳ再発	多発性硬化症	急性腎前性腎不全
強直間代性痙攣発作	間代性痙攣	皮膚異物肉芽腫
一過性意識消失発作	一過性脳虚血発作	陰茎切断
乳児白血病	白血病	孤立性顎骨のう胞
筋委縮	筋萎縮症	心肥大
水腎再燃	水腎症	ＣＯ２ナルコーシス
しびれていない	しびれ感	閉鎖性膀胱損傷
時々血痰	血痰	直腸神経内分泌腫瘍
左鼠経ヘルニア	鼡径ヘルニア	膝部有棘細胞癌
遺伝性腎性尿崩症	先天性腎性尿崩症	頬部扁平母斑
尿管結石	尿管結石症	プラスマ細胞増加症
体幹掻痒感	そう痒	股関節後方脱臼
右大腿部骨幹部骨折	大腿骨骨幹部骨折	肛囲硬結
糖尿病神経症	糖尿病性神経痛	下腿多発性開放創
古典的肝細胞癌再発	肝細胞癌	前額部皮下血腫
左室低形成	左心低形成症候群	１型糖尿病性末梢血管障害
劇症肝炎亜急性型	劇症肝炎	汎発性頑癬
分岐部動脈瘤	内頚動脈後交通動脈分岐部動脈瘤	抗凝固剤投与状態
腫瘍感染	腫瘍	ショック
悪性腫瘍スクリーニング	悪性腫瘍	薬物性光毒性反応
外陰部炎	外陰炎	尿管偏位
軽度骨髄抑制	骨髄機能低下	正中部母斑
右踵骨折	骨折	第３趾有棘細胞癌
ＰＰＨ	肺高血圧症	坐骨神経痛
頭痛時折	頭痛	先天性巨爪
血腫貯留	血腫	外傷性中耳腔出血
不整脈発作	不整脈	側頭骨良性腫瘍
静脈炎症状	静脈炎	閉塞性腹壁瘢痕ヘルニア
子宮間質肉腫	肉腫	上部食道癌
右主気管支膜様部壊死	壊死	腱鞘巨細胞腫
右下肺野スリガラス影	胸部異常陰影	ＩＣＵ症候群
時々頭痛	頭痛	先天性巨爪
胆嚢腺扁平上皮癌	癌	球状上顎のう胞
上行結腸早期癌	上行結腸癌	老人性弛緩性皮膚
突発性血小板減少性紫斑病	血小板減少性紫斑病	帯環金属冠粗造
意識変動	意識障害	炎症後鼓膜穿孔
左閉鎖リンパ節転移	リンパ節転移	分娩時中枢神経系合併症
両側小脳梗塞	小脳梗塞	腋窩神経損傷
胃癌多発肝転移	転移性肝癌	ヘモジデリン沈着症
左前腕浮腫	浮腫	結腸間膜ヘルニア
赤紫斑	紫斑病	膝蓋部血腫
偽腔閉塞型大動脈解離	解離性大動脈瘤	全身中毒症
高度感音性難聴	感音難聴	脳神経良性腫瘍
左耳介欠損	耳介欠損	涙腺肥大
尿路感染	尿路感染症	住血吸虫症
縦隔炎再発	縦隔炎	穿通創
前立腺肥大有	前立腺肥大症	示指屈筋腱損傷
胆嚢腫瘍	胆のう腫瘍	肩関節離断術後
胃がん	胃癌	脊椎固定スクリューのゆるみ
左中大脳動脈梗塞	中大脳動脈塞栓症	悪性腫瘍
Ｓｏｔｏｓ症候群	ソトス症候群	膵腫瘤
必要認知症	認知症	ＭＬＬ再構成型Ｂリンパ芽球性白血病／リンパ腫
肝腫瘤性病変	肝腫瘤	放火癖
大動脈瘤解離	解離性大動脈瘤	大腿動脈閉塞症
挿入部出血	出血	陰茎腫瘤
眠前発熱	発熱	急性失血性貧血
肺炎反復	肺炎	斑状網膜
子宮内発育不全	子宮発育不全	ミベリー氏汗孔角化症
左眼窩内腫瘤	眼窩腫瘤	脳性マラリア
多発性腎梗塞	腎梗塞	腰椎骨折
多臓器不全状態	多臓器不全	股関節部挫傷
再度痙攣発作	痙攣発作	反復性虹彩毛様体炎
変動一過性徐脈	徐脈	猫ひっかき病
四肢色素沈着	皮膚色素沈着	唾液腺膿瘍
良性発作性頭位めまい	良性発作性頭位めまい症	奇形児分娩
三角圧痛	肩部筋痛	脱水型低ナトリウム血症
両側声帯不全麻痺	声帯不全麻痺	猩紅熱
舌痛	舌痛症	２型糖尿病合併妊娠
肺動脈弁下狭窄	肺動脈弁下狭窄症	慢性血行性大腿骨骨髄炎
乳癌局所再発	乳癌	先天性好中球機能不全症
頚椎症性神経根炎	頚椎症性神経根症	肘関節外側側副靱帯損傷
痛みきつい	疼痛	過酸症
両側顎下腺腫大	顎下腺肥大	先天性匙状爪
中等度咽頭期嚥下障害	嚥下障害	内転拘縮
ビタミンＤ不足	ビタミンＤ欠乏症	上腕三頭筋痛
日中下痢便	下痢症	皮膚潰瘍
胸郭低形成	胸郭異常	上腕骨骨幹部悪性骨腫瘍
肺スリガラス陰影	胸部異常陰影	乳房開放創
頻脈傾向変	頻脈症	軟骨形成不全症
口蓋腫瘤	腫瘤	末梢前庭障害
パーキンソン病関連疾患	パーキンソン病	頚椎突起骨折
グラム陰性桿菌菌血症	グラム陰性桿菌敗血症	趾骨軟骨肉腫
右上肢腫脹	上肢腫脹	前胸部打撲傷
左肩甲骨部痛	肩甲骨痛	肺化膿症
開腹子宮筋腫核	子宮筋腫	大腿部悪性黒色腫
白内障手術	白内障	動脈瘤
腫瘤残存	腫瘤	胃結核
直腸癌Ｒａ	直腸癌	屈折性遠視
カルボプラチンアレルギー	薬物過敏症	連鎖球菌性咽頭炎
肺原発ホジキンリンパ腫	ホジキンリンパ腫	眼瞼割創
循環障害	末梢循環障害	肺静脈先天異常
原発性空腸癌	空腸癌	胃瘻造設部感染
右卵巣チョコレート嚢腫	チョコレートのう胞	歯髄壊疽
重度精神運動発達遅滞	混合性特異的発達障害	声門下浮腫
左腎梗塞	腎梗塞	腰椎症性脊髄症
筋緊張高く	筋強直	大動脈弁下部狭窄症
母指潰瘍治癒遅延	皮膚潰瘍	腹部第３度熱傷
歩行時呼吸困難感	労作時呼吸困難	胸部大動脈瘤破裂
滑液貯留	体液貯留	総排泄腔外反症
痰症状	喀痰	育児相談
腸管血流障害	末梢循環障害	上腕第１度熱傷
発赤強い	発赤	手背皮膚癌
全身性単純ヘルペスウイルス感染症	ヘルペスウイルス感染症	外耳道腫瘍
冠動脈高度石灰化	冠動脈石灰化	播種性アスペルギルス症
劇症型腸アメーバ症	腸アメーバ症	大腿静脈損傷
慢性痛	慢性疼痛	月経中間期出血
不適応行動	適応障害	下肢筋廃用萎縮
心室内血栓	心室内血栓症	気管気管支ジスキネジア
腹膜播種結節摘出	腹膜播種	外耳部割創
緑色痰	喀痰	分娩に関連する非化膿性乳腺炎
冠動脈硬化	冠状動脈硬化症	閉鎖性外傷性血気胸
右中葉肺癌	中葉肺癌	臍部悪性黒色腫
ポンプポケット内血腫	血腫	骨盤部打撲傷
血管免疫芽球型Ｔ細胞リンパ腫	血管免疫芽球性Ｔ細胞リンパ腫	肝中心静脈閉塞症
腹部緊満	腹部膨満	頭頂部髄膜腫
舌骨喉頭下垂	喉頭下垂症	ヒドロオキシリジン血症
尿量低下	乏尿	妊娠２８週以上で３７週未満で出生した児
脳梗塞症	脳梗塞	単純性関節炎
左非浸潤性乳管癌	非浸潤性乳管癌	フィブリン性腹膜炎
むつかぶれ	おむつ皮膚炎	閉鎖性膀胱損傷
水平亜脱臼	亜脱臼	頚部奇形
右反復性膝蓋骨脱臼	反復性膝蓋骨脱臼	ギラン・バレー症候群
早期癌	癌	眼球炎
吻合部出血	出血	睫毛性眼瞼炎
子宮頸がん	子宮頚癌	腰殿部帯状疱疹
腺扁平上皮癌	癌	アルコール性肝炎
喉頭蓋サルコイドーシス	サルコイドーシス	耳側半盲
結核性	結核	中心性出血性肝壊死
声門部狭窄	喉頭狭窄症	卵巣性無月経
両側急性硬膜外血腫	急性硬膜外血腫	ＭＰ関節炎
高レニン高血圧	高レニン性高血圧症	口腔内感覚異常症
頭蓋底髄膜腫	髄膜腫	破裂性胸腹部大動脈瘤
右前胸部痛	前胸部痛	上行結腸憩室穿孔
膵全体癌	膵癌	流産熱
両側血気胸	血気胸	単麻痺
穿刺部位出血	出血	頬部刺創
手掌黄色腫	黄色腫症	ローター症候群
皮膚湿疹	湿疹	眼瞼咬創
唾石	唾石症	副腎腺腫
非吻合部多発胆管狭窄	胆管狭窄症	悪性褐色細胞腫
軽度肥満歴	肥満症	ＨＩＶ網膜症
左腎嚢胞不変	腎のう胞	牛乳不耐症
軽度発赤腫脹	発赤	三枝ブロック
左手関節変形	変形性手関節症	腸間膜ヘルニア
蛋白尿（３＋）	蛋白尿	肥満低換気症候群
左手首痛	手部痛	直腸腫瘤
びまん性肺胞出血	肺胞出血	急性骨盤腹膜炎
続発性赤芽球癆	赤芽球ろう	前期破水
インフルエンザ菌	インフルエンザ	皮膚はえ幼虫症
左舌区小細胞癌	小細胞肺癌	洞不全症候群
左足背疼痛	足背痛	熱中症
成人発症Ｓｔｉｌｌ病（ＡＯＳＤ）	成人スチル病	脳良性腫瘍
大球性正色素性貧血	正色素性貧血	麻痺性股関節脱臼
双極Ⅱ型障害	２型双極性障害	卵巣周囲炎
限局型全身性強皮症	全身性強皮症	胸壁横紋筋肉腫
右水晶体脱臼	水晶体脱臼	朝顔症候群
心サルコイト゛ーシス	心サルコイドーシス	頭部のう腫
Ｓ状結腸高分化腺癌	Ｓ状結腸癌	肋骨部打撲
右側頬部腫脹	頬部腫脹	心超音波検査異常
右上背部痛	背部痛	食事性高脂血症
両下肢痛み	疼痛	眼角部異物
多発海綿状血管腫	多発性海綿状血管腫	頬骨上顎骨多発開放骨折
結核歴	結核	中心性出血性肝壊死
ＳＭＡ浸潤	膵癌	外陰第３度熱傷
微小癌	癌	口腔底異物
慢性疼痛性障害	慢性疼痛	胆管細胞癌
高Ｃｌ血症	高クロール血症	蝸牛神経性難聴
乳頭状腺癌	癌	乳児内斜視
帯状疱疹ウイルス脊髄炎	ウイルス脊髄炎	下顎骨筋突起骨折
内臓播種性ＶＺＶ感染症	汎発性帯状疱疹	後天性低プロトロンビン血症
様皮疹	発疹	大腸憩室出血
左帯状疱疹	帯状疱疹	外傷性脾破裂・腹腔に達する開放創合併なし
骨形成不全症Ⅲ型	骨形成不全症	離人症
高度肥満症	病的肥満症	直腸切断術後後遺症
右前頭葉脳内血腫	血腫	盲腸粘膜下腫瘍
マルチミニコア病	マルチコア病	股関節内障
四肢関節腫脹	関節炎	水腎症を伴わない後天性腎盂尿管移行部狭窄
右腸骨静脈血栓症	腸骨静脈圧迫症候群	下腿淡明細胞肉腫
脳底動脈閉塞	脳底動脈閉塞症	足部難治性皮膚潰瘍
胸背部圧迫感	背部圧迫感	陳旧性橋梗塞
眼瞼結膜軽度貧血	貧血	前腕若木骨折
子宮頸癌Ⅲｂ期	子宮頚癌	十二指腸平滑筋肉腫
傍卵巣嚢胞	傍卵巣のう胞	う蝕第１度
肝内腫瘤性病変	腫瘤	放火癖
血管性紫斑病	症候性紫斑病	食道穿孔
時々右股関節痛	股関節痛	腸球菌感染症
ＡＳＤ	心房中隔欠損症	足どり不安定
緑膿菌肺感染症	緑膿菌肺炎	篩骨洞腫瘍
母子感染歴	母子感染	直腸びらん
ふらつきあり転倒リスク高い	めまい	胸膜脂肪肉腫
頸腕症候群	頚肩腕症候群	細菌性膀胱炎
食道癌術後リンパ節転移	リンパ節転移	デンスデポジット病ネフローゼ症候群
亜急性期小脳梗塞	小脳梗塞	腋窩神経損傷
喘息コントロール	咳喘息	皮膚移植ドナー
右膝違和感	全身違和感	腎移植後
腓骨神経麻痺徴候	腓骨神経麻痺	乳房下内側部乳癌
中高分化型腺癌	癌	高機能自閉症
軽度脳梗塞	脳梗塞	アルコール性妄想
身体外傷	外傷	側頭部母斑細胞母斑
心源性塞栓症	心原性脳塞栓症	焼身自殺未遂
左上腕骨近位端骨折	上腕骨近位端骨折	胆のう下垂
神経根性痛	疼痛	サラセミア保因者
白色壊死組織付着	壊死	重複僧帽弁口
夜間中途覚醒	睡眠障害	腓骨筋腱脱臼
軽度肺動脈弁狭窄	肺動脈弁狭窄症	慢性血行性大腿骨骨髄炎
転移性肝癌術後再発	転移性肝癌	ヘモジデリン沈着症
無涙症	涙液分泌不全	回腸神経内分泌腫瘍
劇症Ａ型肝炎	Ａ型劇症肝炎	肝硬変症
ｃｒｉｔｉｃａｌ　ｉｌｌｎｅｓｓ　ｐｏｌｙｎｅｕｒｏｐａｔｈｙ	多発ニューロパチー	脳良性腫瘍
右眼増殖性糖尿病網膜症	増殖性糖尿病性網膜症	青色強膜
右上腕腫脹	上腕部腫脹	開放性脳対側損傷
右側胸水貯留	胸水貯留	偽緑内障
水疱瘡	水疱症	腹壁筋痛
軽度高Ｋ血症	高カリウム血症	不完全左脚ブロック
肝性脳症再発	肝性脳症	亜急性結膜炎
水様便流出	下痢症	前額部貫通創
二絨毛膜二羊膜性双胎第	二絨毛膜二羊膜性双胎	深部足底血管損傷
浮腫傾向	浮腫	急性膀胱炎
骨Ｐａｇｅｔ病	骨パジェット病	家族性片麻痺性片頭痛
Ｅｎｔａｍｏｅｂａ　ｈｉｓｔｏｌｙｔｉｃａ	アメーバ赤痢	脳良性腫瘍
左頚部内頸動脈狭窄	内頚動脈狭窄症	筋萎縮性眼瞼下垂
大腿筋横紋筋肉腫	横紋筋肉腫	躁病型統合失調感情障害
腸炎性関節炎	関節炎	硬化性角膜炎
ＰＭＳ	月経前症候群	急性腎前性腎不全
腓腹部圧痛	腹部圧痛	大腿骨骨幹部悪性骨腫瘍
非チフス性Ｓａｌｍｏｎｅｌｌａ菌血症	菌血症	感覚運動障害
微小多発肝膿瘍	肝膿瘍	鼻前庭せつ
卵管狭窄	卵管狭窄症	一側性矮小腎
胸部大動脈解離	急性大動脈解離	胸椎弯曲症
蜂窩織炎発症	蜂窩織炎	活動期トラコーマ
輪状披裂関節炎	関節炎	肛門神経症
左下肢蜂窩織炎	下肢蜂巣炎	Ｂ群連鎖球菌肺炎
肺塞栓	肺塞栓症	アマルガム低位
咽頭残留	嚥下障害	進行性運動性運動失調症
低髄圧症状	低髄液圧症	１型糖尿病性腎症第３期
左腓骨開放骨折	腓骨開放骨折	膝部悪性末梢神経鞘腫
大量水様下痢	下痢症	皮膚潰瘍
処方右乳癌	乳癌	先天性白内障
症候性けいれん	症候性てんかん	慢性デンスデポジット病
低血糖回避	低血糖	網膜中心静脈血栓症
左慢性閉塞隅角緑内障	慢性閉塞隅角緑内障	ウイルス性疣贅
弧発性古典的ＣＪＤ	孤発性クロイツフェルト・ヤコブ病	足どり不安定
呼吸機能低下	呼吸機能検査異常	アレルギー性鼻炎
右大腿リンパ節転移	リンパ節転移	若年性特発性関節炎・肘関節
左第３趾潰瘍	趾皮膚潰瘍	尿道口びらん
足変形	足部変形	腸回転異常
膝関節水腫	膝関節水症	人工骨感染
腹部瘢痕ヘルニア	腹壁瘢痕ヘルニア	上腕骨骨幹部骨折
月経困難	月経困難症	総義歯義歯床下粘膜異常
左局所進行乳癌	進行乳癌	先天性白内障
好酸球性胆嚢炎	胆のう炎	小指末節骨骨折
左下腿骨幹部骨折	骨折	肛囲硬結
即時型アレルギー	アレルギー	検診
ふらつき有	めまい	胆のうポリープ
ループス腎炎Ｖ型	ループス腎炎	心窩部不快
閉塞性睡眠時無呼吸症侯群	睡眠時無呼吸症候群	眼球損傷
右下肢しびれ	下肢しびれ	皮膚腺病
頭部脂漏性皮膚炎	脂漏性皮膚炎	ジフテリア後麻痺
結核性ブドウ膜炎	結核性ぶどう膜炎	潰瘍性大腸炎再燃
左真珠腫性中耳炎再発	真珠腫性中耳炎	腰椎化膿性椎間板炎
傍大動脈ＬＮ転移	大動脈周囲リンパ節転移	閉鎖性膵損傷
痙直型四肢麻痺	四肢麻痺	浮腫型低ナトリウム血症
角化性紅斑散在	紅斑症	てんかん大発作
労作時呼吸苦自覚	労作時呼吸困難	結膜沈着症
慢性腎炎	慢性腎炎症候群	感染後歯肉退縮
間質性肺炎像	間質性肺炎	網膜症
嘔気様	嘔気	三尖弁閉鎖症
左側頭葉皮質化出血	出血	網膜振盪
左上腕骨開放骨折	上腕骨開放骨折	錫中毒
腹部膨満継続	腹部膨満	頭頂部髄膜腫
右足底腱膜炎	足底筋膜炎	腰椎椎間関節のう腫
両側顎関節症	顎関節症	耳小骨の先天奇形
出血性黄体	出血性黄体のう胞	ビタミン剤乱用
右鼡径部疼痛	鼡径部痛	家族性周期性四肢麻痺
高～中分化型管状腺癌	癌	高機能自閉症
Ｌａｍｉｖｕｄｉｎｅ耐性Ｂ型肝硬変	Ｂ型肝硬変	肘部悪性黒色腫
遺伝性腎炎	家族性腎炎	頭蓋骨固定物の突出
湿疹化	湿疹	下垂体微小腺腫
左大腿部蜂窩織炎	大腿部蜂巣炎	ケトン尿症
下肢対麻痺	対麻痺	人工歯根上部構造不適合
成長発達遅滞	発達遅滞	アテローム動脈硬化症
下腿点状出血	点状出血	頬部刺創
脈管奇形	奇形	下腿丹毒
手指欠損	手指欠損症	股関節周囲炎
咽頭粘膜軽度発赤	咽頭発赤	後縦隔脂肪肉腫
可動時痛	疼痛	珪肺症
下垂手	垂れ手	クラミジア精巣上体炎
左陰嚢内容腫大	陰のう腫大	副腎脊髄ニューロパチー
痰がからみ	喀痰	先天性円錐水晶体
朝出血	出血	卵巣機能不全
右鼠経ヘルニア修復術	鼡径ヘルニア	白癬性毛瘡
ステロイド骨粗鬆症	ステロイド性骨粗鬆症	テノンのう炎
足趾冷感	下肢冷感	家族性溶血性貧血
不整腫瘤	腫瘤	胃結核
腎前性脱水	脱水症	四肢第２度熱傷
左肩部痛	肩部痛	肩甲腓骨型脊髄性筋萎縮症
頸部皮下膿瘍	皮膚膿瘍	ステロイド糖尿病・眼合併症あり
ウイルス性感冒	感冒	住血吸虫症性門脈圧亢進症
多発腫大リンパ節	リンパ節腫大	低血糖発作
腹部自発痛	腹痛症	背部打撲傷
中分化型前立腺癌	前立腺癌	高機能自閉症
左一側性形成不全性股関節症	一側性形成不全性股関節症	腸アニサキス症
好酸球性気道炎症	好酸球性気管支炎	外傷後膀胱頚部狭窄
腸管蠕動障害	腸管運動障害	上腕第１度熱傷
褥瘡形成リスク高い	褥瘡	股関節捻挫
腰椎変性辷り症	腰椎変性すべり症	神経症
手術高血圧	高血圧症	大腿皮膚良性腫瘍
嚥下下困難	嚥下障害	遷延性咳嗽
てんかん脳波	異常脳波	境界母斑
巨大血腫	血腫	肺梅毒
十二指腸原発神経内分泌腫瘍	十二指腸神経内分泌腫瘍	側腹部挫創
腹水多量貯留	腹水症	偽緑内障
内腸骨リンパ節転移	腸骨リンパ節転移	若年性関節リウマチ
ＣＭＶ胃腸炎	サイトメガロウイルス腸炎	バベシア症
瘢痕痙性	瘢痕	異常白血球分化
両Ｔ字杖歩行	歩行障害	遺伝性小脳性運動失調症
便性状変化	便異常	巨指症
右血栓閉塞	血栓塞栓症	アンフェタミン中毒
出血付着程度	出血	頬部刺創
右海綿静脈洞髄膜腫	髄膜腫	先天性膀胱頚部閉塞症
虚血性心疾患合併	虚血性心疾患	固定薬疹
壊死性筋炎	筋炎	股関節脱臼骨折
全肺腫瘍	肺腫瘍	骨癒合不全症
軽度構音障害	構音障害	創部瘢痕ケロイド
両下腿紅斑	紅斑症	外傷性聴神経損傷
低Ｃａ血症	低カルシウム血症	根性坐骨神経症
二次性副腎不全	副腎クリーゼ	アルコール性嫉妬
一週間程度眠気	非器質性過眠症	水痘髄膜炎
子宮内腔癒着	子宮内膜症	しゅさ性ざ瘡
項部硬直軽度	項部硬直	変形性足関節症
下熱	発熱	急性失血性貧血
右母指陳旧性尺側側副靱帯損傷	靱帯損傷	肺動脈弁狭窄症
左気管支狭窄	気管支狭窄症	視神経膠腫
皮膚型ＰＮ	結節性多発動脈炎	瞳孔不同症
肺線維化	肺線維症	眼瞼ヘルペス
副鼻腔軽度粘膜肥厚	副鼻腔炎	唾液分泌障害
味覚異常Ｇｒ１	味覚異常	黒癬
中心視野欠損	視野欠損	烏口肩峰靱帯捻挫
昨晩低血糖	低血糖	脳卒中後遺症
両水腎症	両側水腎症	術後吸収不良性骨粗鬆症
前回貧血	貧血	家族性血球貪食性細網症
骨粗鬆症性圧迫骨折	骨粗鬆症・病的骨折あり	腹腔リンパ節転移
右肺原発肺腺癌	肺腺癌	慢性乳児湿疹
脊髄原発悪性リンパ腫	悪性リンパ腫	肋骨弓変形
手指浮腫	浮腫	片頭痛
口内炎再発	口内炎	顎下リンパ節腫脹
皮質性認知症	皮質下認知症	肺結核・鏡検確認あり
足背発赤	発赤	手背皮膚癌
後縦隔腫瘤	縦隔腫瘍	高チロシン血症２型
頚椎症性脊椎症	脊椎症	両性役割服装倒錯症
中部延髄右外側脳梗塞	脳梗塞	リンガルアーチ脱離
仙骨部瘻孔	難治性瘻孔	続発性寒冷フィブリノゲン血症
軽鎖沈着症	単クローン性軽鎖重鎖沈着症	末梢血管外傷
右傍気管リンパ節転移	リンパ節転移	頚部化膿性リンパ節炎
ｓｍａｌｌ　ｃｅｌｌ　ｃａｒｃｉｎｏｍａ	癌	脳良性腫瘍
遺伝性出血性毛細血管拡張症	オスラー病	肩甲部脂肪肉腫
胸椎後縦靭帯骨化症	胸椎後縦靱帯骨化症	石灰化腱膜線維腫
重症敗血症性ショック	敗血症性ショック	頚部筋筋膜炎
間質性肺炎評価	間質性肺炎	先天性扁平足
右腎損傷	腎損傷	抗リン脂質抗体症候群
右肺門部原発	原発性肺癌	乳房開放創
再発食道癌	食道癌	皮膚萎縮症
不定愁訴多い	不定愁訴症	皮膚リーシュマニア症
発熱再燃	発熱	急性失血性貧血
左肩関節痛	肩関節痛症	Ｓ状結腸軸捻転
瘢痕様変化	瘢痕	脳底動脈瘤
元々頻尿	頻尿症	絶対瞳孔強直
浮腫対策	浮腫	急性膀胱炎
核下性顔面神経麻痺	顔面神経麻痺	反復性血尿
皮膚原発悪性リンパ腫	悪性リンパ腫	反復性膝蓋骨亜脱臼
市中感染型ＭＲＳＡ	ＭＲＳＡ感染症	全足位
左尿管結石	尿管結石症	プラスマ細胞増加症
乾性咳嗽頻回	乾性咳	マーデルング変形
首痛	頚部痛	下腿筋腱移行部損傷
右側頭部紫斑	紫斑病	小腸穿孔
薬剤過敏性症候群	薬物過敏症	体表面積６０−６９％の腐蝕
延長症候群	ＱＴ延長症候群	有糸分裂性不分離トリソミー１３
紫斑形成軽度	紫斑病	膝蓋部血腫
両側肺動脈狭窄症	肺動脈狭窄症	足底角化症
子宮筋腫核出後妊娠	妊娠	前立腺損傷
ＡＲＤＳ合併	急性呼吸窮迫症候群	足どり不安定
胆道系閉塞	胆道閉塞	閉塞性大腸炎
軟骨損傷	肋軟骨損傷	新生児肺炎球菌敗血症
右副腎原発	副腎腫瘍	先端失認症
ｋｌｅｂｓｉｅｌｌａ　ｐｎｅｕｍｏｎｉａｅ感染症	クレブシェラ属感染	ＧＢＳ敗血症
パ−キンソン症候群	パーキンソン症候群	疥癬
右原発性肺癌	原発性肺癌	早期先天皮膚梅毒
敗血症性ショック状態	敗血症性ショック	頚部筋筋膜炎
時々発疹	発疹	固定性保定装置脱離
めまい軽度	めまい	涙腺萎縮
右横隔膜筋欠損	筋欠損	凍傷
脳症後遺症	脳症	舌側転位歯
胸膜悪性中皮腫	悪性胸膜中皮腫	気分変調症
漿膜損傷	損傷	鼻石
頸椎症性	頚椎症	不全骨折
多発外傷	多発性外傷	溺水
皮膚損傷起	皮膚損傷	腸糞線虫症
ふらつき目立	めまい	若年性強直性脊椎炎
近位筋痛	筋肉痛	脳性両麻痺
採血上脱水	脱水症	手掌部軟部腫瘍
脳血管芽腫	小脳血管芽腫	骨悪性リンパ腫
右慢性中耳炎	慢性中耳炎	高血圧性心不全
アレルギー様	アレルギー	検診
ノカルジア脳膿瘍	ノカルジア症	心因性皮膚炎
大腸ポリープ有	大腸ポリープ	肝線維症
右後頭部帯状疱疹	後頭部帯状疱疹	アブサンス
右頚部結核性リンパ節炎	結核性リンパ節炎	舌裂
陳旧性多発アテローム血栓性脳梗塞	陳旧性アテローム血栓性脳梗塞	スケレトンタイプ急速拡大装置不適合
誤嚥徴候	異物誤嚥	卵胞出血
右前腕皮疹	発疹	精巣打撲傷
多発肺腫瘤	肺腫瘤	ウイルス性糖尿病・神経学的合併症あり
後腹膜浸潤	後腹膜悪性腫瘍	爪刺創
網状紫斑	紫斑病	前立腺横紋筋肉腫
胚細胞腫瘍	腫瘍	術後腹壁膿瘍
ゲノタイプ１ｂ型Ｃ型肝硬変	Ｃ型肝硬変	家族性地中海熱
類円形腫大	リンパ節腫大	皮下フェオミコーシス性膿瘍
中枢性気管支拡張像	気管支拡張症	多発性リウマチ性関節炎
小股歩行	歩行異常	症候性原発性胆汁性胆管炎
脳血管傷害	脳血管障害	メープルシロップ尿症
糖尿病末梢神経障害	糖尿病性単ニューロパチー	淋菌性子宮頚管炎
ルンバール後頭痛	腰椎穿刺後頭痛	網膜色素斑
急性重症Ｂ型肝炎	Ｂ型肝炎	子宮頚部微小浸潤癌
下垂時疼痛	疼痛	月経中間期出血
頚部蜂窩織炎	頚部蜂巣炎	活動期トラコーマ
腹満不変	腹部膨満	下肢骨軟骨症
一過性心筋虚血	心筋虚血	全遺尿
日勤帯発熱	発熱	非アルコール性脂肪性肝炎
結核性喉頭狭窄	喉頭狭窄症	食道リンパ管腫
両側鼻内ポリープ	鼻茸	再発性多発軟骨炎
手掌潮紅	紅潮	外傷性聴神経損傷
低血糖歴何年	低血糖	腟良性腫瘍
離床時眩暈	めまい	性交痛
高齢者Ｃ型慢性肝炎	Ｃ型慢性肝炎	耳介貫通創
ＳＬＥ発症	全身性エリテマトーデス	急性腎前性腎不全
軽度咽頭違和感	咽頭異常感症	外傷性隅角解離
体熱感	不明熱	シトリン欠損症
悪性腫瘍評価	悪性腫瘍	趾間カンジダ症
発赤領域	発赤	手背皮膚癌
閉塞性大腸癌	大腸癌	大動脈狭窄症
子宮頚部ポリープ	子宮頚管ポリープ	眼瞼蜂巣炎
両側大腰筋血腫	血腫	迷走神経痛
ＰＳＬＮ転移	大動脈周囲リンパ節転移	急性腎前性腎不全
咽頭部疼痛	咽頭痛	脳性嘔吐
肺腫瘍塞栓症	肺腫瘍	アマルガム低位
羊水過多	羊水過多症	特発性アジソン病
筋肉痛症状	筋肉痛	出血性網膜色素上皮剥離
心外膜石灰化	心膜石灰化	線状苔癬
右下肢急性動脈閉塞症	下肢急性動脈閉塞症	透析シャント動静脈瘤
４型進行胃癌	胃進行癌	シルダー病
圧迫性脊髄症	脊髄症	肺動脈血栓症
出血源不明	出血	産褥血栓症
貧血性網膜症	貧血網膜症	サルモネラ肺炎
椎間板突出	椎間板症	外性器の分娩損傷
カルチノイド腫瘍	カルチノイド	頭部頚部挫創
心臓内腫瘤	腫瘤	間質性心筋炎
日中気分不快	悪心	角結膜擦過傷
多発性嚢胞肝	多発性肝のう胞	発音障害
仙骨奇形	仙骨部奇形	多発性膿疱症
けいれん再発	痙攣	アセトン血症
遊走性静脈炎	遊走性血栓性静脈炎	新生児歯
左胸膜炎	胸膜炎	妊娠水腎症
直腸癌術後異時性肝転移	転移性肝癌	ヘモジデリン沈着症
手指痺れ	しびれ感	新生児ＨＩＶ感染症
左卵管水腫	卵管留水症	乳頭状汗管のう胞腺腫
歩行時呼吸困難	労作時呼吸困難	胸部大動脈瘤破裂
ガーゼ出血	出血	陰茎打撲傷
老人性紅皮症	紅皮症	陰のう悪性黒色腫
右被殻脳梗塞	被殻出血	アルコール性妄想
自律神経ニューロパチー	自律神経性ニューロパチー	直腸潰瘍
子宮頚部嚢胞	子宮頚部腫瘍	性交不能症
右原発閉塞隅角緑内障	原発閉塞隅角緑内障	２型糖尿病・多発糖尿病性合併症あり
腺腫内癌	癌	外陰上皮異形成
両下肢浮腫軽度	下肢浮腫	関節血症
右化膿性肩関節炎	化膿性関節炎・肩関節	全結腸型ヒルシュスプルング病
膣転移	腟癌	爪刺創
体力低下著明	体力低下	胸部硬結
左小脳陳旧性梗塞	陳旧性脳梗塞	巨舌症
淡黄色粘稠痰	喀痰	分娩に関連する非化膿性乳腺炎
外傷所見	外傷	側頭部母斑細胞母斑
発赤局面	発赤	手背皮膚癌
膀胱癌既往	膀胱癌	虚血性腸狭窄症
左末梢性肺動脈狭窄	肺動脈狭窄症	膝靱帯弛緩
骨代謝異常	代謝障害	鎖骨異形成
心陰影拡大	胸部異常陰影	外傷性脳圧迫・頭蓋内に達する開放創合併なし
腎動脈下腹部大動脈瘤	腹部大動脈瘤	ヘルペスウイルス性角結膜炎
腸管壁内気腫	皮下気腫	ダリエー病母体より出生した児
慢性活動性ＥＢＶ感染症	ＥＢウイルス感染症	外耳道異物
足関節圧痛	関節痛	直腸痛
夕方発熱	発熱	急性失血性貧血
顔面紅班	紅斑症	先天性乳び胸
排便痛	排便障害	強膜化角膜
左水腎	水腎症	ＣＯ２ナルコーシス
代謝異常	代謝障害	先天性股関節脱臼前状態
両下肢リンハ゜浮腫	下肢リンパ浮腫	趾脱疽
左頸部ＬＮ腫脹	肘リンパ節腫脹	足根関節脱臼
肺門部リンパ節腫脹	リンパ節腫大	全身性紫斑病
呼吸困難感軽度	呼吸麻痺	胸部大動脈瘤破裂
左膝窩動脈血栓症	動脈血栓症	骨盤腎
左股関節脱臼	股関節脱臼	う蝕第４度
ルーフ゜ス腎炎	ループス腎炎	心窩部不快
鼠径部腫脹	鼡径部腫脹	尿管結石症
内鼠径ヘルニア	内鼡径ヘルニア	う蝕第３度歯髄壊疽
左頬部血管腫	頬部血管腫	奇形
開口制限	開口不全	授乳異常
変形性関節炎	変形性関節症	梅毒血清反応偽陽性
初回歩行時ふらつき	よろめき歩行	精神的幼児性パーソナリティ障害
洞性頻脈	洞頻脈	篩骨前頭洞のう胞
腹膜播種巣	腹膜播種	外耳部割創
アレルギ—性結膜炎	アレルギー性結膜炎	声帯上皮過形成
鼠径部血腫	血腫	開放性外傷性小脳血腫
暗赤色嘔吐	嘔吐症	側頭骨悪性腫瘍
直腸癌ＯＰ	直腸癌	鼡径部脂肪腫
左増殖性糖尿病網膜症	糖尿病網膜症	青色強膜
レム睡眠行動異常	異常行動	難治性口内炎
左大腿有棘細胞癌	大腿有棘細胞癌	脳血管障害
声帯癌	声門癌	小腸憩室穿孔
左大腿部疼痛	大腿痛	ストレートバック症候群
右顎関節症	顎関節症	耳小骨の先天奇形
骨頭壊死	骨壊死	肋間静脈損傷
中枢神経浸潤	中枢神経系損傷	流行性脳炎
直腸皮下瘻孔	難治性瘻孔	声門外傷
胆嚢腫大	胆のう肥大	中枢性眼球運動障害
Ｈｅｅｒｆｏｒｄｔ症候群	ぶどう膜耳下腺熱	唾液瘻
前立腺癌既往	前立腺癌	膝窩疣贅
ダグラス窩腹水	腹水症	網膜障害
失見当障害	見当識障害	肋骨不顕性骨折
ツツガムシ感染症	つつが虫病	輪状網膜症
特発性血小板減少症紫斑病	特発性血小板減少性紫斑病	虫垂クローン病
前立腺浮腫	浮腫	恥骨部打撲
胞性腫瘤	腫瘤	耳介外傷性皮下異物
右鼠径リンパ節腫脹	鼡径部リンパ節腫脹	セリアック病
ＡＡＡ破裂	腹部大動脈瘤	両側性外傷後膝関節症
夜間覚醒	不眠症	胃切除後巨赤芽球性貧血
初発癌	癌	化膿性歯槽骨炎
右迷走神経鞘腫	神経鞘腫	コクサッキーウイルス心筋炎
痙攣様	痙攣	腹痛症
機会誤嚥	嚥下障害	卵胞出血
大腿静脈血栓	静脈血栓症	骨盤腎
股関節部骨折	股関節骨折	下部心臓型総肺静脈還流異常症
吸収不全症侯群	吸収不良症候群	アデニンホスホリボシルトランスフェラーゼ欠損症
新生血管緑内障	緑内障	閉鎖性外傷性硬膜下水腫
甲状腺低下症	甲状腺機能低下症	閉鎖性肝内血腫
アメーバ肝膿瘍	肝アメーバ症	先天性肺炎
先天性真珠腫	真珠腫	妄想型統合失調症
頭部皮膚欠損	頭部皮膚欠損創	口唇擦過創
右肺門部浸潤影	胸部異常陰影	ＩＣＵ症候群
食道悪性腫瘍	食道癌	骨盤入口狭窄
傍大動脈リンパ節転移	大動脈周囲リンパ節転移	閉鎖性膵損傷
ビタミンＤ欠乏	ビタミンＤ欠乏症	上腕三頭筋痛
レントゲン異常	胸部異常陰影	糖尿病性皮膚障害
器質的心疾患	心疾患	本態性クリオグロブリン血症
温痛覚	温痛覚過敏	副腎神経芽腫
両側内反足	内反足	小舌症
低酸素症状	低酸素性脳症	無機能腎
粘稠痰少量	喀痰	先天性円錐水晶体
ダンベル型腫瘍	腫瘍	不全中隔子宮
催不整脈作用	不整脈	根尖周囲のう胞
左腋窩汗腺癌	汗腺癌	胸骨披裂
感染性仮性嚢胞	仮性膵のう胞	右胸心
乳房熱感	ほてり	先天性鎖骨偽関節
大腸穿孔	腸穿孔	動脈性出血
腎瘢痕	瘢痕	下肺野陰影
孤立性左室緻密化障害	孤立性心筋緻密化障害	多発骨折
進行性顔面片側萎縮症	顔面痙攣症	結膜のうアルカリ化学熱傷
左手関節痛	手関節痛	直腸腫瘤
右鼠径部腫脹	鼡径部腫脹	足根関節脱臼
びりびりしたしびれ	しびれ感	閉鎖性膀胱損傷
発赤軽減	発赤	手背皮膚癌
悪寒等	悪寒	手指多発開放骨折
非逆流性食道炎	食道炎	頬粘膜炎
甲状腺萎縮	後天性甲状腺萎縮	進行麻痺
呼吸苦自覚症状	呼吸困難	アフラトキシン中毒
多発単神経障害	多発性単ニューロパチー	全身性エリテマトーデス脳脊髄炎
中毒性	中毒	腹部皮膚良性腫瘍
右肺上葉結節影	胸部異常陰影	ＩＣＵ症候群
骨膜肥厚	肥厚性皮膚骨膜症	総腸骨動脈狭窄
リステリア感染症	リステリア症	梨状筋症候群
アルコール性脂肪性肝炎	アルコール性脂肪肝	胸椎後縦靱帯骨化症
脳室穿破	脳出血	伝音難聴
鼠径部リンパ節腫大	鼡径部リンパ節腫脹	低血糖発作
吐気治	嘔気	芽球増加を伴う不応性貧血−２
右鼡径部リンパ節腫脹	鼡径部リンパ節腫脹	発達障害
多発肺塞栓	肺塞栓症	アマルガム低位
右腋窩リンパ節転位	腋窩リンパ節転移	瞳孔不整
重度右片麻痺	片麻痺	先天性脚長不等
両側乳房腫瘤	乳房腫瘤	鼻部貫通創
原発不明癌頸部リンパ節転移	頚部リンパ節転移	上行結腸過長症
後腹膜脂胞肉腫	後腹膜脂肪肉腫	ヒステリー球
胆管閉塞機転	胆管閉塞症	ウェーバー症候群
右下葉原発扁平上皮癌	下葉肺扁平上皮癌	殿部メルケル細胞癌
腰椎圧迫骨折既往	腰椎圧迫骨折	体表面積８０−８９％の熱傷
便秘悪化	便秘症	胸水結核菌陽性
潜血３	顕微鏡的血尿	前額部貫通創
アレルギー性血管浮腫	浮腫	手関節離断術後
肺動脈分岐部狭窄	肺動脈分岐部狭窄症	術後腹腔内膿瘍
顕微的血尿	血尿	セレウス菌食中毒
右鼡径リンパ節腫脹	鼡径部リンパ節腫脹	発達障害
左足多趾症	多趾症	テオフィリン中毒
日中痛み	疼痛	妊娠・分娩・産褥の既存の高血圧性心疾患
不安感	不安障害	膝関節軟骨損傷
眼球運動痛	疼痛	珪肺症
腰椎変性側弯症	腰椎側弯症	高鉄血症
右腎低形成	低形成腎	下腿開放創
Ｙｅｒｓｉｎｉａ　ｅｎｔｅｒｏｃｏｌｉｔｉｃａ感染症	エルシニア菌食中毒	進行性血管性白質脳症
膿胸合併肺放線菌症	肺放線菌症	小結腸
チクチク痛む	チクチク感	若年性一側性上肢筋萎縮症
左水尿管症	水尿管症	２型糖尿病・糖尿病性合併症あり
多発肺内転移	転移性肺癌	デュピュイトラン拘縮
左下葉肺癌断端再発	下葉肺癌	小指挫傷
右大腿部発赤	下腿発赤	黄斑障害
右顔面打撲	顔面打撲傷	ボーエン様丘疹症
糖尿病性自律神経障害	糖尿病性自律神経ニューロパチー	淋菌性子宮頚管炎
分破水	破水	頭熱傷後遺症
重症マイコプラズマ肺炎	マイコプラズマ肺炎	粘液水腫型先天性ヨード欠乏症候群
卵巣嚢腫破裂	卵巣のう腫破裂	頬小帯短縮症
抗原血症	サイトメガロウイルス感染症	エナメル質初期う蝕
褥瘡発症	褥瘡	先天性脊柱後側弯症
甲状軟骨浸潤	甲状軟骨の悪性腫瘍	広汎性皮下出血
潜在性副腎皮質機能低下症	副腎皮質機能低下症	麻痺性散瞳
眼球陷凹	眼球陥没	小刻み歩行
両足趾潰瘍	趾皮膚潰瘍	咽頭灼熱感
過換気症状	過換気症	左室右房交通症
左鎖骨下リンパ節転移	リンパ節転移	分娩時中枢神経系合併症
上右卵管留血腫	卵管留血腫	閉鎖性外傷性くも膜下出血
濾胞性リンパ腫再発	濾胞性リンパ腫	複聴
両眼糖尿病性網膜症	糖尿病網膜症	動脈還流異常
左外傷性大腿骨頭壊死	外傷性大腿骨頭壊死	十二指腸前門脈
肝臓病変	肝疾患	腟挫傷
右第１趾潰瘍	趾皮膚潰瘍	慢性化膿性中耳炎
腋窩痛	腋窩部痛	膵粘液性のう胞腺癌
踵部発赤	発赤	黄斑障害
両側ぶどう膜炎	ぶどう膜炎	股関節内遊離体
右アスペルギルス肺炎	肺アスペルギルス症	加齢性白内障
痔疾患	痔核	多発性脊髄神経根炎
無疱疹帯状疱疹	帯状疱疹	卵巣損傷
吐き気軽度	嘔気	側頭骨悪性腫瘍
非結核性抗酸菌性人工関節感染症	非結核性抗酸菌症	小腸軸捻転症
両下肢不随意運動	不随意運動症	高尿酸血症
前胸痛	胸痛	ループスアンチコアグラント
洞結節不全症候群	洞不全症候群	ジュベール症候群
結腸皮膚瘻	皮膚瘻	大腿切断
患肢熱感	ほてり	家族性溶血性貧血
両側腎膿瘍	腎膿瘍	乳腺腫瘍
右喉頭腫瘍	喉頭腫瘍	ステロイド剤乱用
潜血	顕微鏡的血尿	前額部貫通創
細菌性脳動脈瘤破裂	脳動脈瘤破裂	乳腺硬癌
右鼡径部皮下出血	皮下出血	ストレス性十二指腸潰瘍
右下腿筋肉内出血	筋肉内血腫	先天性臍動脈形成不全症
痒感	そう痒	股関節後方脱臼
大動脈リンパ節転移	大動脈周囲リンパ節転移	閉鎖性膵損傷
心内血栓	心内血栓症	短橈側手根伸筋損傷
術後出血	後出血	頚部外傷
気分悪	悪心	ビタミンＫ欠乏による凝固因子欠乏
腰部脊椎管狭窄症	腰部脊柱管狭窄症	網膜の先天奇形
遠位弓部嚢状動脈瘤	動脈瘤	後頭部神経痛
左総腸骨動脈狭窄	総腸骨動脈狭窄	鼻咽頭萎縮
尿潜血遷延	顕微鏡的血尿	肩甲骨骨折
夜間悪寒	悪寒	手指多発開放骨折
造骨性骨転移	骨転移癌	胆のう管狭窄症
腫瘍制御	腫瘍	中毒性好中球減少症
失調性構音障害	構音障害	肝癌骨転移
右上腕骨頸部骨折	上腕骨頚部骨折	腹筋挫傷
リンハ゜節腫大	リンパ節腫大	低血糖発作
皮疹拡大傾向	発疹	斑状歯
依然浮腫	浮腫	急性膀胱炎
右足底部蜂窩織炎	足蜂巣炎	活動期トラコーマ
血栓閉塞型大動脈解離	早期血栓閉鎖型大動脈解離	処女膜狭窄症
急性期脳血管障害	脳血管障害	嗅神経芽腫
朝方痰	喀痰	舌扁桃炎
進行性直腸癌	直腸癌	鼡径部脂肪腫
小腸型クローン病	小腸クローン病	下腿壊疽
軽度すりガラス影	胸部異常陰影	食道カルチノイド
二次性血小板増多症	血小板増加症	反復心因性うつ病
胃膵嚢胞	膵のう胞	プロピオン酸血症
最近浮腫	浮腫	鼻脳ムコール症
右顔面疼痛	顔面痛	腓骨遠位端剥離骨折
便失禁多量	便失禁	限局性直腸潰瘍
労作時頻脈	頻脈症	下垂体腺腫
両下肢結節性紅斑	結節性紅斑	胸壁蜂巣炎
重症胆管炎	胆管炎	層間白内障
右側胸部痛	胸痛	膀胱外反症
右小指基節骨骨折	小指基節骨骨折	原始神経外胚葉腫瘍
右足背腫脹	足背腫脹	ポルフィリン症
右上肢発赤	発赤	黄斑障害
呂律のまわりにくさ	構音障害	巨指症
アミオダロン誘発性甲状腺中毒症	薬剤性甲状腺機能障害	外傷性皮下血腫
左胸部痛	胸痛	上行結腸憩室穿孔
右大腿痛	大腿痛	前腕擦過創
左下腿ＤＶＴ	下腿静脈血栓症	単純型顔面外傷
動悸等症状	動悸	メッケル・グルーバー症候群
紫斑	紫斑病	膝蓋部血腫
致死性不整脈出現	不整脈	顎関節部皮下血腫
顆粒膜細胞腫	卵巣顆粒膜細胞腫	前腕多発性血管損傷
一瞬痛み	疼痛	過酸症
意識障害患者	意識障害	陰唇ポリープ
切迫早産腹緊	切迫早産	排卵痛
難治性皮膚非定型抗酸菌症	非結核性抗酸菌症	水頭症性無脳症
頚部鈍痛	鈍痛	槌趾症
発赤範囲	発赤	手背皮膚癌
左腕腫脹	前腕腫脹	胃腸ポリープ
右肺上葉陰影	胸部異常陰影	ＩＣＵ症候群
右上葉肺結節	結節性肺結核	眼窩先天異常
空腹時高血糖	高血糖症	脳卒中後遺症
右麻痺	片麻痺	心因性失神
味覚変化	味覚障害	橈骨骨折
器質化肺炎	特発性器質化肺炎	慢性アレルギー性中耳炎
浮腫悪化	浮腫	下腿神経炎
凝固異常症	血液凝固異常	趾基節骨剥離骨折
右側頭葉脳梗塞	脳梗塞	アルコール性妄想
両側下顎骨折	下顎骨骨折	空腸神経内分泌細胞癌
左頭頂葉神経膠腫	頭頂葉神経膠腫	下眼瞼扁平母斑
骨盤内多発リンパ節転移	骨盤内リンパ節転移	関節リウマチ・脊椎
直腸閉塞	直腸閉鎖	急性肺炎
運動ニューロン病	運動ニューロン疾患	ショパール関節離断術後
肺犬糸状虫症	犬糸状虫症	サイトメガロウイルス性膵炎
軽度骨棘	骨棘	ランゲニールセン症候群
疲労感少	疲労感	広範囲顎骨支持型補綴物脱離
多発性肝腫瘤	肝腫瘍	放火癖
意味性錯語	文意失語症	後天梅毒
ｃｏａｒｓｅ　ｃｒａｃｋｌｅｓ	湿性ラ音	骨移植拒絶反応
緑色下痢便	下痢症	皮膚潰瘍
皮膚損傷リスク	皮膚損傷	腸糞線虫症
左母指痛	母指痛	球後視神経炎
ＡＶブロック	房室ブロック	外陰第３度熱傷
前縦隔ＬＮ転移	縦隔リンパ節転移	腹部大動脈閉塞症
間質性肺炎発症	間質性肺炎	網膜症
外側脱臼	脱臼	手掌第３度熱傷
右環指基節骨骨折	環指基節骨骨折	本態性音声振戦症
左殿部疼痛	殿部痛	皮膚移植後
両側錐体路障害	錐体路障害	胸椎結核
両足しびれ	下肢しびれ	ＣＡＰＤ腹膜炎
膜性増殖性	膜性増殖性糸球体腎炎	インフルエンザ性副鼻腔炎
頻脈性心房粗動	心房粗動	過外転症候群
下肢血流障害	下肢血行障害	頭頚部良性軟部腫瘍
左肺上葉大細胞癌	上葉肺大細胞癌	化学性食道炎
結核性肋膜炎	結核性胸膜炎	インスリン抵抗性糖尿病
疼痛有	疼痛	甲状腺悪性リンパ腫
実質外腫瘤	腫瘤	頚部原発腫瘍
骨盤部リンパ節転移	骨盤内リンパ節転移	関節リウマチ・脊椎
左三叉神経帯状疱疹	三叉神経帯状疱疹	ＨＴＬＶ−１ぶどう膜炎
間質性肺炎悪化	間質性肺炎	網膜症
仙骨部骨折	仙骨骨折	ピンタ性角化症
重症低体温症	低体温	鼻性視神経炎
関節炎悪化	関節炎	シャガス病脳脊髄炎
右尖足	尖足	脈絡膜悪性黒色腫
両手指浮腫	浮腫	片頭痛
左主気管支狭窄	気管支狭窄症	視神経膠腫
浸潤癌化	癌	骨盤内リンパ節の悪性腫瘍
就寝後呼吸困難	呼吸困難	側胸部皮膚良性腫瘍
仮性膵嚢胞	仮性膵のう胞	分娩前出血
右肺上葉癌	上葉肺癌	三角靱帯損傷
訪室時疼痛	疼痛	月経中間期出血
膠原病様症状	膠原病	複合部位の骨折
軽度黄染	黄疸	殿部第２度熱傷
転移性膵癌	膵癌	ヘモジデリン沈着症
除皮質硬直様	除皮質硬直	アテトーシス型脳性麻痺
間歇跛行	間欠性跛行	子宮筋腫による分娩停止
動脈瘤コイル塞栓術	動脈瘤	心下悸
紅斑散在	紅斑症	てんかん大発作
右膝疼痛	膝関節痛	脳脊髄炎
食思不振傾向	食欲不振	メスカリン中毒
皮内腫瘍	腫瘍	若年性骨粗鬆症
左前床突起部髄膜腫	髄膜腫	非合法的妊娠中絶
右脳梗塞	脳梗塞	単純性関節炎
軽度腹部痛	腹痛症	網脈絡膜炎
多発毛細血管拡張	オスラー病	肩甲部脂肪肉腫
不整脈誘発	不整脈	顎関節部皮下血腫
左肺動脈ＰＥ	肺動脈血栓塞栓症	上腕二頭筋損傷
胃潰瘍再発	胃潰瘍瘢痕	気腫型慢性閉塞性気管支炎
境界域精神発達遅滞	知的障害	大腿骨不全開放骨折
胆石膵炎	胆石性膵炎	ウイルス性皮膚炎
右腕頭動脈瘤	腕頭動脈瘤	前腕類上皮肉腫
外陰部ｐａｇｅｔ癌	外陰部パジェット病	爪甲点状凹窩
リウマチ様症状	関節リウマチ	腹部神経症
肺癌性リンパ管症	癌性リンパ管症	眼瞼割創
左上腕骨顆部骨折	上腕骨顆部骨折	複雑性膀胱炎
骨盤位妊娠	骨盤位	前縦隔悪性腫瘍
大腿骨骨折後	大腿骨骨折	小腸出血
左椎間孔狭窄	結合組織性椎間孔狭窄症	胸郭原性脊柱側弯症
前立腺軽度腫大	前立腺肥大症	脂肪腫
下顎腫脹	下顎部腫脹	失声症
鼻中隔弯曲	鼻中隔弯曲症	耳鳴症
大腸憩室症	多発性大腸憩室症	１型糖尿病性潰瘍
逆流性食道炎無	逆流性食道炎	頬粘膜炎
致死性偽膜性腸炎	偽膜性腸炎	ウォールマン病
眼窩蜂窩織炎	眼窩蜂巣炎	骨盤腹膜癒着
排尿後痛	排尿痛	外側半月板変性
右腹痛	腹痛症	頚背筋部分断裂
嚥下耳痛	耳痛症	強膜化角膜
茶色出血	出血	頬部刺創
左下葉扁平上皮癌	下葉肺扁平上皮癌	殿部メルケル細胞癌
右腎梗塞	腎梗塞	腰椎症性脊髄症
原発性ヘモクロマトーシス	ヘモクロマトーシス	陰のう裂創
右前頭葉膠芽腫	前頭葉膠芽腫	再発性胆管炎
急性水頭症	水頭症	毛皮商人肺
活動性肺結核所見	活動性肺結核	耳後部腫脹
右眼白内障	白内障	肩関節異所性骨化
本日胸痛	胸痛	ループスアンチコアグラント
直腸膀膀胱窩	直腸膀胱瘻	ＡＣバイパス術後
頚部結核性リンパ節炎	結核性リンパ節炎	舌裂
左橈骨遠位骨折	橈骨遠位端骨折	広間膜欠損
逆行性Ｐ波	心電図異常	背部リンパ管腫摘出後遺症
しびれない	しびれ感	閉鎖性膀胱損傷
臀部圧痛	圧痛	スティフ・マン症候群
咽頭血腫	咽頭部血腫	肺アスペルギルス症
膀胱癌再発	膀胱癌	虚血性腸狭窄症
多発皮下転移	皮下腫瘍	爪刺創
両側肺動脈血栓塞栓症	肺動脈血栓塞栓症	二次性高血圧症
副鼻腔病変	副鼻	周辺部ぶどう膜炎
安静時呼吸苦	呼吸困難	側胸部皮膚良性腫瘍
左胸膜播種	胸膜播種	耳介創傷
陰嚢疼痛	陰のう痛	頚髄星細胞腫
上眼瞼腫脹	眼瞼浮腫	関節骨折
右下肢複雑骨折	開放骨折	視神経網膜障害
可動性良好腫瘤	腫瘤	耳介外傷性皮下異物
両頬部発赤	発赤	黄斑障害
感染性肝嚢胞	肝のう胞	項部皮下腫瘤
左鼡径部腫脹	鼡径部腫脹	尿管結石症
突然呼吸困難	呼吸困難	胸部大動脈瘤破裂
皮下出血斑	皮下出血	開放性腎損傷
右下腿骨髄炎	大腿骨骨髄炎	脱色素性母斑
平行機能障害	平衡異常	脛骨結節部剥離骨折
元々杖歩行	歩行障害	遺伝性小脳性運動失調症
両下肢腫脹	下肢腫脹	外耳道閉塞性角化症
左傍矢状洞髄膜腫	傍矢状洞髄膜腫	原発性胆汁性胆管炎に伴う食道静脈瘤出血
限局性皮膚硬化型全身性強皮症	全身性強皮症	クルーゾン症候群
毎回失禁	尿失禁症	限局性直腸潰瘍
右小脳腫瘍	小脳腫瘍	気管支狭窄症
続発性サルコペニア	サルコペニア	ブブレ症候群
非医原性左尿管狭窄	尿管狭窄	先天性肘変形
下腿血腫	血腫	角膜瘤
逆流性膀胱炎	膀胱尿管逆流	外側半月のう腫
覚醒時疼痛	疼痛	視神経障害
左大転子部発赤	発赤	黄斑障害
卵巣原発腫瘍	卵巣腫瘍	足関節第３度熱傷
リンパ腫再発	悪性リンパ腫	手化膿性腱鞘炎
重度運動障害性構音障害	構音障害	特発性胸腰椎側弯症
右肩周囲炎	肩周囲炎	趾伸筋腱断裂
軽度動悸	動悸	メッケル・グルーバー症候群
左ポスナーシュロスマン症候群	ポスナーシュロスマン症候群	咽頭創傷
液体貯留	体液貯留	総排泄腔外反症
低張性低ナトリウム血症	低ナトリウム血症	胃消化管間質腫瘍
癌性胸腹膜炎	癌性腹膜炎	耳介壊疽
心臓内腫瘍	心臓腫瘍	多発性挫滅傷
左坐骨神経麻痺	坐骨神経麻痺	鼓膜出血
リステリア髄膜脳炎	リステリア性髄膜脳炎	眼周囲部外傷性異物
点圧痛	圧痛	脱水型低ナトリウム血症
帯状疱疹ウイルス脳炎	帯状疱疹性脳炎	２型糖尿病性関節症
齲蝕	う蝕	１型糖尿病性腎症第１期
腎性急性腎障害	腎障害	眼周囲部挫傷
喉頭嚢胞	喉頭のう胞	神経鞘腫
甲状腺乳頭腺癌	甲状腺乳頭癌	乳児内斜視
左上下肢しびれ	半身しびれ	皮膚腺病
心筋傷害	心筋疾患	外傷性硬膜下水腫・頭蓋内に達する開放創合併あり
圧迫性骨折	圧迫骨折	外陰部痛
胆嚢胆石	胆泥	ＡＬアミロイドーシス
縱隔リンパ節転移	縦隔リンパ節転移	外陰静脈瘤
悪性細胞	癌	片頭痛発作重積
Ｌｉｓｔｅｒｉａ　ｍｏｎｏｃｙｔｏｇｅｎｅｓ敗血症	敗血症	屈曲部湿疹
パニック症侯群	パニック障害	部分調節性内斜視
アレルギー性肺アスペルギルス症	アレルギー性気管支肺アスペルギルス症	低体重
左下肢原発性リンパ浮腫	リンパ浮腫	橈側手根屈筋腱損傷
呼気時喘鳴	喘鳴	躯幹膿痂疹性湿疹
落ち着かない	多動性障害	髄膜炎菌性心膜炎
苦悶症状	胸内苦悶	下大静脈損傷
トルーソー症候群	トルソー症候群	精巣上体炎
全身浮腫不変	全身性浮腫	頭部刺創
左側頭円蓋部髄膜腫	円蓋部髄膜腫	鼓室形成術後後遺症
周術期喘息発作	気管支喘息発作	大腿骨骨折後骨癒合不全
薬剤性副腎不全	副腎皮質機能低下症	アルコール性嫉妬
乳がん	乳癌	総胆管結石性胆のう炎
巣状分節状糸球体硬化症	巣状糸球体硬化症	虫垂良性腫瘍
口腔乾燥感	口腔乾燥症	多発性海綿状血管腫
右手関節尺側部痛	手関節痛	角膜上皮欠損
右上顎洞真菌症	上顎洞炎	真性ケロイド
鮮血便	血便	聴覚性構音障害
心配症	心配	痕跡膝蓋骨
アシドーシス進行	アシドーシス	中枢性思春期早発症
右足滑液包炎	滑液包炎	多腺性自己免疫症候群２型
第５胸椎転移	胸椎転移	背部軟部腫瘍
表出性言語発達遅滞	言語発達遅滞	ウルリッヒ病
発作性心房細動既往	発作性心房細動	不全足位
左リウマチ性膝関節症	関節リウマチ・膝関節	高血圧性眼底
左大腿部痛	大腿痛	ストレートバック症候群
隆起性病変	胃ポリープ症	心臓腫瘍
腫瘤状構造	腫瘤	胃結核
細菌性赤痢感染症	赤痢	ツェルベーガー症候群
多数骨折	骨折	ナフサ中毒
門脈右枝血栓	門脈血栓症	パラチフス
３型進行癌	癌	足関節脱臼粉砕骨折
倦怠感等	倦怠感	全部性歯髄炎
全頭脱毛症	脱毛症	陰のう痛
筋攣縮	筋痙縮	心因性頻尿
元々徐脈	徐脈	上腕骨病的骨折
特発性側彎症	特発性側弯症	外尿道口腫瘍
回盲部放線菌症	放線菌症	ビリルビン尿
ｆａｎ症候群	マルファン症候群	腋窩急性リンパ節炎
脊椎椎間板炎	椎間板炎	上腸間膜動脈解離
起始異常	冠動脈起始異常	下肢筋廃用萎縮
右眼球破裂	眼球破裂	両側性外傷後膝関節症
介助　疼痛	疼痛	胆管細胞癌
前失神	失神	プラスティックブラケット破損
ふらつき感自覚	よろめき歩行	脂腺腫
低分化型肝細胞癌	肝細胞癌	仮性球麻痺
右葉間胸水	葉間胸水	プランマー病
子宮内膜症性卵巣嚢胞	卵巣子宮内膜症のう胞	未破裂椎骨動脈解離
腎嚢胞出血	傍腎盂のう胞	腹腔神経叢損傷
無症候性キャリア	ＨＴＬＶ−１キャリア	歯の埋伏症
中等度腹水	腹水症	環指基節骨骨折
受容体脳炎	抗ＮＭＤＡ受容体脳炎	ウイルス性糖尿病・糖尿病性合併症あり
肛門部軽度発赤	肛門部周囲炎	後縦隔脂肪肉腫
側方リンパ節転移	リンパ節転移	眼窩内髄膜腫
左硝子体混濁	硝子体混濁	臍部皮膚癌
統合失調症既往	統合失調症	先天性腎動脈狭窄症
平衡機能障害	平衡障害	バーネット症候群
肺腫瘤影	胸部異常陰影	褥瘡・ＤＴＩ
複雑型異型子宮内膜増殖症	腺腫性子宮内膜増殖症	インフルエンザ性副鼻腔炎
皮膚潰瘍形成	皮膚潰瘍	先天性乳房異常
肝肥大	肝型糖原病	小腸癌
紅斑腫脹	紅斑症	肺換気不全
腰部圧痛	腰痛症	手指多発骨折
元々不眠症	不眠症	遊走性紅斑
左肩甲骨軟骨肉腫	肩甲骨軟骨肉腫	川崎病性冠動脈瘤
肺血症性ショック	敗血症性ショック	インフルエンザ性胃腸炎
凝固線溶系異常	血液凝固異常	軽症腺ペスト
異所性静脈瘤	静脈瘤	Ｐｈ陽性急性リンパ性白血病
腫瘍崩壊	腫瘍	胆汁性腹膜炎
破壊性甲状腺炎	甲状腺炎	虫垂炎性腹膜炎
右腸骨ＬＮ転移	腸骨リンパ節転移	間質性視神経炎
右腎被膜下血腫	血腫	萎縮性喉頭気管炎
全身性サルコイドーシス	サルコイドーシス	多発性下腿損傷
脱分化型脂肪肉腫	脂肪肉腫	カンジダ性股関節炎
非機能性下垂体腫瘍	下垂体腫瘍	顔面圧挫傷
ＡＣＴＨ分泌不全	ＡＣＴＨ分泌低下症	外傷性脳室内出血
時々残尿感	残尿感	家族性軟骨石灰化症
小人症	低身長症	音響外傷
右臼蓋転移	骨盤転移	爪刺創
右頭頂葉脳梗塞	脳梗塞	アルコール性妄想
マルファン症候群合併	マルファン症候群	中枢性特発性早熟
右眼網膜症	網膜症	盲腸炎
咽喉頭炎	咽頭喉頭炎	胸部ヘルペス
右下葉肺扁平上皮癌	下葉肺扁平上皮癌	悪性奇形腫
足趾壊疽	趾壊死	切痕性鼻
左肺尖部腺癌	肺腺癌	肝脾住血吸虫症
潰瘍型間質性膀胱炎	間質性膀胱炎	辺縁性化膿性歯根膜炎
紅色皮疹	発疹	幼児性血管腫
遺尿	遺尿症	エンテロウイルス脳脊髄炎
頚管狭窄	子宮頚管狭窄症	尿管腸瘻
右腎門部腹側脂肪肉腫	腎周囲脂肪肉腫	子宮脱１度
左中頭蓋窩髄膜腫	中頭蓋窩髄膜腫	破裂性胸腹部大動脈瘤
脳梗塞後後遺症	脳梗塞	胸髄神経根障害
含歯性嚢胞	含歯性のう胞	角膜熱傷
紅斑熱	日本紅斑熱	細菌性腟症
多発頭蓋骨転移	骨転移癌	進行性前立腺癌
Ｄａｎｌｏｓ症候群	エーラス・ダンロス症候群	中指骨折
運動低下性構音障害	構音障害	特発性胸腰椎側弯症
右重症下肢虚血	重症虚血肢	一側下肢多発開放骨折
両側腸腰筋血腫	血腫	新生児ループス
亀頭部発赤	発赤	手背皮膚癌
肝嚢胞感染	肝のう胞	肺熱傷
重症強迫性障害	強迫性障害	局所性脳損傷
顔面骨圧痛	圧痛	線維芽細胞性髄膜腫
左椎間板ヘルニア	椎間板ヘルニア	先天性脊柱前弯
会陰部疼痛	外陰部痛	頚髄星細胞腫
咀嚼時痛	咀嚼筋痛障害	失語・失行・失認症候群
左膝関節偽痛風	膝関節偽痛風	条虫症
２次性副甲状腺機能亢進症	副甲状腺機能亢進症	先天性頭蓋変形
右上腕蜂窩織炎	上腕蜂巣炎	薬剤性糖尿病・神経学的合併症あり
右前大脳動脈未破裂動脈瘤	前大脳動脈瘤	唾液腺萎縮
リウマチ性胸水	リウマチ性肺疾患	偽緑内障
右眼白内障手術	白内障	動脈瘤
悪性リンハ゜腫	悪性リンパ腫	２型糖尿病・関節合併症あり
胆管腫瘍栓	胆管腫瘍	肩関節離断術後
右基底核梗塞	脳梗塞	気管気管支虚脱
境界型耐糖能障害	耐糖能異常	シュワルツ・ヤンペル症候群
リウマチ疾患	関節リウマチ	前腕部絞扼性神経障害
白内障Ｏ	白内障	肩関節異所性骨化
心房細動停止	心房細動	ビタミンＤ依存症
帯状疱疹既往	帯状疱疹	卵巣損傷
腫瘤所見	腫瘤	胃結核
ＶＨＬ病	フォンヒッペル・リンダウ病	急性腎前性腎不全
時折血痰	血痰	直腸神経内分泌腫瘍
陰嚢部腫脹	陰のう腫大	頬部腫瘤
帰室時疲労感	疲労感	広範囲顎骨支持型補綴物脱離
高分化型腺癌	癌	高機能自閉症
糖尿病等	糖尿病	下腿多発性開放創
Ｍｙｃｏｂａｃｔｅｒｉｕｍ　ｓｈｉｇａｅｎｓｅ感染症	非結核性抗酸菌症	進行性血管性白質脳症
後腹膜腫瘍切除術	後腹膜腫瘍	十二指腸カルチノイド
肺転移発覚	転移性肺腫瘍	デュピュイトラン拘縮
右中咽頭癌	中咽頭癌	筋肉内血腫
両側肺動脈血栓塞栓	動脈血栓症	二次性高血圧症
臀部炎症性粉瘤	粉瘤	喉頭狭窄症
左耳耳鳴	耳鳴症	調節性斜視
鼠経ヘルニア	鼡径ヘルニア	手圧挫傷
鼻閉塞	鼻閉	失名詞症
疲労感等	疲労感	広範囲顎骨支持型補綴物脱離
日中掻痒感	そう痒	股関節後方脱臼
前交通動脈未破裂脳動脈瘤	未破裂脳動脈瘤	唾液腺萎縮
夜間低酸素血症	低酸素血症	無機能腎
薬剤性腎不全	薬剤性腎障害	アルコール性嫉妬
気管支狭窄	気管支狭窄症	視神経膠腫
腫瘍増悪	腫瘍	趾間カンジダ症
急性軸索障害	びまん性軸索損傷	股関節部せつ
完全型ベーチェット病	ベーチェット病	卵巣妊娠
筋肉痙攣	痙攣	破水
癌性髄膜腫症	悪性髄膜腫	アタッチメント脱離
化膿性脊椎椎間板炎	化膿性椎間板炎	術後血腫
呼吸性雑音	胸部音異常	プロラクチン分泌異常症
真菌塊	真菌症	インフルエンザ菌性喉頭気管炎
両肩関節圧痛	圧痛	Ｓ状結腸軸捻転
多発肝細胞癌	肝腫瘍	仮性球麻痺
右腎小嚢胞	傍腎盂のう胞	骨膜のう炎
左横隔膜神経麻痺	横隔神経麻痺	類上皮肉腫
右高度水腎症	水腎症	ＣＯ２ナルコーシス
創傷治癒遅延	創傷	遺伝性感覚性自律神経性ニューロパチー
上腫瘍	腫瘍	上下斜視
進行性食道癌	食道癌	皮膚萎縮症
複雑性熱性痙攣	熱性痙攣	閉鎖性尿管損傷
先天性鼻咽腔閉鎖不全症	先天性鼻咽腔閉鎖不全	中隔部肉芽形成
右眼鼻涙管閉塞症	鼻涙管閉鎖症	妊娠性肝斑
縦隔原発Ｂ細胞大細胞型リンパ腫	縦隔原発大細胞型Ｂ細胞性リンパ腫	乳房痛
左半視野障害	視野障害	静脈瘤性皮膚炎
大腿骨近位部骨折	大腿骨骨折	小腸出血
左踵部痛	踵痛	脳脊髄炎
ポリープ様隆起	ポリープ	副筋
刺激性皮膚炎	皮膚炎	副腎皮質腫瘍
慢性緑膿菌感染	緑膿菌感染症	中大脳動脈狭窄症
回腸閉塞	回腸狭窄	特発性拘束型心筋症
尾部嚢胞	膵のう胞	胆のう管癌
虫刺症	蜂刺症	胆道閉塞
第二趾爪囲炎	爪囲炎	胞状腺腫
膵仮性嚢胞破裂	仮性膵のう胞	術後空気塞栓症
シェーンラインヘノッホ紫斑病	ＩｇＡ血管炎	脆弱性骨折
記銘障害	記銘力低下	上行結腸平滑筋肉腫
上歯肉癌	上顎歯肉癌	自閉症スペクトラム障害
チャーグ－ストラウス症候群	好酸球性多発血管炎性肉芽腫症	外陰部挫創
低ＡＴⅢ血症	アンチトロンビン欠乏症	後大脳動脈瘤破裂によるくも膜下出血
超皮質性感覚性失語	皮質下感覚性失語症	手術創離開
ＮＯＭＩ	腸壊死	瞳孔不同症
肥厚性幽門狭窄	肥厚性幽門狭窄症	悪性脳腫瘍
問題なし脊柱管狭窄症	脊柱管狭窄症	クロード症候群
左踵骨裂離骨折	踵骨骨折	足母趾腫瘤
慢性糸球体炎	糸球体腎炎	予防接種後脳脊髄炎
左眼結膜下出血	結膜下出血	前腕若木骨折
子宮頸部上皮内腫瘍	子宮頚部上皮内腫瘍	性交不能症
左腰部有棘細胞癌	腰部有棘細胞癌	喉頭蓋のう胞
糖尿病罹患	糖尿病	下腿多発性開放創
四肢圧痛	圧痛	両側性停留精巣
関節変形	関節奇形	腸間膜ヘルニア
気分変動	気分変調症	Ｓ状結腸憩室出血
左鎖骨下動脈起始異常	鎖骨下動脈起始異常	頚部軟部腫瘍
立位バランス練習重症筋無力症	重症筋無力症	皮膚疣状結核
腰椎脊柱管狭窄	腰部脊柱管狭窄症	網膜の先天奇形
左上葉小細胞肺癌	上葉小細胞肺癌	完全無歯症
左後縦隔腫瘍	後縦隔腫瘍	距骨偽関節
食道カンジタ症合併ＨＩＶ感染症	ＨＩＶカンジダ病	外耳道異物
固縮無動	こわばり	結膜の悪性腫瘍
小体認知症	認知症	強度近視
突然腹痛	腹痛症	十二指腸腫瘍
尿閉気味	尿閉	晩期梅毒性聴神経炎
生検部感染徴候	創傷感染症	大腿挫傷
痛風症状	痛風	先天性鼻中隔弯曲症
脳転移新出	転移性脳腫瘍	閉塞性肺炎
両側肩関節痛	肩関節痛症	Ｓ状結腸軸捻転
右眼下鼻側視野異常	視野障害	網膜腫瘍
右肺Ｓ４原発腺癌	肺腺癌	慢性腎臓病
右肘関節骨折	肘関節骨折	進行性指掌角皮症
両耳下腺腫脹	耳下腺腫脹	Ｘ連鎖無ガンマグロブリン血症
再下血	下血	小指屈曲拘縮
両変形性股関節症	変形性股関節症	生体肝移植後
喘息コントロール不良	咳喘息	皮膚移植ドナー
腹部大動脈狭窄症	大腿動脈狭窄症	下部消化管出血
左肺良性腫瘍	肺良性腫瘍	環指側副靱帯損傷
頸動脈狭窄症	内頚動脈狭窄症	筋萎縮性眼瞼下垂
若年結核性腹膜炎	結核性腹膜炎	タングクリブ破損
発赤部分	発赤	手背皮膚癌
大腸疾患	腸疾患	結核性肺線維症
頚部血腫	頚部表在損傷	回転異常腎
肺雑聴取	胸部音異常	限局性多毛症
急性冠症候群発症	急性冠症候群	腸壊死
皮下浮腫	浮腫	関節血症
低活動型せん妄	せん妄	ＨＩＶ感染
左化膿性耳下腺炎	化膿性耳下腺炎	崩壊精神病
痔核症状	痔核	先天性好中球減少症
拘束性心筋症	拘束型心筋症	付加装置脱離
右内頸動脈血栓閉塞	動脈血栓症	回腸憩室症
肝うっ血	うっ血肝	収縮期高血圧症
ＣＮＩ腎症	薬剤性腎障害	ウィリス動脈輪周囲炎
浮腫軽減	浮腫	下腿神経炎
胃液様	嘔吐症	特発性関節脱臼
右鼡径部出血	出血	ミトコンドリア糖尿病・昏睡合併あり
右肺上葉肺炎	肺炎	開放性矢状洞部硬膜外血腫
膠原病外来	膠原病	複合部位の骨折
門亢症	門脈圧亢進症	血小板機能低下
在型食道癌	食道癌	皮膚萎縮症
創内異物	外傷性異物	陰茎挫傷
膀胱内尿貯留	後腹膜尿貯留	慢性外傷後頭痛
肢痛	疼痛	上腕骨変形治癒骨折
肺結核性腹膜炎	結核性腹膜炎	タングクリブ破損
腸管内血腫	血腫	眼瞼黄色腫
ネフローゼ状態	ネフローゼ症候群	脳幹機能障害
軽度僧帽弁逆流症	僧帽弁逆流症	包皮腫瘤
前胸部粉瘤	粉瘤	喉頭狭窄症
左室中部閉塞性肥大型心筋症	閉塞性肥大型心筋症	小脳性歩行失調
しびれがきつい	しびれ感	閉鎖性膀胱損傷
両側内耳奇形	内耳先天奇形	背部よう
完全右脚ブロック指摘	完全右脚ブロック	胃機能亢進
肛門部潰瘍	肛門潰瘍	共同偏視
臀部紅斑	紅斑症	外傷性聴神経損傷
アレルギ—性鼻炎	アレルギー性鼻炎	視床下部機能障害
末節骨骨折	骨折	ムコリピドーシス４型
脊椎症性変化	脊椎症	尿道良性腫瘍
腸閉塞気味	イレウス	急性肺炎
浅呼吸	呼吸困難	前立腺膿瘍
無症候性狭心症	狭心症	小脳テント血管周皮腫
右顎下リンパ節腫脹	顎下リンパ節腫脹	膝部悪性黒色腫
左側頭葉海綿状血管腫	側頭葉海綿状血管腫	薬物性ショック
直腸癌術後直腸癌	直腸癌	鼡径部脂肪腫
痛覚消失	異常知覚	びまん性表層角膜炎
膵炎再燃	膵炎	エクリン汗腺の障害
肘頭部潰瘍	前腕皮膚潰瘍	肝脾Ｔ細胞リンパ腫
反復性腸閉塞	イレウス	テント上下髄膜腫
胎児腹水	胎児水腫	骨のう腫
失見当識障害	見当識障害	肋骨不顕性骨折
皮膚ツルゴール低下	脱水症	上肢一過性伝導障害
右肩悪性軟部腫瘍	悪性軟部腫瘍	胸椎椎間板症性脊髄症
非定型うつ	非定型うつ病	接触性眼瞼結膜炎
右中指スワンネック変形肩関節	スワンネック変形	リンパ脈管筋腫症
胸郭運動異常	胸郭異常	神経性緊張
前頭蓋底腫瘍	頭蓋底腫瘍	腰椎良性腫瘍
腹部肥満	肥満症	頭頂部髄膜腫
Ｓ状結腸粘膜下腫瘤	腫瘤	再燃緩解型潰瘍性大腸炎
両側下腿圧痕性浮腫	下腿浮腫	スモン
動脈瘤様骨嚢腫	動脈瘤様骨のう腫	神経型先天性ヨード欠乏症候群
軟性腫瘤	腫瘤	胃結核
本日疼痛	疼痛	甲状腺悪性リンパ腫
出血軽度	出血	クロム親和性芽細胞腫
軽度間歇性跛行	間欠性跛行	自然気胸
蛋白血症	異常蛋白血症	足第３度熱傷
不眠時２錠	不眠症	結核性卵巣のう胞
後縦隔膿瘍	縦隔膿瘍	フレザー症候群
胸水排出	胸水貯留	食道瘻
ＡＩＤＳ非定型抗酸菌症	非結核性抗酸菌症	大脳石灰沈着症
尺側神経麻痺	尺骨神経麻痺	色素性緑内障
徐脈等	徐脈	上腕骨病的骨折
てんかんの発作	てんかん	アセトン血症
腹部大動脈石灰化	大動脈石灰化症	播種性アスペルギルス症
サルコイドーシス疑	サルコイドーシス	多発性下腿損傷
左片麻痺	片麻痺	腹部第１度熱傷
足部冷感	下肢冷感	家族性溶血性貧血
下痢〜水様便	下痢症	片側感覚消失
コレステロールポリープ	ポリープ	下顎骨悪性腫瘍
１型糖尿除	糖尿	Ｔ細胞関連型拒絶反応
関節固縮	関節拘縮	尿管欠損
肺多型癌	癌	義歯咬合面不適合
慢性アレルギ—性鼻炎	アレルギー性鼻炎	視床下部機能障害
下顎骨正中部骨折	下顎正中部骨折	空腸神経内分泌細胞癌
後嘔吐	嘔吐症	腹部大動脈血栓症
気分不快出現	悪心	角結膜擦過傷
劇症Ａ群溶連菌感染症	劇症型Ａ群連鎖球菌感染症	喉頭血管腫
内腸骨静脈血栓症	静脈血栓症	下腿淡明細胞肉腫
軽度咽頭期嚥下障害	嚥下障害	内転拘縮
舌根扁桃炎	扁桃炎	出血性虹彩炎
右肺上葉小細胞癌	上葉小細胞肺癌	化学性食道炎
ＣＭＶ網膜症	サイトメガロウイルス網膜炎	ナトリウム欠乏症
脊椎側弯症	脊柱側弯症	上腕圧挫傷
悪心Ｇ１	悪心	尖圭コンジローマ合併妊娠
上腹部鈍痛	上腹部痛	網脈絡膜炎
脊髄視神経炎	視神経炎	常同性運動障害
本日血尿	血尿	仮性近視
クラミジア頸管炎	クラミジア頚管炎	内斜頚斜視
性急性リンパ性白血病	急性リンパ性白血病	結膜のう胞
周囲リンパ節腫大	リンパ節腫大	低血糖発作
印環細胞癌	癌	嗄声
６月肝転移	転移性肝腫瘍	小脳橋角部髄膜腫
左内頸動脈中等度狭窄	頚動脈硬化症	内反踵足
左外耳道閉鎖	外耳道閉鎖	四肢熱傷
右鼡径部ヘルニア	鼡径ヘルニア	大動脈欠損症
ＭＬＦ症候群	核間性眼筋麻痺	腋窩急性リンパ節炎
醜形恐怖	醜形恐怖症	鼻根部打撲挫創
肩関節疼痛	肩関節痛症	海ヘビ毒
右手痺れ	上肢しびれ	急性反復性気管支炎
逆流感	胃食道逆流症	頭部虫刺傷
播種性クリプトコックス症	播種性クリプトコッカス症	マレー渓谷脳炎
左尿管導管吻合部狭窄	吻合部狭窄	内痔瘻
口唇落屑	皮膚落屑	出血性気管炎
時折不整	不整脈	ペラグラ
僧帽弁狭窄症兼閉鎖不全症	僧帽弁狭窄症	びまん性中毒性甲状腺腫
伸筋腱脱臼	脱臼	中指ＤＩＰ関節尺側側副靱帯損傷
両下腿潰瘍	下腿皮膚潰瘍	リステリア性脳動脈炎
内転障害	眼球運動痙攣	興奮型痴愚
びまん性リンパ腫	リンパ腫	手化膿性腱鞘炎
多発嚢胞腎	多発性のう胞腎	全身型若年性特発性関節炎・股関節
足首骨折	足関節骨折	更年期出血
右目白内障	白内障	肩関節異所性骨化
嘔吐１回	嘔吐症	腹部大動脈血栓症
深夜低血糖	夜間低血糖症	脳卒中後遺症
過敏症状	過敏症	非免疫性胎児水腫
高Ｂｉｌ血症	高ビリルビン血症	蝸牛神経性難聴
右足小指骨折	小指骨折	横行結腸狭窄症
第一腰椎破裂骨折	腰椎破裂骨折	示指剥皮創
せん妄発言	せん妄	頭蓋脊椎披裂
ヒステリー症状	ヒステリー反応	股関節割創
歩行時創部痛	術創部痛	大転子開放骨折
パニック	パニック障害	喉頭壊死
正色素性正球性貧血	正球性正色素性貧血	麻痺性股関節脱臼
右足腫脹	足部腫脹	首吊り自殺未遂
両肺胸膜肥厚	胸膜肥厚	小腸悪性リンパ腫
ＡＰＳ	抗リン脂質抗体症候群	足どり不安定
脳圧亢進症状	頭蓋内圧亢進症	若年性特発性関節炎・手関節
眼鏡　近視	近視	紅色丘疹
二次性ヘモクロマトーシス	ヘモクロマトーシス	陰のう裂創
潜在性副甲状腺機能低下症	副甲状腺機能低下症	蜂窩織炎性アンギナ
両眼瞼黄色腫	眼瞼黄色腫	頭頂部石灰化上皮腫
右内腸骨動脈狭窄	動脈狭窄	下顎骨骨髄炎
正中頚嚢胞	正中頚のう胞	先天性ポルフィリン症
両側尿管結石	尿管結石症	プラスマ細胞増加症
高血圧状態	高血圧症	母指ＭＰ関節橈側側副靱帯損傷
喀血症状	喀血	頚椎後方すべり症
指発赤	発赤	手背皮膚癌
Ⅱａ型高脂血症	高脂血症	成人スチル病
右手橈骨骨折	橈骨骨折	縦隔気腫
右睾丸痛	精巣痛	家族性周期性四肢麻痺
本日血便	血便	下腸間膜動脈瘤
回腸出血	腸出血	花粉症
左副腎出血	副腎出血	腹部膿瘍
後頭蓋下髄膜腫	髄膜腫	色素失調症
急性前壁中隔梗塞	急性前壁中隔心筋梗塞	上行結腸神経内分泌細胞癌
右顔面部帯状疱疹	顔面帯状疱疹	栄養失調
びまん性管内増殖性糸球体腎炎	慢性びまん性管内増殖性糸球体腎炎	手関節部挫創
傍腹部大動脈リンパ節腫大	リンパ節腫大	低血糖発作
左上腕脂肪腫	上腕脂肪腫	子宮脱２度
尿道口発赤	発赤	非ＳＴ上昇型心筋梗塞
冠動脈狭窄症	冠状動脈狭窄症	下腿損傷
膵石灰化	膵石灰化症	顔面毛包性紅斑黒皮症
丘疹様	丘疹	乳頭筋断裂・急性心筋梗塞に合併
肺上葉原発性肺癌	原発性肺癌	三角靱帯損傷
労作時胸部不快	労作時呼吸困難	貧血母斑
２型＋ステロイド性糖尿病	ステロイド糖尿病	閉鎖性脾損傷
腫瘤縮小	腫瘤	胃結核
Ｓａｌｍｏｎｅｌｌａ　ｅｎｔｅｒｉｔｉｄｉｓ敗血症	サルモネラ敗血症	赤外線白内障
グル音異常	異常腸音	全胞状奇胎
鉄吸収障害	鉄欠乏症	膿瘍性下行結腸憩室
水中毒症状	水中毒	片側痙攣片麻痺てんかん症候群
鼻中隔彎曲	鼻中隔弯曲症	耳鳴症
本日右眼白内障	白内障	左心不全
過敏性腸症侯群	過敏性腸症候群	鼓膜弛緩部穿孔
会話性幻聴	幻聴	昏睡
筋疲労感	筋疲労	脛骨腓骨近位端骨折
水疱後びらん	水疱症	関節奇形
胆管内結石	胆管結石症	頭部打撲
時々せん妄	せん妄	頭蓋脊椎披裂
処置後膵炎	膵炎	先天性副腎性器症候群
術後右反回神経麻痺	術後性反回神経麻痺	非還納性横隔膜ヘルニア
反復性細菌感染	細菌感染症	脳幹性前兆を伴う片頭痛
ｗｉｄｅ　ＱＲＳ頻拍	頻拍症	男性性器癌
両側性末梢性顔面神経麻痺	末梢性顔面神経麻痺	ツベルクリン反応偽陽性
皮膚軟部組織感染症	皮膚感染症	脳梁離断術後
腰痛ヘルニア	椎間板ヘルニア性腰痛症	帯環マルチブラケット装置不適合
イレウス合併	イレウス	母指切断
息苦しく	呼吸困難	急性涙のう炎
肺好酸球性肉芽腫	肺好酸球性肉芽腫症	機能低下性子宮出血
無菌性腸炎	非感染性腸炎	情緒性ショック
骨盤内リンパ嚢腫	骨盤部感染性リンパのう胞	濾胞性甲状腺腺腫
両側眼瞼下垂症	眼瞼下垂症	急性上顎洞炎
両側性結核性胸膜炎	結核性胸膜炎	インスリン抵抗性糖尿病
甲状腺機能亢進症状	甲状腺機能亢進症	亜急性虚血性大腸炎
平坦Ｔ波	心電図異常	陰部神経症
ペーシング不全	両室ペーシング機能付き植込型除細動器不全	エーベルト病
後頭部打撲	頭部打撲	ボーエン様丘疹症
薬剤性過敏症候群	薬剤性過敏症症候群	体表面積６０−６９％の腐蝕
両側喉頭肉芽腫	喉頭肉芽腫	膵萎縮
ふらつきあり	めまい	胸膜脂肪肉腫
右鼡径ヘルニア	鼡径ヘルニア	大動脈欠損症
職業性ストレス	急性ストレス反応	放射線治療後甲状腺機能低下症
卵管水腫	卵管留水症	乳頭状汗管のう胞腺腫
左下葉原発性肺扁平上皮癌	肺扁平上皮癌	悪性奇形腫
外気胸	気胸	月経前症候群
ポリープ数個	ポリープ	下咽頭異物
右低音障害型感音難聴	急性低音障害型感音難聴	食道憩室
外陰部血腫	外陰血腫	微熱
左乳突蜂巣炎	乳様突起炎	上咽頭後壁癌
未破裂左内頸動脈瘤	内頚動脈瘤	心臓弁置換術後
中咽頭側壁扁平上皮癌	癌	良性胸膜中皮腫
ＥＶＡＮＳ症候群	エバンス症候群	中指骨折
右聴神経腫瘍	聴神経腫瘍	膝部難治性皮膚潰瘍
両肺多発結節性陰影	胸部異常陰影	乳房開放創
左血腫	血腫	外傷性中耳腔出血
早期乳癌	乳癌	薬物性じんま疹
脾臓腫瘤	腫瘤	アルコール性神経筋障害
多発髄膜腫	多発性髄膜腫	ケーキ様腎
術中出血多	多量出血	クロム親和性芽細胞腫
先天性嚢胞肺	先天性のう胞肺	先天性免疫不全症候群
手背部疼痛	手背部痛	致死性家族性不眠症
腹部大動脈嚢状瘤	腹部大動脈瘤	黄色腫症
腫瘍感染合併	腫瘍	聴覚失認
ＩＰ合併	間質性肺炎	足どり不安定
左腫瘤	腫瘤	胃結核
ゾメタ骨髄炎	骨髄炎	慢性再発性多発性骨髄炎
葉酸欠乏	葉酸欠乏症	足部石灰化上皮腫
右胸膜原発血管肉腫	血管肉腫	原発性クリオグロブリン血症
拘縮気味	筋拘縮症	結膜の悪性腫瘍
手関節圧痛	圧痛	直腸腫瘤
浮腫残存	浮腫	頭部刺創
非てんかん性心因性発作	てんかん	狭心症
鼻口蓋管嚢胞	鼻口蓋管のう胞	下肢第２度熱傷
下腸間膜動脈閉塞	腸間膜動脈塞栓症	急性化膿性耳下腺炎
右中大脳動脈領域梗塞	中大脳動脈閉塞症	悪性腫瘍
消化管腫瘤	腫瘤	耳介外傷性皮下異物
脛骨前面圧痕性浮腫	浮腫	陰のう内腫瘤
多少眠気	非器質性過眠症	水痘髄膜炎
高濃度腫瘤	腫瘤	頚部原発腫瘍
ＤＧＥ症状	消化管術後後遺症	瞳孔不同症
過形成性ポリープ	胃過形成ポリープ	下咽頭異物
日光アレルギー	光線過敏症	初期う蝕小窩裂溝填塞材破損
両膝痛	膝関節痛	妊娠性間質性乳腺炎
こわばりあり	こわばり	胸肋関節炎
慢性炎症性腸疾患	腸炎	自己貪食空胞性ミオパチー
尺骨頭脱臼	脱臼	脾膿瘍
けいれん症状	痙攣	肺損傷
重度三尖弁閉鎖不全症	三尖弁閉鎖不全症	下肢多発骨折
肺炎併発	肺炎	開放性矢状洞部硬膜外血腫
右下肢感覚鈍麻	感覚異常症	外陰挫滅創
第二度房室ブロック	第２度房室ブロック	電撃性虚血性大腸炎
慢性進行性肺アスペルギルス症	肺アスペルギルス症	低体重
点状発赤	発赤	手背皮膚癌
白血病化	白血病	腸炎
消退性発赤	発赤	手背皮膚癌
ヒステリー	ヒステリー反応	外傷後股関節症
手指皮疹	発疹	足第２度熱傷
残尿	残尿感	頭部皮下血腫
腫脹圧痛	圧痛	脱水型低ナトリウム血症
ループスアンチコアグラント陰性	ループスアンチコアグラント	メトヘモグロビン尿症
両肺気胸	気胸	喉頭挫滅損傷
右肺胸水貯留	胸水貯留	偽緑内障
血性吐物	吐血	多発性膀胱腫瘍
両側腓骨神経麻痺	腓骨神経麻痺	乳房下内側部乳癌
廃用	廃用症候群	硝子体黄斑牽引症候群
浮動感	めまい	手関節部第２度熱傷
軽度右室肥大	右室肥大	腰椎不顕性骨折
右膝蜂窩織炎	膝部蜂巣炎	輪状暗点
強制換気	人工呼吸器装着状態	左室右房交通症
２型＋ステロイド糖尿病	ステロイド糖尿病	閉鎖性脾損傷
左下肢ガス壊疽	ガス壊疽	耳管結核
低血糖用	低血糖	網膜中心静脈血栓症
喚語障害	不全失語症	爪カンジダ症
右足底潰瘍	足底皮膚潰瘍	血小板増加症
右網膜静脈分枝閉塞症	網膜静脈分枝閉塞症	外耳道奇形
腹痛時	腹痛症	十二指腸腫瘍
多動多弁	多動性障害	後鼻孔狭窄
右手背浮腫	限局性浮腫	片頭痛
足趾しびれ	下肢しびれ	趾悪性黒色腫
突然意識障害	意識障害	陰唇ポリープ
足底痺れ	しびれ感	腹壁挫傷
角膜ヘルペス	ヘルペス角膜炎	続発性骨萎縮症
食思不振症状	食欲不振	メスカリン中毒
細菌性食道炎	食道炎	大腿脂肪腫
開大代謝性アシドーシス	代謝性アシドーシス	須毛毛瘡
心因性過食症	心因性過食	肺性心
術後肺転移	転移性肺腫瘍	デュピュイトラン拘縮
転移性腫瘤	転移性腫瘍	耳介外傷性皮下異物
夜間尿意	夜間頻尿症	習慣性斜頚
右下腿腫脹	下腿腫脹	神経症性非行
背部皮脂欠乏性湿疹	皮脂欠乏性湿疹	頻回再発型ネフローゼ症候群
足爪白鮮	足爪白癬	網膜中心静脈塞栓症
神経性疼痛	神経痛	脊髄空洞症
房室接合部調律	異所性調律	肩関節亜脱臼
末梢循環不全徴候	末梢循環不全	アレルギー
眼瞼下垂自覚	眼瞼下垂症	急性上顎洞炎
右上顎洞乳頭腫	上顎洞乳頭腫	母指関節捻挫
帯状疱疹拡大	帯状疱疹	情動精神病
左尾状核ラクナ硬塞	ラクナ梗塞	結晶クリオグロブリン血症
ＳＭＡ閉塞	急性上腸間膜動脈閉塞症	身体表現性障害
めまいの発作	めまい	赤芽球ろう
呼吸切迫	急性呼吸窮迫症候群	膝窩動脈捕捉症候群
劇症型連鎖球菌感染症	連鎖球菌感染症	喉頭血管腫
腹部疝痛	仙痛	スティフ・マン症候群
胆嚢多発ポリープ	胆のうポリープ	頭部挫傷後遺症
柑皮症	カロチン血症	涙腺腫瘍
浮腫状	浮腫	下腿神経炎
陰部掻痒	外陰部そう痒症	壊疽性胆のう炎
十二指腸多発びらん	十二指腸びらん	歯性副鼻腔炎
前立性肥大症	前立腺肥大症	示指屈筋腱損傷
嘔気状況	嘔気	三尖弁閉鎖症
両側眼球外転障害	眼球運動障害	部分的脂肪萎縮症
元々浮腫	浮腫	頭部刺創
左小脳出血	小脳出血	唾液分泌欠如
躁うつ	躁うつ病	頭頂骨線状骨折
夜間失禁	尿失禁症	脳表ヘモジデリン沈着症
ベージェット病	ベーチェット病	乳汁分泌抑制
元来頭痛	頭痛	先天性巨爪
褥瘡発生リスク低い	褥瘡	股関節捻挫
下部直腸癌	直腸癌	鼡径部脂肪腫
両側総腸骨動脈狭窄	総腸骨動脈狭窄	鼻咽頭萎縮
牽引痛	牽引性頭痛	腎打撲傷
Ⅱ度熱傷	熱傷	閉鎖性膵臓破裂
重度感覚障害	体感異常	挫創
両側肺尖部進行性胸膜肥厚	胸膜肥厚	加齢黄斑変性
婦人入院脳梗塞	脳梗塞	外傷性脳動脈瘤・頭蓋内に達する開放創合併あり
炎症性ポリープ多発	ポリープ	尿道短縮症
右坐骨結節転移再発	転移性腫瘍	社会不安障害
ダンピング症候群併発	ダンピング症候群	特発性拡張型心筋症
右上肢痺れ	しびれ感	卵巣のう胞
ＭＣＴＤ	混合性結合組織病	急性腎前性腎不全
ループスアンチコアグラント陽性	ループスアンチコアグラント	メトヘモグロビン尿症
昨日水様便	下痢症	小指中節骨開放骨折
気分不快増強	悪心	重症多形滲出性紅斑・急性期
拡張期高血圧	高血圧症	膝蓋靱帯炎
右気管支肺炎	気管支肺炎	腓骨近位部骨腫瘍
左頸部リンパ節腫大	薬剤性自己免疫性溶血性貧血	低血糖発作
右低音部感音難聴	感音難聴	趾基節骨良性腫瘍
ＰＨＴ	肺高血圧症	坐骨神経痛
夜間失見当	見当識障害	慢性辺縁性歯周炎中等度
劇症型髄膜炎菌感染症	髄膜炎菌感染症	頚動脈ステント植え込み状態
物忘れ気	健忘症	思春期うつ病
両難聴	難聴	髄膜炎菌血症
左腎細胞癌	腎細胞癌	うつ状態
多発膵転移	転移性膵腫瘍	開鼻声
両眼白内障手	白内障	肩関節異所性骨化
右手関節滑膜炎	滑膜炎	多発性骨壊死
膠原病由来	膠原病	複合部位の骨折
声門上喉頭癌	喉頭癌	妄想を主とする急性精神病性障害
右膝メルケル細胞癌	メルケル細胞癌	１型糖尿病性腎症
右椎骨動脈起始部狭窄	椎骨動脈狭窄症	上口唇挫傷
加害妄想	妄想反応	乳び心のう液貯留
嚢胞性胸腺腫	胸腺腫	舌乳頭腫
急性乳突洞炎	急性中耳炎	縦隔悪性リンパ腫
舌内リンパ節転移	リンパ節転移	瞳孔不整
悪性リンパ腫既往	悪性リンパ腫	２型糖尿病・関節合併症あり
左肺下葉腫瘤影	肺腫瘤	褥瘡・ＤＴＩ
Ｌ３圧迫骨折	圧迫骨折	外陰部痛
左感音性難聴	感音難聴	大動脈弁狭窄症兼三尖弁閉鎖不全症
腎臓疾患	腎疾患	無菌性骨壊死
ＣＯＰＤＩ期	慢性閉塞性肺疾患	足どり不安定
転倒歴多数	よろめき歩行	上腕淡明細胞肉腫
ＤＩＨＳ	薬疹	足どり不安定
夜勤帯下血	下血	子宮頚部軽度異形成
インスリン依存性糖尿病	１型糖尿病	手指神経断裂
頸部椎間板ヘルニア	頚椎椎間板ヘルニア	頚部血管腫
右眼網膜裂孔	網膜裂孔	嗅覚異常
拍動性疼痛	疼痛	無痛性胆石症
下血増悪	下血	小指屈曲拘縮
ＤＭ性腎不全	糖尿病性腎不全	熱傷ショック
膝関節軽度屈曲拘縮	屈曲拘縮	ガンマヘルペスウイルス性単核症
ＡＴＬ	成人Ｔ細胞白血病リンパ腫	急性腎前性腎不全
肺動脈弁閉鎖不全	肺動脈弁閉鎖	足関節打撲傷
熱感軽度	ほてり	上腕神経叢下位型麻痺
重度不眠	不眠症	遊走性紅斑
咀嚼困難感	咀嚼障害	多発性脊髄神経根炎
食道圧迫	食道圧迫症	直腸周囲炎
両足関節痛	足関節痛	直腸痛
術後肝転移	転移性肝癌	小脳橋角部髄膜腫
朝低血糖	低血糖	脳卒中後遺症
喘息疑い	咳喘息	網脈絡膜萎縮
顔皮疹	発疹	角膜パンヌス
子宮筋腫有	子宮筋腫	期外収縮性不整脈
淡明細胞型腎細胞癌	腎細胞癌	うつ状態
浮腫生	浮腫	下腿神経炎
再出血徴候	出血	胆石性急性胆のう炎
アシネトバクター敗血症	敗血症	赤外線白内障
左自然気胸再発	自然気胸	涙管粘液のう胞腫
高度肥満２型糖尿病	２型糖尿病	外陰部そう痒症
右大腿骨骨肉腫	大腿骨骨肉腫	急速進行性歯周炎
左腎盂腎炎治癒後	腎盂腎炎	胎児無心体のための母体管理
二次性水頭症	外傷後水頭症	女性性器癌
ダグラス窩播種	腹膜播種	下垂体膿瘍
左室拡張能低下	左室不全	肛門部ボーエン病
ウィルス感染症	ウイルス感染症	住血吸虫症性門脈圧亢進症
左手尺骨神経麻痺	尺骨神経麻痺	ミラーフィッシャー症候群
周期性呼吸時折	周期性呼吸	外傷性食道破裂・胸腔に達する開放創合併なし
異常帯下	帯下	温度感覚異常
多発性大腸ポリープ	大腸ポリープ	肝線維症
糖尿病用	糖尿病	下腿多発性開放創
術前心電図異常	心電図異常	背部筋肉痛
中耳炎症状	中耳炎	新生児クラミジア感染症
脱力症状	脱力感	肺炎球菌感染症
上半身掻痒感	そう痒	精巣萎縮
動揺性めまい	めまい	ウイルス血症
褥瘡発生歴	褥瘡	先天性脊柱後側弯症
水分摂取困難	嚥下障害	下肢知覚低下
趾爪囲炎	爪囲炎	胞状腺腫
右下葉原発低分化腺癌	癌	骨盤内リンパ節の悪性腫瘍
挙上期誤嚥	異物誤嚥	卵胞出血
腹部膨満増強	腹部膨満	頭頂部髄膜腫
右副腎腫瘍摘出術	副腎腫瘍	下顎部横紋筋肉腫
右鎖骨痛	鎖骨痛	股関節部クリック
細菌性扁桃炎	扁桃炎	異所性灰白質
左歯性上顎洞炎	歯性上顎洞炎	腎コレステロール塞栓症
重度歯周病	歯周症	肝梗塞
正常圧緑内障	緑内障	耳出血
梗塞後出血	出血性脳梗塞	子宮頚部上皮内癌
骨髄異型性症候群	骨髄異形成症候群	急性網膜壊死
光線過敏	光線過敏症	側頭葉腫瘍
副睾丸炎	精巣炎	胃熱傷
虚脱病変	虚脱	補綴隙不適合
慢性アレルギー性鼻炎	季節性アレルギー性鼻炎	視床下部機能障害
肘痛	肘関節痛	卵巣腫瘤
夕食前低血糖	低血糖	脳卒中後遺症
先天性代謝異常症	代謝障害	先天性股関節脱臼前状態
単頸双角子宮	双角子宮	セメント質増殖症
原発性肺高血圧症	肺高血圧症	続発性女性不妊症
左眼加齢性黄斑変性症	加齢黄斑変性	橈骨偽関節
左鎖骨リンパ節転移	リンパ節転移	分娩時中枢神経系合併症
殿部色素沈着	色素異常症	腓骨遠位端骨折
舌浮腫	浮腫	閉経後骨粗鬆症・大腿部病的骨折あり
ストレス性潰瘍	ストレス潰瘍	非定型神経性大食症
舌損傷	損傷	脊椎固定スクリューの突出
発熱下	発熱	急性失血性貧血
失見当識発言	見当識障害	肋骨不顕性骨折
右眼内悪性リンパ腫	眼窩悪性リンパ腫	新生児気胸
腹部大動脈狭窄	大動脈狭窄症	下部消化管出血
右季肋部自発痛	季肋部痛	趾拘縮
軽度痺れ	しびれ感	晩期梅毒性視神経萎縮
星芒状血管腫	血管腫	高アンモニア血症
右房内腫瘤	腫瘤	弾発肘
Ｓ状結腸転移	転移性消化器腫瘍	２型糖尿病性単ニューロパチー
全身掻痒感	そう痒	股関節後方脱臼
右手舟状骨骨折	手舟状骨骨折	抗精神病薬中毒
肉芽腫性腸疾患	腸疾患	直腸周囲膿瘍
両足圧痕性浮腫	浮腫	片頭痛
発作後精神病	精神病	先天性膀胱ヘルニア
虫垂粘液嚢胞腺腫	虫垂粘液のう胞	微量元素欠乏性貧血
四肢水疱	水疱症	関節奇形
右足趾骨髄炎	趾骨髄炎	大腿骨遠位端骨肉腫
若年性リウマチ	関節リウマチ	前腕部絞扼性神経障害
体陽性脳炎	脳炎	皮質下脳損傷・頭蓋内に達する開放創合併なし
境界域ＤＭ	糖尿病	外陰第３度熱傷
結節性不整脈	不整脈	側頭骨良性腫瘍
劇症敗血症	敗血症	肝血管腫
慢性血腫	血腫	網膜のう胞
骨破壊病変	関節リウマチ	肋間静脈損傷
眼窩部痛	眼痛	膵粘液性のう胞腺癌
昨日不眠	不眠症	遊走性紅斑
頚椎脊柱管狭窄症	頚部脊柱管狭窄症	尿管腸瘻
発赤域	発赤	手背皮膚癌
膵頭部転移	転移性膵腫瘍	開鼻声
高度肝障害	肝障害	腟挫傷
右肺下葉腫瘍	肺腫瘍	骨癒合不全症
口腔内発赤腫脹	発赤	慢性肺性心
中咽頭再発腫瘍	咽頭腫瘍	舌咽神経麻痺
左下肢冷感	下肢冷感	家族性溶血性貧血
大腫瘍	腫瘍	中毒性好中球減少症
胸骨肋骨転移	肋骨転移	胆のう摘出後症候群
重症心身障害児	重症心身障害	腎移植急性拒絶反応
腹部軽度膨隆	腹部膨満	手指損傷
リンパ管症	癌性リンパ管症	稗粒腫
遷延性抑うつ状態	うつ状態	胃盤虫症
結核性強膜炎	結核性胸膜炎	潰瘍性大腸炎再燃
下腿筋萎縮	筋萎縮症	梨状陥凹癌
膵頭癌	癌	初老期妄想状態
ＶＡＨＳ	ウイルス関連血球貪食症候群	坐骨神経痛
圧痛自発痛	圧痛	脱水型低ナトリウム血症
痰中等量引ける	喀痰	育児相談
放射線障害	放射線宿酔	中指関節痛
浅眠	不眠症	水痘髄膜炎
反射異常	異常反射	新生児中毒性紅斑
慢性間質性腎炎	慢性尿細管間質性腎炎	ブラジル出血熱
脳溢血	脳卒中	肋骨痛
右下肢深部静脈血栓症	下肢静脈血栓症	胸部打撲傷
カテーテル感染	カテーテル感染症	メンデルソン症候群
腫瘍多発	腫瘍	中毒性好中球減少症
背部筋緊張高い	筋強直	大動脈弁下部狭窄症
全身紅斑	紅斑症	てんかん大発作
しびれてる感	しびれ感	閉鎖性膀胱損傷
少量尿失禁	尿失禁症	反復性肩関節脱臼
脳腫瘍切除	脳腫瘍	射精不能症
右側下顎骨体部骨折	下顎骨骨折	空腸神経内分泌細胞癌
高血糖是正	高血糖症	口唇虫刺傷
腫瘤拡大	腫瘤	胃結核
病原性大腸菌	病原性大腸菌感染症	記憶喪失
耳小骨奇形	耳小骨の先天奇形	顎関節強直症
全身性紫斑	全身性紫斑病	肺異物
微小多発脳梗塞	多発性脳梗塞	腋窩神経損傷
右股関節亜脱臼	股関節亜脱臼	中葉非小細胞肺癌
糸球体血尿	血尿	鎖骨腫瘍
左橈骨神経麻痺	橈骨神経麻痺	ＭＥＬＡＳ症候群
全身性間代性痙攣	間代性痙攣	踵骨不顕性骨折
右肋間痛	肋間痛	瀬川病
右続発性緑内障	続発性緑内障	足底腱膜線維腫症
軟骨腫	骨軟骨腫	直腸静脈瘤
開大性代謝性アシドーシス	代謝性アシドーシス	須毛毛瘡
パニック様症状	全般性不安障害	野兎病
胆嚢充満結石	胆のう結石症	頭部打撲
左上葉肺転移	転移性肺腫瘍	乾性胸膜炎
軽度しびれ感	しびれ感	閉鎖性膀胱損傷
意識レベル低	意識障害	陰茎切断
爪囲紅斑	爪囲炎	てんかん大発作
子宮頸癌Ｉｂ１期	子宮頚癌	十二指腸平滑筋肉腫
感覚性運動失調	運動失調	思春期貧血
両側鎖骨上窩リンパ節腫大	リンパ節腫大	鎖骨下動脈閉塞症
中枢性めまい	中枢性めまい症	頚動脈小体悪性腫瘍
関節滑膜炎	滑膜炎	多発性骨壊死
続発性膜性腎症	膜性腎症	頬部脂肪腫
立位保持困難	四肢筋力低下	胸部硬結
先天性風疹症侯群	先天性風疹症候群	上肢下肢損傷
左足痺れ	しびれ感	感染性胃腸炎
Ｒｉｅｄｅｌ甲状腺炎	線維性甲状腺腫	椎弓切除後脊柱後弯症
椎骨動脈狭窄	椎骨動脈狭窄症	上口唇挫傷
活動性肺結核症	活動性肺結核	耳後部腫脹
鼻腔化膿性肉芽腫	細菌性肉芽腫症	下顎遠心咬合
痙攣発作再発	痙攣発作	反復性虹彩毛様体炎
右脛骨内果骨折	足関節内果骨折	卵管線維腫
左胸膜転移	胸膜播種	爪刺創
卵巣腫瘍再発	卵巣腫瘍	足関節第３度熱傷
右肺中葉転移	転移性肺癌	慢性漿液ムチン性中耳炎
下腿筋痛	下肢筋肉痛	脳室静脈性血管腫
右大腰筋血腫	血腫	尿道下裂
十二指腸潰瘍再発	慢性十二指腸潰瘍	肛門ポリポーシス
Ａｆ不変	心室細動	腋窩急性リンパ節炎
左下腿部帯状疱疹	帯状疱疹	心因性便秘
顔面麻痺１	顔面神経麻痺	コア破損
巨大腫瘤	腫瘤	胃結核
右足関節腫脹	足関節腫脹	水腎症を伴わない後天性腎盂尿管移行部狭窄
外陰部湿疹	湿疹	眼瞼咬創
両肺副雑音	胸部音異常	限局性多毛症
腎機能異常	腎機能検査異常	オピッツ病
姿勢障害	姿勢異常	肺腫瘤陰影
左肘頭開放骨折	開放骨折	第３脳室腫瘍
イレウス発生	イレウス	母指切断
若干硬結	硬結	重症先天性好中球減少症
左骨盤内リンパ嚢胞	骨盤部感染性リンパのう胞	小腸びらん
発作性３度房室ブロック	第３度房室ブロック	肝吸虫症
身体損傷	損傷	小指ＭＰ関節側副靱帯損傷
右大腿骨骨腫瘍	大腿骨腫瘍	慢性胃炎
慢性胆嚢炎	慢性胆のう炎	頬部皮膚欠損創
偽性高Ｋ血症	高カリウム血症	発育異常
反応性胸水	胸水貯留	偽緑内障
元々痛み	疼痛	過酸症
骨盤内膜症	骨盤子宮内膜症	幻肢
右耳下腺腫瘤	耳下腺腫瘤	下顎咬創
肝形質細胞腫	形質細胞腫	新生児の筋緊張障害
躁病相	躁状態	硬質レジンジャケット冠粗造
易出血傾向	出血傾向	大腿骨骨幹部粉砕骨折
ジューリング疱疹状皮膚炎	ジューリング病	薬剤性過敏症症候群
末梢発赤	発赤	手背皮膚癌
部分性脂肪萎縮症	部分的脂肪萎縮症	趾皮膚潰瘍
亜急性脊髄連合変性症	亜急性連合性脊髄変性症	外傷性肝破裂
副腎偶発腫	良性副腎皮質腫瘍	間欠性内斜視
右下腿紅斑	紅斑症	外傷性聴神経損傷
腸管通過障害	消化管狭窄	上腕第１度熱傷
努力様呼吸	起坐呼吸	胃周囲リンパ節転移
膿疱形成	膿疱	腟断端炎
左卵巣膿瘍	卵巣膿瘍	食道ひだ
発赤皮疹	発疹	頚部白癬
赤痢アメーバ大腸炎	アメーバ赤痢	胸椎腫瘍
サイトメガロウイルス感染	サイトメガロウイルス感染症	ＣＡＤ／ＣＡＭ冠破損
Ｇｒａｄｅ　３肝障害	肝障害	頚部脊柱管狭窄症
低ＡＬＢ血症	低アルブミン血症	不完全左脚ブロック
Ⅱ型糖尿病	２型糖尿病	硬膜下血腫・頭蓋内に達する開放創合併なし
両顎関節痛	顎関節痛	口腔癌
逆流性胆管炎	逆行性胆管炎	無トランスフェリン血症
関節痛症状	関節痛	喉頭内異物による窒息
空気塞栓	空気塞栓症	５分の４冠過高
肝膿瘍破裂	肝膿瘍	腓骨動脈損傷
総肺静脈還流異常症	肺静脈還流異常症	本態性ペントース尿症
両下腿痛	下腿痛	髄膜炎菌性球後視神経炎
左橈骨頭脱臼骨折	脱臼骨折	網膜中心静脈閉塞症による黄斑浮腫
正中創感染	創傷感染症	メサンギウム増殖性糸球体腎炎
左網膜分枝動脈閉塞症	動脈閉塞症	急性穿孔性虫垂炎
頸部浮腫	浮腫	片頭痛
肺扁平上皮癌、病期不明	肺扁平上皮癌	尿管断裂・骨盤腔に達する開放創合併あり
低血圧自覚症状	低血圧症	２型糖尿病性腎症第３期Ｂ
常時痛み	疼痛	妊娠・分娩・産褥の既存の高血圧性心疾患
倦怠感増	倦怠感	全部性歯髄炎
脾臓腫瘍	脾腫瘍	下腿母斑
多発肝転移増大	転移性肝癌	中指挫創
頸部食道狭窄	食道狭窄	膝蓋骨偽関節
陰茎アポクリン癌	陰茎アポクリン腺癌	大腿骨壊死
元来月経痛	月経痛	脚気
胆嚢十二指腸瘻	胆のう十二指腸瘻	三叉神経損傷
特発性肺胞出血	肺胞出血	急性骨盤腹膜炎
左鼠径部疼痛	鼡径部痛	腱付着部炎
左側頬粘膜癌	頬粘膜癌	上腕神経痛
円盤状皮疹	円板状エリテマトーデス	大腸憩室出血
左手首疼痛	手部痛	頬粘膜咬創
アレルギー反応	アレルギー	検診
夜間痙攣	痙攣	先天性結核
膵体部小嚢胞	腫瘍性膵のう胞	ベーチェット病
耳介脂漏性湿疹少	脂漏性皮膚炎	乳房動脈損傷
両側急性硬膜下出血	急性硬膜下血腫	強直間代発作
毎回尿失禁	尿失禁症	反復性肩関節脱臼
喉頭蓋腫脹	喉頭蓋炎	脛骨腓骨遠位端骨折
愁訴	不定愁訴症	皮膚リーシュマニア症
血腫不変	血腫	外傷性中耳腔出血
各種膠原病	膠原病	複合部位の骨折
肺気胸	気胸	臍帯卵膜付着
深部感覚鈍麻	感覚異常症	肘損傷
脊柱圧痛	圧痛	脱水型低ナトリウム血症
亜脱臼傾向	亜脱臼	サルコスポリジウム症
自傷痕	自傷	老年性骨粗鬆症・病的骨折あり
嘔吐持続	嘔吐症	腹部大動脈血栓症
痙攣重積後脳症	痙攣重積型二相性急性脳症	肺炎球菌性髄膜炎
小腸大腸型	小腸大腸クローン病	項部硬直
薬剤肝障害	薬物性肝障害	悪寒戦慄
転移性膵体部癌	膵体部癌	流産熱
左前頭葉神経膠腫	前頭葉神経膠腫	ストレス潰瘍
精神運動興奮	精神運動興奮状態	尺骨内軟骨腫
インフルエンザＡ型感染症	インフルエンザＡ型	老年性そう痒症
紅斑反応	紅斑症	膀胱頚部ポリープ
右尿管結石症	尿管結石症	プラスマ細胞増加症
瞳孔不同	瞳孔不同症	内麦粒腫
多発肝転移巣	転移性肝腫瘍	中指挫創
顕微鏡的大腸炎	大腸炎	胎向異常胎児
直腸Ｒａ癌	直腸癌	屈折性遠視
原発性アルドステロン	原発性アルドステロン症	老年性骨粗鬆症・脊椎病的骨折あり
苔癬局面	苔癬	新膀胱形成状態
足趾爪混濁肥厚	ころもじらみ寄生症	腰椎圧迫骨折
ＣＭＶ肺炎	サイトメガロウイルス肺炎	熱傷後ケロイド
右ＩＣＡ狭窄	内頚動脈狭窄症	外傷性小脳血腫・頭蓋内に達する開放創合併あり
痰貯留	喀痰	先天性円錐水晶体
足趾蜂窩織炎	足蜂巣炎	活動期トラコーマ
僧帽弁狭窄兼逆流症	僧帽弁狭窄症	包皮腫瘤
中背部悪性黒色腫	背部悪性黒色腫	肺静脈血栓塞栓症
歯槽膿漏	歯周炎	カンジダ感染母体より出生した児
左肘関節破壊	関節リウマチ・肘関節	蘇生に成功した心停止
副甲状腺亢進症	副甲状腺機能亢進症	歯冠継続歯破損
右声帯不全麻痺	声帯不全麻痺	猩紅熱
心合併症	心臓合併症	ピリン疹
皮下石灰化	皮膚石灰沈着症	皮膚付属器腫瘍
薬剤性発熱	発熱	淋菌性精巣炎
労作時前胸部痛	前胸部痛	上行結腸憩室穿孔
肺炎等	肺炎	斑状網膜
軽度ＡＤＨＤ	注意欠陥多動障害	自然流産胎児
新生児一過性多呼	新生児一過性多呼吸	広範囲顎骨支持型装置周囲炎
両心房拡大	心肥大	家族性腎炎
上転障害	眼球運動障害	胃腸ムコール症
不眠状態	不眠症	遊走性紅斑
プレクリニカルクッシング症候群	クッシング症候群	鼓膜外傷後遺症
左胸鎖乳突筋炎	胸鎖乳突筋炎	傾軸進入
腫瘍性	腫瘍	不全中隔子宮
時々関節痛	関節痛	カリエスのない歯髄炎
嫌悪感	悪寒	ビタミンＫ欠乏による凝固因子欠乏
二次性僧帽弁閉鎖不全症	僧帽弁閉鎖不全症	外傷性虹彩離断
急性大動脈弁閉鎖不全	大動脈弁閉鎖不全症	細菌疹
左心肥大	心肥大	外傷性血胸・胸腔に達する開放創合併あり
腹痛嘔気	嘔気	十二指腸腫瘍
前頭部打撲	頭部打撲	ボーエン様丘疹症
左大腿部骨外性粘液型軟骨肉腫	軟骨肉腫	頭部多発擦過創
高度異形成相当	子宮頚部高度異形成	続発性甲状腺機能低下症
腹緊なし	腹部膨満	頭頂部髄膜腫
右頚部ＬＮ腫大	リンパ節腫大	聴覚失認
側卵巣嚢腫	卵巣のう腫	産褥骨盤腹膜炎
哺乳後嘔吐	嘔吐症	下肢脱力感
右結石性腎盂腎炎	結石性腎盂腎炎	項部皮膚癌
Ｃｒｏｎｋｈｉｔｅ−Ｃａｎａｄａ症候群	クロンカイト・カナダ症候群	上顎石灰化上皮性歯原性腫瘍
心嚢液貯留	心膜液貯留	前腕第３度熱傷
臓器限局性前立腺癌	限局性前立腺癌	帯状疱疹後多発性ニューロパチー
貧血傾向	貧血	関節脱臼後遺症
右中大脳動脈梗塞	内頚動脈塞栓症	悪性腫瘍
日中傾眠	傾眠症	腓骨近位部良性骨腫瘍
脾臓結核	結核	急性カタル性虫垂炎
食後高血糖	高血糖症	口唇虫刺傷
高浸透圧血症	高血糖高浸透圧症候群	下行結腸憩室穿孔
両下肢軽度浮腫	下肢浮腫	恥骨部打撲
右間歇性跛行	間欠性跛行	自然気胸
陰嚢ヘルニア	陰のうヘルニア	慢性膀胱炎
多形紅斑型薬疹	薬疹	側脳室海綿状血管腫
右腋窩リンパ節腫脹	腋窩リンパ節腫脹	橈骨遠位端関節内骨折
静脈内腫瘍栓	腫瘍	下顎部石灰化上皮腫
爪甲剥離症	爪剥離症	職業神経症
再度急性腎不全	急性腎不全	熱傷ショック
進行再発大腸癌	大腸癌	大腿骨顆部開放骨折
胃接合部癌	胃癌	手指脱疽
耳閉塞感	耳閉感	二絨毛膜二羊膜性双胎
手足しびれ	しびれ感	趾悪性黒色腫
内膜損傷	損傷	鼻石
胃小彎側ＬＮ転移	胃周囲リンパ節転移	のう胞性リンパ管腫
軽度発達遅滞	発達遅滞	アテローム動脈硬化症
非浸潤性膀胱癌	膀胱癌	グアネチジン中毒
右先天性耳瘻孔	先天性耳瘻孔	鎖骨開放性粉砕骨折
脂肪腫摘出	脂肪腫	背部平滑筋肉腫
椎間板ヘルニア有	椎間板ヘルニア	先天性脊柱前弯
扁平ポリープ	ポリープ	下咽頭異物
咽頭知覚障害	咽頭異常感症	頬骨変形治癒骨折
腸液貯留	体液貯留	総排泄腔外反症
両変形性膝関節症	変形性膝関節症	下顎骨腫瘍
急性胆嚢胆管炎	胆管炎	層間白内障
扁平上皮癌	癌	殿部メルケル細胞癌
内痔核脱出	内痔核	先天性無トランスフェリン血症
びまん性脳浮腫	脳浮腫	閉経後骨粗鬆症・大腿部病的骨折あり
呼気困難	呼吸困難	胸部大動脈瘤破裂
重症鬱血性心不全	うっ血性心不全	上肢知覚異常
大腸早期癌	大腸癌	大動脈狭窄症
喘鳴聴取	喘鳴	躯幹膿痂疹性湿疹
左乳癌特	乳癌	腹膜悪性腫瘍
Ａ型溶連菌感染症	溶連菌感染症	レーザー・トルラ症候群
悪性副腎外褐色細胞腫	褐色細胞腫	気管内出血
傍隔壁型肺気腫	肺気腫	口角部挫創
角膜糜爛	角膜びらん	前置血管胎児
骨盤内播種新生	骨盤転移	淋菌性腟炎
急性非代償性心不全	心不全	ダノン病
最近便秘	便秘症	胸水結核菌陽性
右頬部痛	頬部痛	老人性眼瞼外反症
右肺動静脈瘻	肺動静脈瘻	肩関節開放性脱臼骨折
１型高ウイルスＣ型慢性肝炎	Ｃ型慢性肝炎	大腸カルチノイド
問題なし膀胱直腸障害	膀胱直腸障害	腹壁神経痛
Ｌｉｓｔｅｒｉａ腸炎	細菌性腸炎	バベシア症
右膿胸	膿胸	視床星細胞腫
ヒリヒリ感	疼痛	昆虫毒
時折胸痛	胸痛	ループスアンチコアグラント
大動脈弁下心室中隔欠損	心室中隔欠損症	頬部血管肉腫
右傍矢状静脈洞髄膜腫	髄膜腫	原発性胆汁性胆管炎に伴う食道静脈瘤出血
無自覚性低血糖	低血糖	網膜中心静脈血栓症
両側卵管留血腫	卵管留血腫	閉鎖性外傷性くも膜下出血
脱水注意	脱水症	手掌部軟部腫瘍
心尖部型肥大型心筋症	肥大型心筋症	再発性十二指腸潰瘍
右飛蚊症	飛蚊症	趾ひょう疽
腎不全保存期	腎不全	脊髄疾患
口腔内炎	口内炎	無感覚症
びまん性大細胞	びまん性大細胞型Ｂ細胞性リンパ腫	肋軟骨骨折
大うつ病	単極性うつ病	膝関節開放骨折
肝門部悪性リンパ腫	肝門部リンパ節転移	新生児梅毒
精神病性うつ病	うつ病	散在性脈絡膜炎
水疱性類天疱	水疱症	腹壁筋痛
中枢性低換気	換気量減少	眼瞼メラノーシス
右膝ＡＣＬ損傷	前十字靱帯損傷	頚椎捻挫後遺症
全身倦怠感軽度	全身倦怠感	重症多形滲出性紅斑・急性期
混合難聴	難聴	脳動脈瘤
毛孔一致性丘疹	丘疹	心筋不全
先天性巨大色素性母斑	巨大母斑細胞母斑	巨大十二指腸
不安大	不安障害	膝関節軟骨損傷
胸骨下液体貯留	体液貯留	総排泄腔外反症
新出肺転移	転移性肺腫瘍	デュピュイトラン拘縮
左聴器癌	癌	原発性甲状腺機能亢進症
多発脳神経障害	多発性脳神経障害	反復性肘関節脱臼
上腹部リンパ節転移	リンパ節転移	のう胞性リンパ管腫
被殻梗塞	被殻出血	ＣＲＨ産生腫瘍
直腸Ｒａｂ癌	直腸癌	屈折性遠視
軽度高血糖	高血糖症	口唇虫刺傷
本日硬便少量	便異常	総胆管結石
２型腫瘤	腫瘤	胃結核
右腎無形成	腎無形成	ムンプス腎炎
リンパ節圧痛	圧痛	両側性矮小腎
全身性細菌感染症	細菌感染症	脳幹性前兆を伴う片頭痛
脳髄膜瘤	髄膜脳瘤	後天性生毛性多毛症
水頭症症状	水頭症	毛皮商人肺
小血栓	血液凝固異常	気胸
右耳失聴	聴覚消失	不安障害
統合失調症合併	統合失調症	先天性腎動脈狭窄症
胃痛症状	胃痛	右室流出路狭窄
急性期ＨＩＶ感染症	ＨＩＶ感染症	外耳道異物
右下肢運動障害	四肢運動障害	高尿酸血症
炎症性脱髄性多発根神経炎	慢性炎症性脱髄性多発神経炎	増殖性外毛根鞘性のう腫
上行結腸腫瘤	腫瘤	背部リンパ管腫
過食症状	過食症	先天性大静脈狭窄症
疾病不安	不安障害	ざんごう熱
肺癌手術	肺癌	傍卵巣のう胞
色素脱失	炎症後色素脱失	脳脊髄液ホルモンの異常値
膿貯留	膿瘍	大腿骨慢性骨髄炎
片側副腎腫瘍	副腎腫瘍	結膜腐蝕
リンパ節腫脹	リンパ節腫大	先天性動静脈瘤
右椎骨動脈巨大血栓化動脈瘤	椎骨動脈瘤	先天性腟奇形
カテ感染	カテーテル感染症	メンデルソン症候群
安心感	心気症	ビタミンＫ欠乏による凝固因子欠乏
左鼡径ヘルニア再発	鼡径ヘルニア	異所性ホルモン産生腫瘍
胃食道静脈瘤破裂	食道静脈瘤破裂	動脈硬化性腎硬化症
左足背蜂窩織炎	足背蜂巣炎	視神経低形成
右胸水貯留	胸水貯留	偽緑内障
暗青色斑	青色母斑	亀裂性湿疹
ＨＣＶ陽性	Ｃ型肝炎ウイルス感染	坐骨神経痛
疲労感生	疲労感	広範囲顎骨支持型補綴物脱離
感染性静脈血栓症	静脈血栓症	輸血後鉄過剰症
両側腎腫大	腎腫大	心中隔欠損症
過敏性膀胱炎	膀胱炎	術後リンパ漏
包交時出血	出血	橈骨末端手根骨開放骨折
右坐骨骨折	坐骨骨折	急性外陰腟炎
右耳下腺腫脹	耳下腺腫脹	Ｘ連鎖無ガンマグロブリン血症
進行肺癌	肺癌	義歯咬合面不適合
肋骨起始部骨転移	肋骨転移	胆のう摘出後症候群
外傷性変化	外傷	溺水
中等度精神遅滞	中等度知的障害	声門下浮腫
先天性左股関節脱臼	先天性股関節脱臼	三角靱帯捻挫
リポフスチン沈着	神経セロイドリポフスチン症	常染色体異常
鮮血痰	血痰	直腸神経内分泌腫瘍
壊死性変化	壊死	須毛偽毛包のう炎
溶連菌感染	溶連菌感染症	膝蓋骨打撲傷
局所発赤	発赤	手背皮膚癌
不整脈チーム	不整脈	側頭骨良性腫瘍
中等度ＣＯＰＤ	慢性閉塞性肺疾患	ビタミンＤ過剰症
胸部圧痛	圧痛	スティフ・マン症候群
両上肢痛	上肢痛	上腕骨変形治癒骨折
気分不快症状	悪心	角結膜擦過傷
右上腕骨近位端粉砕骨折	上腕骨近位端粉砕骨折	アレルギー性結膜炎
乳突蜂巣	乳様突起炎	胃破裂・腹腔に達する開放創合併なし
褥創形成	褥瘡	上腕母斑細胞母斑
ガマ腫	がま腫	先天性股関節脱臼遺残変形
膀胱腫瘍再発	膀胱腫瘍	感染性喉頭気管炎
夜間せん妄状態	せん妄	白血病性関節症
神経系腫瘍	腫瘍	屈曲部乾癬
クッシング徴候	クッシング症候群	鼓膜外傷後遺症
先天性側弯	肋骨異常を伴う先天性側弯症	外尿道口腫瘍
非定型抗酸菌肺炎	肺炎	眉毛部石灰化上皮腫
軽度甲状腺腫大	甲状腺腫	手指中節骨骨折
手足痺れ	四肢しびれ	硬化性血管腫
節外性濾胞辺縁帯リンパ腫	脾辺縁帯リンパ腫	アトピー性皮膚炎
左下葉肺癌	下葉肺癌	外傷性耳小骨脱臼
Ｋｌｅｂｓｉｅｌｌａ　ｐｎｅｕｍｏｎｉａｅ敗血症	新生児クレブシエラ敗血症	赤外線白内障
若年性認知症	認知症	ＭＬＬ再構成型Ｂリンパ芽球性白血病／リンパ腫
外腸骨域リンパ節腫大	リンパ節腫大	飛び込み自殺
貧血高度	貧血	家族性血球貪食性細網症
腰部腫瘍	腰椎部腫瘍	中頭蓋窩髄膜腫
鼠径ヘルニア	鼡径ヘルニア	クロストリジウム・ディフィシル腸炎
分化型管状腺癌	癌	高機能自閉症
侵襲性肺アスペルギウス症	侵襲性肺アスペルギルス症	低体重
孤発性ＣＪＤ	孤発性クロイツフェルト・ヤコブ病	足どり不安定
右下葉結節影	胸部異常陰影	腰椎炎
軽度左軸偏位	心電図左軸偏位	精索腫瘤
左頚部結核性リンパ節炎	結核性リンパ節炎	舌裂
食道がん	食道癌	増殖性硝子体網膜症
肛門部発赤	発赤	後縦隔脂肪肉腫
脳室拡大進行	脳室拡大	術後骨弁感染
下腿潰瘍	下腿皮膚潰瘍	リステリア性脳動脈炎
小脳転移	転移性脳腫瘍	老人性円背
腎盂軽度拡張	腎盂拡張	第２色弱
腫瘍指摘	腫瘍	射精不能症
心臓原発性悪性リンパ腫	心臓悪性リンパ腫	エソファゴストム症
準夜帯嘔気	嘔気	三尖弁閉鎖症
成人Ｓｔｉｌｌ病	成人スチル病	器質性月経困難症
脳血管疾患	脳血管障害	下肢圧挫損傷
左膝窩部痛	膝窩部痛	脳脊髄炎
非浸潤性尿路上皮癌	尿管尿路上皮癌	エンドリーク
下咽頭がん	下咽頭癌	高フィブリノゲン血症
両上肢痺れ	上肢しびれ	卵巣のう胞
混合性肝癌	肝癌	思春期月経過多
甲状腺痛	甲状腺炎	出血性内痔核
少量血便	血便	下腸間膜動脈瘤
脳梗塞有	脳梗塞	単純性関節炎
痕発赤	発赤	手背皮膚癌
不消化便	消化不良性下痢	巨指症
末梢性めまい	めまい症	網膜中心静脈閉塞症
左上腕骨肉腫	上腕骨骨肉腫	皮下唇裂
四肢型運動失調	運動失調	高尿酸血症
産生胃癌	胃癌	中心性脈絡網膜症
下肢冷感軽度	下肢冷感	家族性溶血性貧血
左室内同期不全	左室不全	糞便性嘔吐
左脛腓骨骨折	腓骨骨折	剥離性間質性肺炎
漿液性腺腫	卵巣漿液性腺腫	多乳頭症
日本海裂頭条虫	日本海裂頭条虫症	パーキンソン病Ｙａｈｒ５
先天性脳血管異常	脳動静脈奇形	エボラ出血熱
臀部皮疹	発疹	マキシラリトラクター不適合
歩行時軽度跛行	跛行	精神的幼児性パーソナリティ障害
心室中隔扁平化	心室中隔欠損症	深大腿動脈損傷
フルニエ壊疽	外陰部壊死性筋膜炎	肘部ガングリオン
肝芽腫再発	肝芽腫	関節ロッキング
状血管腫	血管腫	肩せつ
卵巣癌破裂	卵巣癌	頭皮下血腫
右下腿疼痛	下腿痛	髄膜炎菌性球後視神経炎
軽度眼球突出	眼球突出症	慢性本態性好中球減少症症候群
前頭葉障害	前頭葉症候群	胆のう管閉塞症
歯牙損傷	切歯破折	家庭限局性素行障害
両側乳糜胸水	胸水貯留	骨のう腫
肺門部リンパ節腫大	肺門リンパ節腫脹	全身性紫斑病
麻疹罹患歴	麻疹	陳旧性遠位脛腓靱帯損傷
尿漏れ	尿失禁症	小脳星細胞腫
心膜播種	腹膜播種	外耳部割創
髄液播種	腹膜播種	淋菌性腟炎
左腎動脈狭窄症	腎動脈狭窄症	歯髄出血
体動時創部痛	術創部痛	大転子開放骨折
後頭部皮下血腫	頭部皮下血腫	尿細胞数増加
ＭＲＳＡ菌血症	ＭＲＳＡ感染症	延髄空洞症
篩骨蜂巣	篩骨洞炎	亜急性毛様体炎
左退形成性星細胞腫	退形成性星細胞腫	急性発疹症
仮性動脈瘤切除	偽性動脈瘤	動脈硬化性腎硬化症
鼻中隔血腫	血腫	低レニン血症
左嗅裂ポリープ	ポリープ	ビリルビン代謝障害
労作時疲労	疲労感	広範囲顎骨支持型補綴物脱離
不定愁訴多	不定愁訴症	皮膚リーシュマニア症
軽度失調性構音障害	構音障害	肝癌骨転移
びらんからの出血	出血	頬部刺創
動揺性精神神経症状	神経症	筋性防御
過呼吸気味	過換気症	前立腺膿瘍
真菌性感染性心内膜炎	細菌性心内膜炎	髄膜炎後遺症
気道狭窄音	気道狭窄	リスフラン関節離断術後
未分類関節炎	関節炎	医原性気胸
左視床出血	視床出血	舞踏病
骨突出部発赤	発赤	黄斑障害
神経症性うつ病	抑うつ神経症	低脂血症
右浸潤影	胸部異常陰影	ＩＣＵ症候群
四肢近位筋筋力低下	筋力低下	外耳道外傷
左耳後部腫瘤	耳後部腫瘤	新生児敗血症
右乳腺良性腫瘍	乳腺腫瘍	鼻尖有棘細胞癌
左尿管結石性腎盂腎炎	結石性腎盂腎炎	項部皮膚癌
イレウス気味	偽性イレウス	足背部第１度熱傷
筋力低下可能性	筋力低下	可撤性保定装置不適合
咽喉頭違和感	咽喉頭異常感症	弁膜症性心房細動
前立腺癌死	前立腺癌	先天性動脈狭窄症
再度皮疹	発疹	大腸憩室出血
左肩腱板損傷	肩腱板損傷	頭蓋内胚細胞腫瘍
低形成	骨髄低形成	少関節型若年性関節炎
再脱臼	脱臼	卵巣類内膜腺癌
左肺動脈狭窄症	肺動脈狭窄症	足底角化症
肺動脈弁上狭窄	肺動脈弁上狭窄症	ゴムアレルギー性接触皮膚炎
後頸部発赤	発赤	手背皮膚癌
血管原性浮腫	浮腫	てんかん
偽粘液腫	粘液腫	骨形成不全症３型
毛包向性菌状息肉症	菌状息肉症	陰茎第３度熱傷
Ｂｌｕｅ　ｔｏｅ　ｓｙｎｄｒｏｍｅ	末梢動脈疾患	上顎石灰化上皮性歯原性腫瘍
嚢胞様腫瘤像	腫瘤	脛骨腓骨骨折
右足不随意運動	不随意運動症	陰茎外傷
婦人科癌	癌	複殿位
両側眼振	眼振	気管損傷
爪水虫	爪白癬	肺乳頭腫
子宮体癌Ｉａ期	子宮体癌	股関節部付着部症
過活動型せん妄	せん妄	ＨＩＶ感染
左下肢鬱滞性皮膚炎	うっ滞性皮膚炎	痙性対麻痺
ＢＰＳＤ	認知症に重なったせん妄	急性腎前性腎不全
進行性核上麻痺	進行性核上性麻痺	胃悪性リンパ腫
汎発性水痘感染症	水痘	全足位
えん下障害	嚥下障害	肺損傷
左上腕悪性黒色腫	上腕部悪性黒色腫	殿部壊死性筋膜炎
左側頭葉挫傷	脳挫傷	銃自殺未遂
虚血性肝炎	肝炎	全身第１度熱傷
重症敗血症	敗血症	肘関節内遊離体
幽門前部狭窄	幽門狭窄症	統合失調症症状を伴わない類循環精神病
圧迫移植部ネクローシス	壊死	手掌基底細胞癌
子宮頸癌子宮頚癌	子宮頚癌	水分欠乏症
舌乾燥	口腔乾燥症	子癇発作
足痛い	足痛	下腿筋腱移行部損傷
円形紅斑	紅斑症	大腸腫瘤
左眼後発性白内障	白内障	足部淡明細胞肉腫
徐脈気味	徐脈	上腕骨病的骨折
境界性パーソナリティ障害	境界型パーソナリティ障害	交通性水頭症
鼻骨折	鼻骨骨折	左脚ヘミブロック
膵尾部腫瘤性病変	膵腫瘤	慢性化膿性穿孔性中耳炎
重症腸炎	腸炎	脛骨腓骨遠位端開放性粉砕骨折
左大腿骨転子下骨折	転子下骨折	アキレス腱炎
左低形成腎	低形成腎	下腿開放創
肺野すりガラス状陰影	肺野異常陰影	外傷性脳圧迫・頭蓋内に達する開放創合併なし
アテローム性血栓性脳梗塞	血栓性脳梗塞	雷撃
結腸癌肝転移	転移性肝癌	ヘモジデリン沈着症
診察時皮疹	発疹	人工歯根破損
切開関連性心房粗動	心房粗動	子宮付属器炎
硬性白斑	白斑	胎盤位置異常
術後不整脈	不整脈	顎関節部皮下血腫
広範囲脊柱管狭窄症	広範脊柱管狭窄症	ＲＳウイルス肺炎
中～低分化肝細胞癌	肝細胞癌	仮性球麻痺
起床時咳嗽	咳	マーデルング変形
腰骨骨折	腰椎骨折	振動性じんま疹
血性腹水貯留	腹水症	家族性パーキンソン病
心理的不安	不安障害	ざんごう熱
カンジダ肺炎	肺カンジダ症	涙のう瘻
右小細胞癌	小細胞肺癌	嗄声
頬部悪性腫瘍	頬部腫瘍	胸腔内リンパ節結核・菌確認あり
多源性ＰＶＣ散発	心室期外収縮	黄体機能不全
原発性甲状腺機能低下	甲状腺機能低下症	軟部悪性巨細胞腫
ヨードアレルギー	ヨード過敏症	検診
右ＩＣ動脈瘤	内頚動脈脳動脈瘤	抗凝固剤投与状態
顔面形成	顔面形成異常	落屑性皮疹
活動性肝炎	肝炎	レーベル遺伝性視神経症
インフルエンザ陽性	インフルエンザ	耳介外傷性腫脹
眼球結膜浮腫	結膜浮腫	肋間動脈瘤
排便なし	便秘症	二次性変形性関節症
全身性Ｃａｎｄｉｄａ感染症	カンジダ症	全足位
顔面神経痛	三叉神経痛	上腕貫通銃創
多発肺膿瘍	肺膿瘍	タピア症候群
疣贅様構造物	疣贅	習慣および衝動の障害
アルコ−ル性肝硬変	肝硬変症	下行結腸過長症
皮質層状壊死	壊死	歯根露出
発熱随伴症状	発熱	急性失血性貧血
急性肺動脈血栓塞栓症	肺動脈血栓塞栓症	二次性高血圧症
両下肢深部静脈血栓症	下肢静脈血栓症	胸部打撲傷
右上腕骨近位端骨折	上腕骨近位端骨折	胆のう下垂
脳炎脳症	脳症	皮質下脳損傷・頭蓋内に達する開放創合併なし
辺縁性脳炎	脳炎	小指ＰＩＰ関節橈側側副靱帯損傷
易疲労性強い	易疲労感	機械性眼瞼下垂症
せん妄生	せん妄	頭蓋脊椎披裂
右第３趾爪囲炎	爪囲炎	胞状腺腫
多発縦隔リンパ節転移	縦隔リンパ節転移	外陰静脈瘤
家族性ＣＪＤ	家族性クロイツフェルト・ヤコブ病	足どり不安定
圧迫時疼痛	疼痛	月経中間期出血
症型Ａ群溶連菌感染症	溶連菌感染症	レーザー・トルラ症候群
末梢肺動脈塞栓症	動脈塞栓症	二次性高血圧症
歩容困難	歩行障害	Ｓ状結腸腺腫
脳室出血	出血	子宮損傷・骨盤腔に達する開放創合併なし
顔面痺れ	しびれ感	感冒性腹症
尿失禁状態	尿失禁症	反復性肩関節脱臼
重度失調性構音障害	構音障害	皮膚結節性多発動脈炎
卵巣癌Ⅲｃ期	卵巣癌	出血傾向
低血糖鞘状	低血糖	ＨＩＶ間質性肺炎
発赤潰瘍	発赤	尿道口びらん
左下肺浸潤影	肺部異常陰影	ＩＣＵ症候群
右大脳動脈未破裂動脈瘤	脳動脈瘤	唾液腺萎縮
失語正常	失語症	咽頭ポリープ
先週頭痛	頭痛	先天性巨爪
ｃｅｌｌ　ｌｅｕｋｅｍｉａ	白血病	骨移植拒絶反応
失語持続	失語症	開放性腸間膜損傷
ＧＣＡ	巨細胞動脈炎	脳出血後遺性精神障害
大動脈弁硬化症	大動脈弁狭窄症	腰椎椎間板断裂
多発筋炎	多発性筋炎	顔面骨悪性腫瘍
呼吸促迫症状	呼吸促迫	膝窩動脈捕捉症候群
大腿骨骨頭壊死	大腿骨頭壊死	横川吸虫症
呼気喘鳴	喘鳴	躯幹膿痂疹性湿疹
サイトメガロ網膜炎	サイトメガロウイルス網膜炎	小腸血管形成異常
ＡＣＴＨ非依存性Ｃｕｓｈｉｎｇ症候群	クッシング症候群	上顎石灰化上皮性歯原性腫瘍
次週左気胸	気胸	混合細胞型古典的ホジキンリンパ腫
内分泌機能不全	内分泌機能異常	サルコイドーシス性虹彩毛様体炎
熱	発熱	急性失血性貧血
Ｍａｌｌｏｒｙ−Ｗｅｉｓｓ症候群	マロリ・ワイス症候群	上顎石灰化上皮性歯原性腫瘍
軽度音声障害	音声障害	後脛骨神経損傷
緑膿菌腸炎	緑膿菌性腸炎	特発性進行性多発ニューロパチー
ドレーン出血	出血	卵巣機能不全
副鼻腔転移	副鼻腔癌	周辺部ぶどう膜炎
原発不明癌頸部転移	原発不明癌	上行結腸過長症
発熱中	発熱	急性失血性貧血
再発腫瘤	腫瘤	耳介外傷性皮下異物
右錐体路障害	錐体路障害	胸椎結核
犬吠様咳嗽	咳	殿部打撲傷
両下肢筋痛	下肢筋肉痛	慢性大腸炎
左室ブロック波形	心電図異常	軸椎開放骨折
有痛性腫瘤	腫瘤	耳介外傷性皮下異物
難治性冠攣縮性狭心症	冠攣縮性狭心症	腹部膨満
起床時頭痛	頭痛	非特異的ＳＴ−Ｔ変化
Ⅱ型房室ブロック	房室ブロック	咽頭気管炎
眼白内障	白内障	肩関節異所性骨化
慢性下気道感染	急性気管支炎	腰椎奇形
乳頭様腎盂腫瘍	腎盂乳頭状癌	小児汎発性膿疱性乾癬
喀痰付着	喀痰	先天性円錐水晶体
両側下腿潰瘍	下腿皮膚潰瘍	リステリア性脳動脈炎
心肺停止後蘇生	心肺停止	びまん性肺炎
ＳＣＤ	脊髄小脳変性症	急性腎前性腎不全
無症候性腸アメーバ症	腸アメーバ症	大腿静脈損傷
手首痛	手部痛	下腿筋腱移行部損傷
頸部食道癌	頚部食道癌	分娩後遺症尿道狭窄
症候性てんかん発症	症候性てんかん	慢性デンスデポジット病
左腎血管腫	腎血管腫	胃十二指腸潰瘍
地誌的失認	失認	後頭部切創
命令性幻聴	幻聴	昏睡
子宮体癌Ⅱ期	子宮体癌	股関節部付着部症
両側副腎腫瘍	副腎腫瘍	慢性化膿性鼻咽頭炎
左顔面神経麻痺症状	顔面神経麻痺	コア破損
左顔面痛覚障害	片側痛覚鈍麻	クラミジア性前立腺炎
顎部痛	顎痛	網膜静脈閉塞症
元々疼痛	疼痛	甲状腺悪性リンパ腫
粘膿性鼻汁	鼻汁	第１中手骨裂離骨折
膣原発横紋筋肉腫	横紋筋肉腫	乾皮症
卵巣嚢腫ＯＰ	卵巣のう腫	薬剤性甲状腺機能低下症
遅発性ペースメーカー感染症	ペースメーカ植え込み後感染症	肛門尖圭コンジローマ
子宮筋肉腫	子宮肉腫	下腿脱力
肺血管陰影増強	肺血管疾患	乳房開放創
頭頸部放線菌症	放線菌症	慢性副鼻腔膿瘍
腎機能障害	腎機能低下	精巣除去後機能低下症
Ｈｏｄｇｋｉｎ　Ｌｙｍｐｈｏｍａ	ホジキンリンパ腫	瞳孔不同症
冠動脈−肺動脈瘻	肺動脈瘻	前頭位のための母体管理
嚥下時疼痛	嚥下痛	強膜化角膜
術後創感染	術後膿瘍	光沢苔癬
大腸ポリープ後	大腸ポリープ	肝線維症
右下葉扁平上皮癌	下葉肺扁平上皮癌	殿部メルケル細胞癌
咳嗽法	咳	マーデルング変形
高リスク前立腺癌	前立腺癌	膀胱タンポナーデ
門脈圧亢進	門脈圧亢進症	頬部切創
認知面低下	軽度認知障害	胎盤梗塞新生児
ノカルジア	ノカルジア症	炎症性アテローム
右人工膝関節感染	人工膝関節感染	間欠性爆発障害
膿梗塞	脳梗塞	ビールス症候群
下大静脈狭窄	大静脈狭窄症	大腿二頭筋内頭損傷
十二指腸穿通性潰瘍	穿通性十二指腸潰瘍	脛骨骨幹部開放骨折
左横隔膜弛緩症	横隔膜弛緩症	胎児共存奇胎
火傷	熱傷	側頭部母斑細胞母斑
入眠困難感	不眠症	重症多形滲出性紅斑・急性期
非定型カルチノイド腫瘍	カルチノイド	糸状線維腫
軽度食欲低下	食欲不振	心臓電子器具の機械的合併症
尿管結石有	尿管結石症	プラスマ細胞増加症
両下腿壊疽性膿皮症様潰瘍	膿皮症	急性側壁心筋梗塞
冠攣縮型狭心症	冠攣縮性狭心症	腹部膨満
恥骨骨髄炎	骨髄炎	足背部第２度熱傷
かすみ目	視力低下	ヘモグロビンＳＳ病
眩暈消失	めまい	性交痛
手指関節腫脹	関節炎	水腎症を伴わない後天性腎盂尿管移行部狭窄
ＳＰＮ	充実性偽乳頭状腫瘍	坐骨神経痛
夜間嘔気	嘔気	三尖弁閉鎖症
左足背発赤	下腿発赤	手背皮膚癌
女性器クラミジア感染症	クラミジア感染症	滲出型加齢黄斑変性
血液凝固障害	血液凝固異常	軽症腺ペスト
慢性的な呼吸困難	呼吸困難	プロラクチン分泌異常症
右肺下葉肺炎	肺炎	斑状網膜
低酸素虚血性脳症	低酸素性脳症	多発性パラミオクローヌス
左大葉性肺炎	大葉性肺炎	先天性尿道奇形
膵臓癌術後再発	膵癌	絨毛血管腫
足底湿疹	足湿疹	精液異常
歩行ふらつき	めまい	精神的幼児性パーソナリティ障害
結腸縫合不全	縫合不全	腰部筋筋膜炎
多発肝血管腫	多発性肝血管腫	結核腫
紅色腫瘤	腫瘤	潜伏性早期先天梅毒
気管支閉鎖症	気管支閉鎖	外傷性脳動脈瘤・頭蓋内に達する開放創合併なし
神経アミロイドーシス	アミロイドーシス	皮質静脈血栓症
夜疼痛	疼痛	甲状腺悪性リンパ腫
咽頭粘膜発赤	発赤	後縦隔脂肪肉腫
時々不整脈	不整脈	側頭骨良性腫瘍
多発性リンパ節転移	多部位リンパ節転移	眼窩内髄膜腫
新生児死亡	原因不明の死亡	軟膜炎
最近花粉症	花粉症	塵肺症
食道空腸吻合部狭窄	吻合部狭窄	食道リンパ管腫
クリオグロブリン性血管炎	クリオグロブリン血症性血管炎	口内炎
右頬部擦過傷	頬部擦過創	非器質性精神病
右肺下葉癌	下葉肺癌	外傷性耳小骨脱臼
腎結石多発	腎結石症	混性近視
ＥＢウイルス初感染	ＥＢウイルス感染症	前額部打撲傷
外表奇形	奇形	延髄性知覚消失
急性膵臓炎	急性膵炎	続発性血小板減少性紫斑病
Ｉｓｐポリープ	大腸ポリープ	下咽頭異物
咽頭部発赤	発赤	後縦隔脂肪肉腫
頭部腫瘍	頭部皮下腫瘍	全子宮脱
遅発性発疹	発疹	乳児レフサム病
肺炎悪化	肺炎	開放性矢状洞部硬膜外血腫
朝痰	喀痰	舌扁桃炎
子宮体癌Ⅳ期	子宮体癌	股関節部付着部症
骨外腫瘤形成	腫瘤	総腸骨動脈損傷
低悪性度Ｂ細胞性リンパ腫	びまん性大細胞型Ｂ細胞性リンパ腫	胆管萎縮
視神経脊髄炎（ＮＭＯ）	視神経脊髄炎	常同性運動障害
左下副甲状腺腺腫	副甲状腺腺腫	歯肉退縮
単形性ＶＴ	非持続性心室頻拍	眼瞼欠損
特発性心室細動	心室細動	傾斜歯
高脂血症高脂血症	高脂血症	食道熱傷
白色調腫瘍	腫瘍	メルケル細胞癌
左頬部有棘細胞癌	頬部有棘細胞癌	不正咬合
Ｇｏｔｔｒｏｎ徴候	ゴットロン丘疹	上顎石灰化上皮性歯原性腫瘍
脊柱起立筋膿瘍	筋膿瘍	反復性前房蓄膿
左踵骨骨折	踵骨骨折	第３趾有棘細胞癌
胃癌幽門狭窄	幽門狭窄症	分娩における麻酔合併症
拡張能障害	心不全	肺壊疽
小腸静脈瘤破裂	食道静脈瘤破裂	顔面脂腺癌
右上肢振戦	一側上肢振戦	膵管内管状腺癌
中枢性甲状腺機能低下症	甲状腺機能低下症	軟部悪性巨細胞腫
左肺動脈閉塞	肺動脈狭窄症	手指第２度熱傷
単純性網膜症	網膜症	四肢小児湿疹
両眼性複視	複視	骨盤位牽出術
Ｈｅｎｏｃｈ−Ｓｃｈｏｎｌｅｉｎ紫斑病	ＩｇＡ血管炎	上顎石灰化上皮性歯原性腫瘍
右胸腔内腫瘍	腫瘍	高ＬＤＬ血症
尿もれ	尿失禁症	家族性軟骨石灰化症
下肢筋力低下自覚	筋力低下	両側性高音障害漸傾型感音難聴
右足静脈瘤	静脈瘤	非浸潤性乳管癌
上気道浮腫	咽頭浮腫	舌血管腫
複雑型熱性痙攣	熱性痙攣	閉鎖性尿管損傷
吻合部浮腫	浮腫	片頭痛
右膀胱側壁部膀胱癌	膀胱側壁部膀胱癌	角膜切創
Ｃａｐｎｏｃｙｔｏｐｈａｇａ　ｃａｎｉｍｏｒｓｕｓ感染症	グラム陰性菌感染症	進行性血管性白質脳症
子宮頸部頸管狭窄	子宮頚管狭窄症	１秒量低下
呼吸喘鳴	喘鳴	躯幹膿痂疹性湿疹
口腔内乾燥	口腔乾燥症	溶連菌敗血症
脊椎管狭窄症	脊柱管狭窄症	クロード症候群
ヘルペス髄膜炎	髄膜炎	小指屈筋腱断裂
左股関節破壊	股関節症	脚気心
左前庭障害	前庭障害	中縦隔悪性腫瘍
膠原繊維性腸炎	腸炎	バベシア症
食道期軽度障害	嚥下障害	十二指腸穿孔腹膜炎
右外腸骨静脈狭窄	静脈狭窄	下顎骨骨髄炎
妊娠発覚	妊娠	神経セロイドリポフスチン症
両膝関節症	膝関節症	多剤精神作用物質使用による急性精神・行動障害
類もやもや病	もやもや病	頭部メルケル細胞癌
呼内疾患ベース肺炎	肺炎	ＧＶＨＤ・骨髄移植後
左足関節開放性脱臼骨折	足関節開放性脱臼骨折	中毒性ミオパチー
白色粘性痰	喀痰	分娩に関連する非化膿性乳腺炎
食道癌２病変	食道癌	皮膚萎縮症
右卵巣奇形腫	卵巣奇形腫	異物誤嚥
感冒罹患	感冒	急性羊水過多症
血腫像	血腫	回転異常腎
ｌｙｍｐｈｏｍａ	悪性リンパ腫	外陰第３度熱傷
左足首骨折	足関節骨折	更年期出血
慢性血栓性肺高血圧症	慢性血栓塞栓性肺高血圧症	大腸重積症
眼振誘発	眼振	グレイ血小板症候群
急性ウイルス性脳炎	ウイルス性脳炎	下行性視神経萎縮
掻痒等	そう痒	股関節後方脱臼
労作時呼吸困難感軽度	労作時呼吸困難	結膜沈着症
逆流性食道炎症状	逆流性食道炎	頬粘膜炎
非代償性Ｃ型肝硬変	Ｃ型非代償性肝硬変	腹膜炎
子宮筋腫大	子宮筋腫	新生児腎不全
ヘルペス感染症	ヘルペスウイルス感染症	第４趾基底細胞癌
抑うつあり	うつ状態	低脂血症
出血腫脹	出血	続発性肥大性骨関節症
急性感音性難聴	感音難聴	切迫性尿失禁
肺塞栓既往	肺塞栓症	アマルガム低位
リンパ節多発転移	多部位リンパ節転移	前脛骨筋損傷
ｉｎｖａｓｉｖｅ　ｔｈｙｍｏｍａ	悪性胸腺腫	脳良性腫瘍
イレウスリスク高い	イレウス	網膜色素上皮症
左肺下葉扁平上皮癌	下葉肺扁平上皮癌	悪性奇形腫
分類不能型免疫不全	免疫不全	足底脂肪腫
高度拘束性換気障害	拘束性換気障害	夢幻精神病
非典型的胸痛	胸痛	急性本態性浮腫
ＭＲＳＡ感染	ＭＲＳＡ感染症	全足位
肝多発腫瘤	肝腫瘤	放火癖
左大腿骨病的骨折	大腿骨病的骨折	眼球形成不全
Ｓ状結腸癌術後肝転移	転移性肝癌	ヘモジデリン沈着症
棘波	心電図異常	開放性気管支損傷
黄色痰自己喀出	膿性痰	先天性円錐水晶体
心膜腔内播種	転移性心腫瘍	耳介創傷
耳痛	耳痛症	反射性耳痛
四肢末端しびれ	しびれ感	眼瞼石灰化上皮腫
内頸動脈狭窄	内頚動脈狭窄症	筋萎縮性眼瞼下垂
胃部分壊死	壊死	多胞性肝エキノコックス
転倒受傷	外傷	上腕淡明細胞肉腫
左急性感音難聴	感音難聴	器質性性器出血
タール便少量	黒色便	総胆管結石
切除不能胃癌	胃癌	小指伸筋腱断裂
後頭葉脳出血	脳出血	唾液分泌欠如
隅角結節	虹彩結節	膝関節内骨折
落ち着かなさ	多動性障害	髄膜炎菌性心膜炎
脊椎多発圧迫骨折	圧迫骨折	開放性外傷性脳内血腫
左傍脊柱筋膿瘍	筋膿瘍	反復性前房蓄膿
Ⅰ型ＤＭ	糖尿病	足どり不安定
多発ＬＮ転移	多部位リンパ節転移	腎性高血圧症
右角膜ヘルペス	ヘルペス角膜炎	続発性骨萎縮症
大腸粘膜癌	癌	一側上肢振戦
大動脈損傷	上大動脈損傷	虹彩血管新生
仙骨前腫瘤	腫瘤	陰部挫傷
前頭葉脳出血	脳出血	唾液分泌欠如
社会不安症	不安神経症	馬尾損傷
左頚部食道傍リンパ節転移	リンパ節転移	瞳孔不整
時折物忘れ	健忘症	ペラグラ
左頬部未分化腺癌	癌	骨盤内リンパ節の悪性腫瘍
ＩＩ型ＤＭ	２型糖尿病	足どり不安定
脊椎管狭窄	脊柱管狭窄症	尿管腸瘻
膨満　グル音正常	腹部膨満	消化管ポリープ
顔面神経麻痺静的再建	顔面神経麻痺	ターナー症候群モザイク４５Ｘ
低分化性扁平上皮癌	癌	殿部メルケル細胞癌
左房内粘液腫	心臓粘液腫	側頭部切創
重症うつ病	うつ病	膝関節開放骨折
左肺下葉浸潤影	胸部異常陰影	ＩＣＵ症候群
中葉舌区症候群	中葉無気肺	最重症再生不良性貧血
膵管炎	膵炎	エクリン汗腺の障害
軟部組織腫瘤	腫瘤	結腸ポリープ
腫瘤構造	腫瘤	胃結核
慢性誤嚥	嚥下障害	卵胞出血
Ｇｍ敗血症	敗血症	剥離性限局性舌炎
右大腿部蜂窩織炎	大腿部蜂巣炎	ケトン尿症
病的腹水	腹水症	家族性パーキンソン病
慢性疲労	疲労感	広範囲顎骨支持型補綴物脱離
膿性喀痰	膿性痰	分娩に関連する非化膿性乳腺炎
Ｃｈｏｌｅｄｏｃｈｏｃｅｌｅ	総胆管のう腫	脳出血後遺性精神障害
癌再発	癌	先天性動脈狭窄症
胆汁うっ滞型	胆汁うっ滞	微小コア疾患
肺門腫瘤	縦隔腫瘍	ウイルス性糖尿病・神経学的合併症あり
両膝関節疼痛	膝関節痛	妊娠性間質性乳腺炎
右鎖骨転移	骨転移癌	胆のう摘出後症候群
緑内症	緑内障	血小板障害症
夕方痛み	疼痛	腓骨遠位端剥離骨折
左側副部痛	側腹部痛	膀胱外反症
後腹膜腫瘍上行結腸浸潤	後腹膜腫瘍	バセドウ病母体児
心窩部自発痛	心窩部痛	癒着胎盤・出血を伴わない
リンパ節腫大傾向	リンパ節腫大	低血糖発作
時々尿失禁	尿失禁症	反復性肩関節脱臼
左臀部悪性軟部腫瘍	殿部悪性軟部腫瘍	う蝕第２度単純性歯髄炎
低血糖遷延	低血糖	腟良性腫瘍
右中大脳動脈閉塞症	中大脳動脈閉塞症	剥離外側半月
重症ＣＭＶ腸炎	サイトメガロウイルス腸炎	バベシア症
発熱コントロール	発熱	急性失血性貧血
右下腿蜂窩織炎	下腿蜂巣炎	水疱症
膿瘍形成	膿瘍	痘瘡性ざ瘡
右尿管損傷	尿管損傷	出血を伴う低置胎盤
感染性心内膜症	感染性心内膜炎	髄膜炎後遺症
ブドウ球菌検出	ぶどう球菌感染症	飛び降り自殺
副腎皮質機能不全	副腎皮質機能低下症	心臓弁膜症
Ｅｓｃｈｅｒｉｃｈｉａ　ｃｏｌｉ	大腸菌感染症	骨移植拒絶反応
両側網膜剥離	網膜剥離	青春期内閉神経症
播種性血管内凝固症	播種性血管内凝固	体表面積４０−４９％の腐蝕
肺野肺門部異常陰影	肺門部異常陰影	慢性漿液ムチン性中耳炎
右房浸潤	乳房悪性腫瘍	流産後無尿
屈筋腱鞘炎	腱鞘炎	気管支損傷・胸腔に達する開放創合併あり
肺結節陰影	胸部異常陰影	ヘモグロビン異常症
呼吸困難感等自覚症状	呼吸困難	胸部大動脈瘤破裂
原発性肺腫瘍	肺腫瘍	乾性胸膜炎
右下腿コンパートメント症候群	下腿コンパートメント症候群	クレスト症候群
右鎖骨上窩リンパ節腫大	鎖骨上リンパ節腫脹	鎖骨下動脈閉塞症
右鼡径部腫脹	鼡径部腫脹	尿管結石症
低悪性度リンパ腫	ホジキンリンパ腫	２型糖尿病・関節合併症あり
右側胸部皮下結節	皮下結節	前胸壁痛
両側卵巣チョコレート嚢胞	チョコレートのう胞	歯髄壊疽
回盲部悪性リンパ腫	悪性リンパ腫	新生児気胸
陰部腫脹	陰のう腫大	頬部腫瘤
腹水浸出	腹水症	胎児発育過度
ＴＡＡ	胸部大動脈瘤	足どり不安定
腸管皮膚瘻	腸瘻	大腿切断
ライン感染	カテーテル感染症	潜在性統合失調症
多発擦過傷	擦過創	髄膜炎菌性脊髄炎
脂質異常	脂質異常症	若年性パーキンソン病Ｙａｈｒ４
肺嚢胞感染	肺のう胞	アセトン血性嘔吐症
Ｃｈｕｒｇ−Ｓｔｒａｕｓｓ　症候群	好酸球性多発血管炎性肉芽腫症	上顎石灰化上皮性歯原性腫瘍
脾結核	結核	急性カタル性虫垂炎
潰瘍性大腸炎急性増悪	潰瘍性大腸炎	新生児一過性甲状腺機能低下症
肺抗酸菌感染症	肺非結核性抗酸菌症	先天性ミオパチー
２型大腸癌	大腸癌	大動脈狭窄症
両眼網膜症	網膜症	四肢小児湿疹
左眼結膜炎	結膜炎	褐色細胞腫
右肺原発腺癌	肺腺癌	早期先天皮膚梅毒
ＣＲＥＳＴ症候群	クレスト症候群	中指腱鞘巨細胞腫
感覚神経障害	知覚障害	単純性失神
物忘れ	健忘症	脊柱管内腫瘍
脳筋症	ミトコンドリア脳筋症	陰のう奇形
駆細胞型急性リンパ性白血病再発	急性リンパ性白血病	発音補整装置不適合
左大腿骨骨腫瘍	大腿骨腫瘍	慢性胃炎
膿瘍縮小	膿瘍	機能性蛋白尿
右後頭葉塞栓性脳梗塞	塞栓性脳梗塞	尿管閉塞
肝内転移	転移性肝腫瘍	小脳橋角部髄膜腫
膵管内乳頭粘液腫瘍	膵管内乳頭粘液性腫瘍	結膜結核
胃癌多発骨転移	胃癌骨転移	血腫
僧房弁疣贅	疣贅	漿液性虹彩炎
左膝窩動脈瘤	膝窩動脈瘤	大腿部骨化性筋炎
腹部背部痛	背部痛	食事性高脂血症
アルコール性ニューロパチー	アルコール性多発ニューロパチー	胸椎硬膜外血腫
体幹部発赤	発赤	黄斑障害
慢性突発性血小板減少性紫斑病	血小板減少性紫斑病	血栓性心内膜炎
下部消化管穿孔	腸穿孔	頚髄不全麻痺
Ｔ字杖歩行可能	歩行障害	遺伝性小脳性運動失調症
鎖骨上リンパ節腫大	鎖骨上リンパ節腫脹	鎖骨下動脈閉塞症
右大腿ヘルニア嵌頓	大腿ヘルニア嵌頓	閉塞性肥大型心筋症
大腫瘤影	腫瘤	褥瘡・ＤＴＩ
双極２型障害	２型双極性障害	卵巣周囲炎
感染性腹部動脈瘤	感染性腹部大動脈瘤	夏型過敏性肺炎
ヘルペス性脳炎	サル痘	先天性気管異常
不安症様	不安神経症	膝関節軟骨損傷
右前額部痛	前頭部痛	胃腸炎
右胸膜播種	胸膜播種	耳介創傷
骨折病変	骨折	正中神経麻痺
半月体形成糸球体腎炎	半月体形成性糸球体腎炎	クリオフィブリノゲン血症
筋力低下著明	筋力低下	可撤性保定装置不適合
下肢骨折	骨折	初期硬結
付属器圧痛	圧痛	脱水型低ナトリウム血症
アスピリンアレルギー	アスピリン不耐症	検診
固形腫瘍	腫瘍	強膜バックリング術後の機械的合併症
嘔吐出現	嘔吐症	腹部大動脈血栓症
統合失調症残遺状態	統合失調症	低酸素性脳症
右上肢不全片麻痺	不全片麻痺	亜急性細菌性心膜炎
低血糖生	低血糖	網膜中心静脈血栓症
劇症型肺炎球菌性敗血症	肺炎球菌性敗血症	胃腸管穿孔破裂・腹腔に達する開放創合併あり
左大腿蜂窩織炎	蜂窩織炎	ケトン尿症
発熱有	発熱	急性失血性貧血
頭位性回転性めま	体位性めまい	下葉無気肺
不眠考	不眠症	遊走性紅斑
全失語	全失語症	開放性腸間膜損傷
口唇紅潮	紅潮	先天性乳び胸
開腹腫瘤	腫瘤	産褥性乳汁分泌抑制
左尺骨神経障害	尺骨神経麻痺	ミラーフィッシャー症候群
外側部乳癌	乳癌	側頭部皮下血腫
脳幹部神経膠腫	脳幹神経膠腫	乾癬
両足関節以遠しびれ感	しびれ感	上行結腸粘膜下腫瘍
左再発性気胸	続発性気胸	腎機能検査異常
胃のむかつき	悪心	脊椎固定スクリューのゆるみ
気管性喘息	気管支喘息	乳房よう
痒疹結節散在	痒疹	上顎前突症
日中下痢	下痢症	片側感覚消失
骨粗鬆症有	骨粗鬆症	乳輪部第３度熱傷
先天性胆管欠損	胆管先天奇形	趾骨骨折
左深部静脈血栓症	深部静脈血栓症	肺炎桿菌肺炎
冠性Ｔ波	心電図異常	キャサヌール森林病
多発胸膜肥厚斑	胸膜肥厚	瓜実条虫症
カンジダ眼内炎	眼内炎	腎欠損症
副腎転移	転移性副腎腫瘍	頭部石灰化上皮腫
左緊張性気胸	緊張性気胸	Ｖ型外斜視
度腟壁裂傷	腟裂傷	爪かみ
仙骨部腫瘤	腫瘤	総腸骨動脈損傷
帯状疱疹再燃	帯状疱疹	情動精神病
左前胸部腫瘤	前胸部腫瘤	気管支結石症
喘息症状	咳喘息	網脈絡膜萎縮
ふらつく気	よろめき歩行	先天性卵巣奇形
拡張障害型心不全	心不全	新生児一過性心筋虚血
アカシジア症状	錐体路障害	炎症性アテローム
間歇的腹痛	腹痛症	十二指腸腫瘍
左肺舌区扁平上皮癌	肺扁平上皮癌	日本紅斑熱
星状細胞腫	星細胞腫	中咽頭乳頭腫
急性腎障害	腎障害	耳下腺腫瘍
左鎖骨上リンパ節腫脹	鎖骨上リンパ節腫脹	鎖骨下動脈閉塞症
陳旧性脳出血	脳出血	腰椎捻挫
良性下垂体腫瘍	下垂体腫瘍	肺機能検査異常
腸雑音聴取可	異常腸音	梅毒感染母体より出生した児
左側頭部帯状疱疹	帯状疱疹	アブサンス
左肺原発性肺癌	原発性肺癌	早期先天皮膚梅毒
頭蓋内出血性病変	非外傷性頭蓋内出血	代償性水頭症
閉塞性睡眠呼吸障害	睡眠時無呼吸症候群	眼球損傷
右披裂部腫瘍	腫瘍	陰茎海綿状血管腫
両膝変形	変形性膝関節症	心臓腫瘍
表在性腫瘍	腫瘍	不全中隔子宮
左母指多指症	副母趾	膀胱頚部閉鎖
両側側脳室軽度拡大	脳室拡大	術後骨弁感染
脈性右室心筋症	不整脈原性右室心筋症	機能的顎矯正装置不適合
アルコール性末梢神経障害	アルコール性多発ニューロパチー	閉鎖孔ヘルニア
縦隔炎併発	縦隔炎	穿通創
暗紅色斑	紅斑症	膀胱頚部ポリープ
骨盤圧痛	骨盤痛	腰部血管腫
骨巨細胞腫瘍	骨巨細胞腫	不正性器出血
Ｌａｎｇｈａｎｓ巨細胞	ランゲルハンス細胞組織球症	頚椎神経挫滅
気管支喘息発症	気管支喘息	乳房よう
分葉状嚢胞性腫瘤	腫瘤	間質性心筋炎
胆管拡張	胆管拡張症	ゴム腫
甲状腺肥大	甲状腺疾患	先天性直腸瘻
患肢発赤	発赤	黄斑障害
好中球浸潤	好中球増加症	脳脊髄梅毒
多房性腫瘤	腫瘤	頚部原発腫瘍
夜間不安	不安障害	ざんごう熱
右上肢線状強皮症	線状強皮症	頚部リンパ節腫瘍
左内耳障害	迷路障害	アルコール性残遺性感情障害
左耳介発赤	発赤	手背皮膚癌
朝方倦怠感	倦怠感	全部性歯髄炎
後頚部脂肪腫	頚部脂肪腫	脛骨血管損傷
副腎性クッシング症侯群	クッシング症候群	皮膚コクシジオイデス症
混合性アルカローシス	アルカローシス	大腸嵌頓
痛く	疼痛	過酸症
皮疹再燃	発疹	大腸憩室出血
再発悪性リンパ腫	悪性リンパ腫	２型糖尿病・関節合併症あり
子宮筋腫手術	子宮筋腫	周辺部脈絡膜炎
時折心窩部痛	心窩部痛	癒着胎盤・出血を伴わない
右足根骨骨折	足根骨骨折	新生児副腎出血
腕頭静脈血栓症	静脈血栓症	耳下腺肥大
脊椎病変	脊椎異常	潜在性脊椎披裂
歯状核	歯状核赤核淡蒼球ルイ体萎縮症	小細胞肺癌
右脛骨骨幹部骨折	脛骨骨幹部骨折	一側性顎関節突起形成不全
両側腎盂軽度拡張	腎盂拡張	第２色弱
軽度屈曲拘縮	屈曲拘縮	高音障害型難聴
左下肺野陰影	下肺野陰影	ＩＣＵ症候群
ＥＢＶ腸炎	細菌性腸炎	バベシア症
左側舌癌	舌癌	尺骨神経炎
足しびれ	下肢しびれ	閉鎖性膀胱損傷
膵内分泌腫瘍肝転移	転移性肝癌	中指挫創