出現形	正解	予測
副腎原発神経芽腫	副腎神経芽腫	転移性膵腫瘍
Ｗｅｎｃｋｅｂａｃｈ型房室ブロック	ウェンケバッハ型第２度房室ブロック	しびれ感
痰貯留多	喀痰	舌癌
皮膚リンパ腫	菌状息肉症	ＭＲＳＡ腸炎
個細胞壊死	壊死	下肺野陰影
左大腿骨顆上骨折	大腿骨外顆骨折	屈曲拘縮
病原性大腸菌Ｏ−１５７感染性腸炎	病原性大腸菌感染症	腎盂拡張
口腔粘膜浮腫	浮腫	脛骨骨幹部骨折
腟粘膜発赤	発赤	殻状歯
レム睡眠行動異常症	レム睡眠行動障害	脊椎疾患
閉塞性膵炎	膵炎	上腕静脈血栓症
脱髄性疾患	脱髄疾患	足根骨骨折
多発性脾膿瘍	脾膿瘍	心窩部痛
間質性肺水腫	肺水腫	子宮筋腫術後
無動性無言	無動性無言症	悪性リンパ腫
舌扁平上皮癌	舌癌	反応性発疹症
両側肺門部浸潤影	胸部異常陰影	全身痛
軽度悪心	悪心	アルカローシス
慢性活動性ＥＢウルス感染症	ＥＢウイルス感染症	副腎性器症候群
蛋白尿減少	蛋白尿	頚部脂肪腫
脳障害	脳症	倦怠感
中心性奬液性網脈絡膜症	中心性漿液性網脈絡膜症	咽頭発赤
左一側性反回神経麻痺	一側性反回神経麻痺	心耳相同
イレウス様	イレウス	線状強皮症
膵炎併発	膵炎	不安緊張状態
ｈｅｍｏｐｈａｇｏｃｙｔｉｃ　ｓｙｎｄｒｏｍｅ	血球貪食症候群	乳房腫瘤
抗癌剤漏出	薬剤漏出性皮膚障害	好中球Ｇ６ＰＤ欠乏症
水痘帯状疱疹	帯状疱疹	発赤
ｓｙｓｔｅｍｉｃ　ｍａｓｔｏｃｙｔｏｓｉｓ	肥満細胞腫症	甲状腺欠損
発汗多量	多汗症	胆管拡張症
早発黄疸	早発性黄疸	精巣上体腫瘤
急性細菌性気管支炎	急性気管支炎	気管支喘息発作
右上葉肺小細胞癌	上葉肺大細胞癌	Ｉ細胞病
腟癌１期	腟癌	骨巨細胞腫
会陰部発赤	発赤	骨盤痛
嚥下時痛軽度	嚥下痛	環状紅斑
左顔面血管腫	顔面血管腫	縦隔炎
鼻汁多く	鼻汁	アルコール性神経筋障害
口腔内出血痕	口腔出血	不整脈原性右室心筋症
ＳＩＡＤ	抗利尿ホルモン不適合分泌症候群	脳室拡大
夜両足痛	足痛	多指症
左後頭葉梗塞	脳梗塞	良性腫瘍
左内眼角基底細胞癌	眼角基底細胞癌	足部変形
難治性イレウス	イレウス	腫瘍
副鼻腔腫瘍	鼻副鼻腔腫瘍	閉塞性睡眠時無呼吸
大腸菌菌血症	菌血症	外傷性頭蓋内出血
右前頭葉出血	脳出血	原発性肺癌
左膝部痛	膝窩部痛	後頭部帯状疱疹
仙椎陳旧性骨折	陳旧性骨折	異常腸音
乳癌既往	乳癌	下垂体良性腫瘍
軽度咽頭発赤	咽頭発赤	脳出血
痙攣起	痙攣	鎖骨上リンパ節腫脹
下肢浮腫圧痕	下肢浮腫	腎障害
左側頬部腫脹	頬部腫脹	星状芽細胞腫
心室中隔穿孔	心室中隔欠損症	肺扁平上皮癌
四肢浮腫軽度	四肢浮腫	周期性腹痛
大腸ポリープ　ポリペク後	大腸ポリープ	ノカルジア症
腰椎椎体椎間板炎	腰椎椎間板炎	急性心不全
左下葉肺炎悪化	大葉性肺炎	気うつ
ぼんやり感持続	反応性低下	夜間性喘息
右鼠径部痛	鼡径部痛	前胸部腫瘤
皮疹不変	発疹	汎発性帯状疱疹
創部痛	術創部痛	骨腫瘤
軽度右気胸	気胸	高位腟裂傷
腸閉塞歴	イレウス	緊張性気胸
左大腿骨骨折	大腿骨骨折	転移性副腎腫瘍
紅斑局面多発	紅斑症	カンジダ性口内炎
下部進行食道癌	食道癌	胸膜肥厚
無γグロブリン血症	無ガンマグロブリン血症	ＲＡＥＢ−ｔ
子宮頸管ポリープ切除	子宮頚管ポリープ	深部静脈血栓症
手首疼痛	疼痛	先天性胆のう欠損
ｓｐｌｅｎｉｃ　ｍａｒｇｉｎａｌ　ｚｏｎｅ　ｌｙｍｐｈｏｍａ	脾辺縁帯リンパ腫	骨粗鬆症
体動時息ぎれ	労作時呼吸困難	下痢症
一部浮腫	浮腫	結節性痒疹
ふらつき注意	よろめき歩行	気管支喘息
左中耳炎	中耳炎	胃瘻開口部に対する手当て
胃食道逆流症状	胃食道逆流症	特発性気胸
両側卵巣子宮内膜症性嚢胞	卵巣子宮内膜症のう胞	足関節強直
新出肝転移	転移性肝癌	脳幹神経膠腫
脊椎カリエス	脊椎結核	乳房上外側部乳癌
行動障害	素行障害	尺骨神経麻痺
妊娠性糖尿病	妊娠糖尿病	腹部腫瘤
小豆大紅斑	紅斑症	顔面紅潮
ＦＳＧＳ	巣状糸球体硬化症	全失語症
左寛骨臼骨折	寛骨臼骨折	不眠症
原発性両眼内悪性リンパ腫	眼窩悪性リンパ腫	頭位変換性めまい
腹腔鏡補助下子宮筋腫核	子宮筋腫	発熱
両下肢静脈血栓	下肢静脈血栓症	大腿部蜂巣炎
神経根障害	神経根炎	肺炎球菌性敗血症
クモ膜下出血	くも膜下出血	低血糖
後鼻汁症候群	後鼻漏	上肢不全麻痺
糖尿病性腎症１期	腎性糖尿	残遺型統合失調症
左臀部慢性膿皮症	慢性膿皮症	嘔吐症
メサンギウム増殖性腎炎	メサンギウム増殖性糸球体腎炎	葉状腫瘍
左前頭葉心原性脳梗塞	心原性脳塞栓症	アレルギー
閉塞性尿路感染	尿路感染症	圧痛
顔面蝶形紅斑	ＬＥ蝶形皮疹	上肢骨折
上行結腸癌肝転移	転移性肝癌	筋力低下
仙骨部色素沈着	色素異常症	半月体形成性糸球体腎炎
肥満糖尿病	糖尿病	病的骨折
左肩痛み	肩部筋痛	胸膜播種
ＰＳＶＴ発作	発作性上室頻拍	前胸部痛
顎変形症術後顎変形症	顎変形症	不安障害
ＤＭＮ　２期	糖尿病	ヘルペス脳炎
労作時胸部絞扼感	胸内苦悶	感染性腹部大動脈瘤
右膝変形	変形性膝関節症	２型双極性障害
指趾潰瘍	趾皮膚潰瘍	眼窩腫瘤
２型食道癌	食道癌	大腿ヘルニア嵌頓
骨性腫瘤	腫瘤	鎖骨上リンパ節腫脹
外傷性脊髄損傷	脊髄損傷	歩行困難
下肢結節性紅斑	結節性紅斑	根管側壁穿孔
左動眼神経麻痺	動眼神経麻痺	慢性特発性血小板減少性紫斑病
家族性海綿状血管腫	海綿状血管腫	発赤
術中直腸損傷	直腸損傷	アルコール性多発ニューロパチー
下肢動脈瘤	下肢の動脈瘤	背部痛
精神病様症状	精神病	膝窩動脈瘤
項頸部痛	頚部痛	尋常性疣贅
頸部白斑	白斑	胃癌骨転移
左大腿骨転子部粉砕骨折	転子下骨折	膵管内乳頭粘液性腫瘍
最近眠気	非器質性過眠症	転移性肝腫瘍
ＶＨＤ	心臓弁膜症	塞栓性小脳梗塞
夜頻尿	夜間頻尿症	膿瘍
回盲部炎	回盲部憩室炎	大腿骨近位部骨腫瘍
重症肺血栓塞栓症	肺塞栓症	急性リンパ性白血病
左歯痛	歯痛	脳症
腹膜播種切除	腹膜播種	健忘症
右乳突蜂巣	乳様突起炎	知覚障害
右肺尖部気胸	気胸	ＶＡＴＥＲ症候群
骨盤内子宮内膜症	子宮内膜症	原発性肺癌
左頬部痛	頬部痛	眼瞼結膜炎
局麻薬アレルギー	薬物過敏症	近視性網膜症
肺クリプトコックス症	急性肺クリプトコッカス症	大腸癌
右肩関節亜脱臼半横指	肩関節亜脱臼	多剤耐性腸球菌感染症
慢性蕁麻疹	慢性じんま疹	急性潰瘍性大腸炎
マラセチア毛嚢炎	マラセチア毛包炎	腎結核
高分化型漿液性腺癌	癌	Ｅｕｔｈｙｒｏｉｄ　Ｓｉｃｋ症候群
腫瘍床	腫瘍	Ｂ群溶連菌感染症
左膀胱尿管逆流症	膀胱尿管逆流	脂質異常症
外側疼痛	疼痛	多発性擦過創
卵巣癌再発卵巣癌	卵巣癌	ＨＩＶ感染
錐体路病変	錐体外路系疾患	直腸皮膚瘻
リンパ球性白血病	リンパ性白血病	ＣＡＤＡＳＩＬ
クラミジア感染	クラミジア感染症	濾出性腹水
奬液性嚢胞腺腫	膵漿液性のう胞腺腫	胸部腫脹
夜間倦怠感	倦怠感	悪性リンパ腫
脳血栓塞栓症	脳血管閉塞性脳梗塞	チョコレートのう胞
左リウマチ性肘関節症	関節リウマチ・膝関節	皮下結節
右下腿潰瘍感染	下腿皮膚潰瘍	悪性リンパ腫
気分不快時	悪心	鼡径部腫脹
問題なし前立腺肥大	前立腺肥大症	鎖骨上リンパ節腫脹
急性パルボウイルスＢ１９感染症	パルボウイルス感染症	下腿コンパートメント症候群
脂肪性腫瘤	脂肪腫	肺良性腫瘍
ウィルス性肺炎	肺炎	呼吸困難
類円形紅斑	紅斑症	胸部異常陰影
書字不能	書痙	手屈筋腱腱鞘炎
肺動脈狭窄	肺動脈狭窄症	移植性前房のう胞
夜間不眠状態	不眠症	肺門部異常陰影
熱型	発熱	播種性血管内凝固
骨盤内充実性腫瘍	骨盤腫瘍	網膜剥離
夢遊病	夢遊症	ＣＡＲＡＳＩＬ
脊髄小脳変性症６型	脊髄小脳変性症	副腎皮質機能低下症
左内頚動脈閉塞	内頚動脈閉塞症	Ｂ群溶連菌保菌者
両側角乾燥性結膜炎	結膜炎	感染性心内膜炎
脳虚血症状	脳虚血症	尿管損傷
微熱持続	微熱	水晶体膿瘍
夕方浮腫	浮腫	下腿蜂巣炎
眼性疲労	眼精疲労	発熱
直腸肛門奇形	鎖肛	ＭＲＳＡ腸炎
右大腿部腫瘍	大腿悪性軟部腫瘍	中大脳動脈閉塞症
頚椎症神経根症	頚椎症性神経根症	低血糖
壊死性遊走性紅斑	遊走性紅斑	殿部悪性軟部腫瘍
睡眠障害招くリスク	睡眠障害	尿失禁症
上大静脈血栓	静脈血栓症	リンパ節腫大
骨盤内ＬＮ転移	骨盤内リンパ節転移	心窩部痛
ＰＫＤ	多発性のう胞腎	下行結腸腫瘍
分水嶺脳梗塞	脳梗塞	側胸部痛
上皮性腫瘍	腫瘤	持続痛
大球性正色素貧血	大球性貧血	偽緑内障
挙上空腸穿孔	腸穿孔	鎖骨上転移性腫瘍
腸管アメーバ感染症	腸アメーバ症	膝関節痛
放射線性皮膚炎	放射線皮膚炎	肺腫瘤
肛門周囲びらん	外痔びらん	胆汁うっ滞
髄膜炎徴候	髄膜炎	前立腺癌再発
胸部不快	胸内苦悶	ＨＣＡＨＣ
下葉肺炎	肺炎	膿性痰
右足根部粉砕骨折	粉砕骨折	慢性疲労症候群
蛋白漏出胃腸症	蛋白漏出性胃腸症	血性腹水
左大脳陳旧性ラクナ梗塞	陳旧性ラクナ梗塞	大腿部蜂巣炎
出血多量	急性大量出血	ＧＢＳ敗血症
腹水多量	腹水症	異物誤嚥
腸間膜リンパ管腫	リンパ管腫	腫瘤
右卵巣悪性腫瘍	卵巣悪性腫瘍	臍部腫瘤
糖尿病（２型）	２型糖尿病	膵炎
化膿性胸鎖関節炎	化膿性関節炎・胸鎖関節	中葉症候群
右乳腺線維腫症	線維腫	下肺野陰影
肺野鬱血像	肺野異常陰影	うつ病
児嘔気	嘔気	左心房粘液腫
尿閉歴	尿閉	中葉肺扁平上皮癌
陰嚢びらん	陰のうびらん	術後顔面神経麻痺
精神的ショック	ショック	心音図異常
右上腕骨外側上顆炎	外側上顆炎	頚部脊柱管狭窄症
子宮頚上皮内癌	子宮頚部上皮内癌	ＨＤＬＳ
難治性非定型性抗酸菌症	非結核性抗酸菌症	甲状腺未分化癌
軽度腹水	腹水症	記憶錯誤
湿疹様	湿疹	肝門部リンパ節転移
大後頭孔狭窄	軟骨形成不全症	社会不安障害
熱型変化	発熱	小脳出血
右無機能腎	無機能腎	仙骨腫瘍
月経痛コントロール不十分	月経痛	胸部大動脈損傷
左鎖骨下動脈閉塞	鎖骨下動脈閉塞症	大腸粘液癌
右ＤＶＴ	深部静脈血栓症	ヘルペス角膜炎
非特異的胸痛	胸痛	テント上下転移性腫瘍
Ａｅｒｏｍｏｎａｓ　ｈｙｄｒｏｐｈｉｌａ敗血症	敗血症	ＨＤＬＳ
重症細菌性敗血症	敗血症	脊髄硬膜外膿瘍
逆行性健忘	逆向性健忘	胸椎多発圧迫骨折
腹直筋膜下血腫	筋肉内血腫	落ち込み
関連腎臓病	腎疾患	隅角癒着
認知症様症状	認知症	小脳出血
顎骨骨折	下顎骨骨折	胃癌末期
高度大動脈弁狭窄	大動脈弁狭窄症	大量便
右顔面骨骨折	顔面骨骨折	両側性感音難聴
炎症性粉瘤	粉瘤	卒倒
左腰部疼痛	腰痛症	腸壊死
ＨＣＶ重複感染症	Ｃ型肝炎ウイルス感染	内頚動脈狭窄症
脂質異常症（＋）	脂質異常症	四肢端しびれ
上腹部圧痛	腹部圧痛	耳痛症
両側椎骨動脈瘤	椎骨動脈瘤	胸膜播種
非ケトン性高血糖	高血糖高浸透圧症候群	喀痰喀出困難
Ｙｅｒｓｉｎｉａ腸炎	エルシニア腸炎	棘刺創
声帯浮腫	声帯炎	転移性肝癌
誤嚥性肺炎併発	誤嚥性肺炎	大腿骨病的骨折
咳嗽持続	咳	肝腫瘤
左側下顎骨嚢胞	顎骨のう胞	ＭＲＳＡ感染症
右末梢前庭障害	末梢前庭障害	反復性胸痛
胆管閉鎖症	胆管閉塞症	拘束性換気障害
閉塞性動脈硬化症　症状	閉塞性動脈硬化症	分類不能免疫不全症
洞不全	洞不全症候群	下葉肺扁平上皮癌
特発性リンパ浮腫	リンパ浮腫	イレウス
シャント吻合部狭窄	透析シャント狭窄	ＣＡＤＡＳＩＬ
無気力	無力症	リンパ節転移
胸骨炎	胸骨周囲炎	肺塞栓症
ナッツアレルギー	ピーナッツアレルギー	両側性感音難聴
甲状腺乳頭癌術後再発	甲状腺乳頭癌	血腫
上肢疼痛	疼痛	気うつ
Ｔｕｒｎｅｒ症候群	ターナー症候群	ヘルペスウイルス感染症
肝臓機能障害用	肝機能障害	巨大子宮筋腫
左心不全徴候	心不全	Ｃ型非代償性肝硬変
ＩＰＭＮ癌化	膵管内乳頭粘液性腺癌	逆流性食道炎
後発頚部転移	頚部転移性腫瘍	労作時呼吸困難
下痢治	下痢症	そう痒
朝方疼痛	疼痛	ウイルス性脳炎
蜂窩肺形成	蜂窩織炎	眼振
右ＩＣＡ高度狭窄	内頚動脈狭窄症	慢性血栓塞栓性肺高血圧症
膵体部嚢胞	膵のう胞	足背骨折
右気管支狭窄	気管支狭窄症	ＨＤＬＳ
非ヘルペス性辺縁系脳炎	辺縁系脳炎	血腫
無症候性ＶＴ	心室頻拍	感冒
好酸球増多	好酸球増加症	卵巣奇形腫
口腔清掃	個人衛生の著しいレベル低下	食道小細胞癌
両下腿皮膚潰瘍	下腿皮膚潰瘍	膿性痰
無石性胆嚢炎	胆のう炎	足関節開放性脱臼骨折
ｓ型ポリープ	ポリープ	急性肺炎
時折頭痛	頭痛	もやもや病
関節リウマチ発症	関節リウマチ	膝関節症
残像腫瘍	腫瘍	妊娠
両顎下腺腫大	顎下腺肥大	外腸骨動脈狭窄
夜間中途覚醒時	睡眠障害	食道障害
今朝頭痛	頭痛	細菌性腸炎
眼球偏移	眼球偏位	前庭障害
腹腔内癒着高度	腹膜癒着	股関節損傷
右母指多指症	多指症	ヘルペスウイルス髄膜炎
薬剤性骨髄抑制	骨髄機能低下	脊柱管狭窄症
肥満	肥満症	口腔乾燥症
網膜中心動脈閉塞	網膜中心動脈閉塞症	口呼吸
中枢神経悪性リンパ腫再発	悪性リンパ腫	子宮頚管狭窄症
旅行者下痢症	下痢症	ＭＲＣＮＳ感染症
右声帯ポリープ	声帯ポリープ	膀胱側壁部膀胱癌
非Ｂ非Ｃ型肝硬変	肝硬変症	浮腫
頭部皮下結節	皮下結節	熱性痙攣
足がむくみ	下肢浮腫	陰のう浮腫
下肢潰瘍	下肢皮膚潰瘍	下肢静脈瘤
難治性胸腹水	難治性腹水	上肢筋力低下
幻覚症状	幻覚	尿溢出
異常腫瘤	腫瘤	胸膜腫瘍
未破裂脳動脈瘤コイル塞栓	未破裂脳動脈瘤	Ｅｕｔｈｙｒｏｉｄ　Ｓｉｃｋ症候群
左下顎骨慢性骨髄炎	慢性顎骨骨髄炎	複視
左側頭葉膠芽腫	側頭葉膠芽腫	増殖性網膜症
脳血管障害性パーキンソニズム	脳血管障害性パーキンソン症候群	純型肺動脈閉鎖
右後角脳室内出血	脳室内出血	二次性甲状腺機能低下症
難治性浮腫	高度浮腫	一側上肢振戦
Ｇｒａｎｕｌｏｍａｔｏｓｉｓ　ｗｉｔｈ　ｐｏｌｙａｎｇｉｉｔｉｓ	多発血管炎性肉芽腫症	胃静脈瘤破裂
再発脊索腫	脊索腫	器質性緊張病性障害
Ｃ型肝硬変症	Ｃ型肝硬変	胃幽門部癌
左踵部悪性黒色腫	踵部悪性黒色腫	踵骨骨折
未分化癌	癌	脊髄硬膜外膿瘍
両側副腎悪性リンパ腫	悪性リンパ腫	Ｅｕｔｈｙｒｏｉｄ　Ｓｉｃｋ症候群
帯状疱疹無	帯状疱疹	頬部有棘細胞癌
左膝痛み	膝関節痛	皮膚腫瘍
右下腿痛	下腿痛	高脂血症
気管支喘息症状	気管支喘息	心室細動
大腿骨内顆骨壊死	特発性大腿骨内顆骨壊死	非特異的ＳＴ−Ｔ変化
炎症性貧血	貧血	副甲状腺腺腫
両下肢掻痒感	皮膚そう痒症	視神経脊髄炎
右後頭葉脳挫傷	脳挫傷	ＡＬＫ陽性大細胞型Ｂ細胞性リンパ腫
女性化乳房	女性化乳房症	骨腫瘤
ｍａｓｓ　ｌｅｓｉｏｎ	腫瘤	子宮体癌
右大脳半球多発脳梗塞	多発性脳梗塞	喀痰
大動脈弁膜症	大動脈弁弁膜症	急性肺炎
鎮静困難	興奮状態	特発性発疹
再発腫瘤近傍	腫瘤	頭部皮下腫瘍
右下腿麻痺	下肢麻痺	咽頭発赤
切除不能多発性肝転移	転移性肝腫瘍	ポリープ
腹腔内膿瘍形成	膿瘍	急性膵炎
発作性上室性頻拍	発作性上室頻拍	奇形
筋肉痛生	筋肉痛	ＥＢウイルス感染症
腰椎滑り症	腰椎すべり症	多発性腎結石
淡血性胸水	血性胸水	下葉肺癌
腎被膜下出血	外傷性腎被膜下血腫	頬部擦過創
仙骨部褥瘡痕	仙骨部褥瘡	クリオグロブリン血症性血管炎
左肝腫瘍	肝腫瘍	尿管回腸導管吻合部狭窄
非Ｃｌｏｓｔｒｉｄｉｕｍ性ガス壊疽	ガス壊疽	花粉症
リンパ腺腫脹	リンパ節腫大	新生児仮死
心室二段脈	心室性二段脈	多部位リンパ節転移
鼻腔腫瘍摘出	鼻腔腫瘍	不整脈
疼痛時頓用	疼痛	咽頭発赤
多房性膿瘍	膿瘍	疼痛
右耳介後部痛	耳痛症	アミロイドーシス
左胸壁腫瘍切除	胸壁腫瘍	気管閉鎖症
無呼吸症候群	無呼吸発作	皮膚腫瘤
右尿管癌	尿管癌	多発性肝血管腫
出血過多	出血	縫合不全
甲状腺嚢腫	甲状腺のう胞	よろめき歩行
両側浸出性中耳炎	滲出性中耳炎	足湿疹
覚醒度	麻酔覚醒遅延	悪性膵内分泌腫瘍
高血糖	高血糖症	大葉性肺炎
有意弁膜症	弁膜炎	新生児低酸素性虚血性脳症
胸痛無	胸痛	肺炎
右下肺野無気肺	無気肺	呼吸困難
小脳性失調	小脳性運動失調症	血液凝固異常
好酸球増多症	好酸球増加症	クラミジア感染症
右腎明細胞肉腫	腎明細胞肉腫	下腿発赤
甲状腺左葉濾胞腺腫	濾胞性甲状腺腺腫	嘔気
下位運動ニューロン徴候	運動ニューロン疾患	ＨＤＬＳ
主幹動脈狭窄	脳動脈狭窄症	足関節腫脹
創部皮下血腫	外傷性皮下血腫	起立性眩暈
掻痒感軽減	そう痒	くしゃみ
両肺小結節影	肺野異常陰影	恥骨骨炎
造影剤アレルギー歴	薬物過敏症	冠攣縮性狭心症
左眼鼻涙管閉塞症	鼻涙管閉鎖症	潰瘍性慢性膿皮症
慢性的な抑うつ気分	うつ状態	尿管結石症
鼻部異物肉芽腫	皮膚異物肉芽腫	神経性食欲異常
遠隔ＬＮ転移	リンパ節転移	異所性ＡＣＴＨ産生腫瘍
子宮がん	子宮癌	レム睡眠行動障害
Ｂｉｃｋｅｒｓｔａｆｆ型脳幹脳炎	ビッカースタッフ脳幹脳炎	熱傷
睾丸腫脹	精巣腫脹	横隔膜弛緩症
右中皮腫	中皮腫	穿通性十二指腸潰瘍
ジベル薔薇色粃糠疹	ジベルばら色粃糠疹	先天性下大静脈狭窄症
脳実質外腫瘍	腫瘍	全膿胸
抑鬱感	気うつ	人工膝関節感染
扁桃腺腫大	扁桃肥大	ノカルジア症
口内出血	口腔出血	軽度認知障害
右上方視野欠損	視野欠損	門脈圧亢進症
両側臼蓋形成不全症	臼蓋形成不全	進行性前立腺癌
進行肝癌	肝癌	慢性咳嗽
噴門部狭窄	胃狭窄	下葉肺扁平上皮癌
突発性腎出血	腎出血	大腸ポリープ
前股関節症	股関節症	術後創部感染
多発肝嚢胞	多発性肝のう胞	嚥下痛
過換気状態	過換気症	肺動脈瘻
傍大動脈ＬＮ	大動脈周囲リンパ節転移	ＨＤＬＳ
左椎骨動脈低形成	骨髄低形成	腎障害
左房拡張	心拡大	放線菌症
サルモネラ菌感染症	サルモネラ感染症	肺門部異常陰影
両側性多発性嚢胞腎	多発性のう胞腎	子宮肉腫
化学物質アレルギー	アレルギー	ペースメーカ植え込み後感染症
右手指腫脹	手指腫脹	卵巣門細胞腫
右足背発赤	発赤	鼡径部横紋筋肉腫
脊柱管高度狭窄	脊柱管狭窄症	粘液性鼻漏
右急性網膜壊死	急性網膜壊死	急性疼痛
皮膚硬化がまだかなり	新生児皮膚硬化症	顎痛
口腔内乾燥軽度	口腔乾燥症	顔面神経障害
下肢筋痛	下肢筋肉痛	中枢性顔面神経麻痺
蠕動不良	異常腸音	副腎腫瘍
四肢腱反射亢進	反射亢進	子宮体癌
黒色丘疹	丘疹	幻聴
胸部陰影	胸部異常陰影	失認
クモ膜下嚢胞	くも膜のう胞	腎血管腫
２次性糖尿病	二次性糖尿病	症候性てんかん
Ｈａｅｍｏｐｈｉｌｕｓ　ｉｎｆｌｕｅｎｚａｅ敗血症	敗血症	頚部食道癌
慢性期疼痛	慢性疼痛	手関節痛
右上葉原発肺小細胞癌	小細胞肺癌	慢性腸アメーバ症
出血源不詳	出血	ＡＩＤＳ
一般細菌感染	細菌感染症	心肺停止
急性小脳失調症	急性小脳性失調症	下腿皮膚潰瘍
浸潤癌化所見	癌	喀痰
痔核脱出	痔核	腎盂腫瘍
重症膵炎	膵炎	下気道感染を伴う慢性閉塞性肺疾患
痛みアリ	疼痛	層間白内障
左心室内血栓症	心室内血栓症	房室ブロック
右足疼痛	疼痛	睡眠時頭痛
増殖前網膜症	網膜症	冠攣縮性狭心症
傍神経節腫瘍	傍神経節腫	頚部腫瘤
小腸膀胱瘻	膀胱皮膚瘻	術後房室ブロック
左小細胞肺癌	小細胞肺癌	下肢痛
少量左胸水	胸水貯留	感染後咳嗽
多発ＨＣＣ再発	肝細胞癌	錐体路障害
結核性嚢腫	結核	多発性皮下腫瘤
右大腿骨外顆骨折	大腿骨外顆骨折	発熱
巨大膵仮性嚢胞	仮性膵のう胞	多発性癌転移
大腿腫脹	下腿腫脹	転移性副鼻腔癌
全身性ＣＭＶ感染症	サイトメガロウイルス感染症	出血
多発肝内転移	転移性肝腫瘍	緑膿菌性腸炎
右外耳道炎	外耳炎	音声障害
両下肢圧痕性浮腫	クインケ浮腫	ＭＥＬＡＳ症候群
下部腸間膜動脈出血	動脈性出血	微熱
ＩｇＭ型Ｍ蛋白	単クローン性免疫グロブリン血症	内分泌機能異常
喘息発作様症状	気管支喘息発作	気胸
分食道癌	食道癌	ＣＨＩＬＤ症候群
多少便秘気味	便秘症	サイトメガロウイルス網膜炎
ポリープ状病変	ポリープ	努力性呼吸
既往高血圧	高血圧症	大腿骨頭壊死
右リウマチ性膝関節症	関節リウマチ・膝関節	呼吸促迫
急性骨髄性白血病（ＡＭＬ）	急性骨髄性白血病	多発性筋炎
腹水大量	腹水症	大動脈弁閉鎖症
全身皮膚発赤	発赤	ＨＣＡＨＣ
多発肺嚢胞	肺のう胞	失語症
右小脳橋角部腫瘍	小脳橋角部腫瘍	Ｅｕｔｈｙｒｏｉｄ　Ｓｉｃｋ症候群
右眼網膜静脈分枝閉塞症	網膜静脈分枝閉塞症	群発頭痛
右脛骨腓骨開放骨折	脛骨腓骨開放骨折	全失語症
左側卵巣腫瘍	卵巣腫瘍	未破裂脳動脈瘤
口腔内びらん	口唇びらん	下肺野陰影
紅斑熱群リケッチア症	リケッチア感染症	扁桃潰瘍
ＩＴＰ	特発性血小板減少性紫斑病	低血糖
気管支喘息小発作	気管支喘息発作	卵巣小細胞癌
解離性動脈瘤破裂	解離性動脈瘤	機能性構音障害
左眼窩内腫瘍	眼窩腫瘍	尿失禁症
肺外小細胞癌	小細胞肺癌	顔面痙攣
高度大動脈弁狭窄症	大動脈弁狭窄症	脳室内出血
ｂｒｅａｋｔｈｒｏｕｇｈ　ｈｅｐａｔｉｔｉｓ	肝炎	歩行困難
左室圧排	右室肥大	末梢動脈塞栓症
両側声帯外転障害	声帯外転筋麻痺	Ｂ群溶連菌感染症
一部水疱形成	水疱症	急性疼痛
糖尿病潰瘍	糖尿病性潰瘍	家族性ＬＣＡＴ欠損症
飲みこみにくさ	嚥下障害	縦隔リンパ節転移
左腎低形成	低形成腎	爪囲炎
左母趾疼痛	母趾痛	せん妄
副腎ヒストプラズマ感染症	真菌症	易疲労感
右眼糖尿病網膜症	糖尿病網膜症	辺縁系脳炎
下肢浮腫左	下肢浮腫	脳炎
両松葉杖歩行	歩行障害	上腕骨近位端骨折
冠動脈狭窄３枝病変	狭心症３枝病変	下肢静脈血栓症
遺伝性低尿酸血症	低尿酸血症	肺動脈血栓塞栓症
低アルドステロン血症	低アルドステロン症	心因性発熱
小腸皮膚瘻	皮膚瘻	皮膚壊死
重度僧帽弁狭窄症	僧帽弁狭窄症	アルコール性肝硬変
非細菌性血栓性疣贅	疣贅	尋常性疣贅
特発性腸間膜血腫	血腫	肺膿瘍
脳原発性悪性リンパ腫	脳悪性リンパ腫	顔面痛
抜管後両側反回神経麻痺	両側性反回神経麻痺	ＭＲＣＮＳ感染症
肝骨転移	骨転移癌	排便障害
乳腺線維腫症	線維腫	結膜浮腫
術後左反回神経麻痺	反回神経麻痺	インフルエンザ
無症候性髄膜腫	髄膜腫	活動性慢性肝炎
左肺下葉肺癌	下葉肺癌	顔面形成異常
アルコール離脱症候群	アルコール離脱状態	大動脈瘤
左腸骨骨肉腫	腸骨軟骨肉腫	アレルギー
脳梁低形成	脳梁形成不全	原発性甲状腺機能低下症
表皮内水疱形成	先天性表皮水疱症	急性大動脈解離ＤｅＢａｋｅｙＩＩＩｂ
後頚部圧痛	圧痛	頬部皮膚良性腫瘍
不定愁訴様	不定愁訴症	前立腺小細胞癌
良性胆道狭窄	胆管狭窄症	カンジダ性口内炎
左下葉非小細胞肺癌	下葉非小細胞肺癌	不安障害
ＣＫＤ　腎硬化症	腎硬化症	血性腹水
前頭葉出血	出血	腰椎骨折
有茎性乳頭状腫瘍	腫瘍	慢性咳嗽
理解困難	言語理解障害	肝細胞癌
スメア異常	腟スメア細胞診陽性	広範脊柱管狭窄症
腹腔内敗血症	敗血症	術中不整脈
膵尾部腫大	膵腫大	白斑
過呼吸状態	過換気症	心房粗動
右肺門部原発肺小細胞癌	小細胞肺癌	風疹
胃癌骨髄癌腫症	骨髄転移	転移性肝癌
眼乾燥感	ドライアイ	アテローム血栓性脳梗塞
内側縦束症候群	核間性眼筋麻痺	肺野円形陰影
両足関節炎	足関節炎	低形成腎
夜低血糖	低血糖	大腿骨転子部骨折
左上下肢軽度麻痺	四肢麻痺	急性腸炎
下肢痙性	痙性対麻痺	膵頭部腫瘤
皮疹状況	発疹	鼻骨骨折
不適応	適応障害	境界型パーソナリティ障害
陰茎部痛	陰茎部疼痛	徐脈
髄外形質細胞腫	骨外性形質細胞腫	先天性白内障
ｍａｌｉｇｎａｎｔ　ｌｙｍｐｈｏｍａ	悪性リンパ腫	多形紅斑
重症ＡＧＨＤ	重症成人成長ホルモン分泌不全	足痛
両白内障	白内障	口内乾燥
腎結石	腎結石症	子宮頚癌
湿疹性病変	湿疹	スケレトンタイプ拡大装置破損
穿刺部発赤	発赤	術後幽門狭窄
時々背部痛	背部痛	敗血症
手内筋萎縮	筋萎縮症	虚血性腸炎
腎機能悪化	腎機能低下	前頭部挫傷
尾てい骨骨折	尾骨骨折	上腕部悪性黒色腫
高度視力障害	視力障害	症候性てんかん
周期性クッシング症候群	クッシング症候群	細菌感染症
昨夜微熱	微熱	進行性核上性麻痺
腓腹筋痙攣	痙攣	ＡＩＤＳ
左肋骨打撲	肋骨部打撲	だに皮膚炎
破壊性脊椎症	脊椎症	夜間せん妄
胆嚢破裂	胆のう管破裂	子宮体癌
独歩不可	歩行障害	爪白癬
骨破壊進行	関節リウマチ	先天性眼振
下肢白癬	白癬	女性性器癌
左鼓膜発赤	発赤	不随意運動症
潜在結核	結核	卵巣腫瘤
熱苦症状	発熱	Ｅｕｔｈｙｒｏｉｄ　Ｓｉｃｋ症候群
シャイドレジャー症候群	シャイ・ドレーガー症候群	菌状息肉症
肺動脈弁閉鎖症	肺動脈弁閉鎖	粘液腫
脾摘施行Ｃ型肝炎	Ｃ型肝炎	血管神経性浮腫
胸水セルブロック	胸水貯留	発赤
右肺上葉すりガラス影	胸部異常陰影	肺動脈弁上狭窄症
Ｆｏｌｌｉｃｕｌａｒ　ｌｙｍｐｈｏｍａ	濾胞性リンパ腫	肺動脈狭窄症
腫瘍性ＤＩＣ	線溶亢進	脱臼
右精巣上体炎	精巣上体炎	右室低形成
左肘関節亜脱臼	亜脱臼	肩腱板損傷
左聴神経腫瘍	聴神経腫瘍	風疹様発疹
左肺感染性嚢胞	肺のう胞	前立腺癌再発
母体出血	出血	咽喉頭異常感症
右足趾壊疽	下肢壊疽	筋力低下
胃腸障害	急性胃腸障害	イレウス
残遺癌	癌	結石性腎盂腎炎
不安大きく	不安障害	乳房良性腫瘍
ＭＳ再発	多発性硬化症	耳後部腫瘤
強直間代性痙攣発作	間代性痙攣	四肢筋力低下
一過性意識消失発作	一過性脳虚血発作	下肺野陰影
乳児白血病	白血病	反復性精神病性うつ病
筋委縮	筋萎縮症	発赤
水腎再燃	水腎症	視床出血
しびれていない	しびれ感	増殖性関節炎
時々血痰	血痰	気道狭窄
左鼠経ヘルニア	鼡径ヘルニア	亜急性感染性心内膜炎
遺伝性腎性尿崩症	先天性腎性尿崩症	頻呼吸
尿管結石	尿管結石症	精神運動興奮状態
体幹掻痒感	そう痒	後出血
右大腿部骨幹部骨折	大腿骨骨幹部骨折	発達性構音障害
糖尿病神経症	糖尿病性神経痛	不定愁訴症
古典的肝細胞癌再発	肝細胞癌	疲労感
左室低形成	左心低形成症候群	嗅覚脱失
劇症肝炎亜急性型	劇症肝炎	鼻部皮下血腫
分岐部動脈瘤	内頚動脈後交通動脈分岐部動脈瘤	解離性動脈瘤
腫瘍感染	腫瘍	退形成性星細胞腫
悪性腫瘍スクリーニング	悪性腫瘍	篩骨洞のう胞
外陰部炎	外陰炎	ＭＲＳＡ感染症
軽度骨髄抑制	骨髄機能低下	側頭部皮下血腫
右踵骨折	骨折	術創部痛
ＰＰＨ	肺高血圧症	腎動脈狭窄症
頭痛時折	頭痛	脊髄播種
血腫貯留	血腫	胸膜播種
不整脈発作	不整脈	尿道漏
静脈炎症状	静脈炎	亜急性痒疹
子宮間質肉腫	肉腫	肺門リンパ節腫脹
右主気管支膜様部壊死	壊死	乳び性腹水
右下肺野スリガラス影	胸部異常陰影	歯肉外傷
時々頭痛	頭痛	前頭葉症候群
胆嚢腺扁平上皮癌	癌	眼球突出症
上行結腸早期癌	上行結腸癌	下腿痛
突発性血小板減少性紫斑病	血小板減少性紫斑病	卵巣癌
意識変動	意識障害	血管腫
左閉鎖リンパ節転移	リンパ節転移	肝芽腫
両側小脳梗塞	小脳梗塞	ガス壊疽
胃癌多発肝転移	転移性肝癌	室上稜下部心室中隔欠損
左前腕浮腫	浮腫	歩行異常
赤紫斑	紫斑病	全身発疹
偽腔閉塞型大動脈解離	解離性大動脈瘤	脳血管障害
高度感音性難聴	感音難聴	日本海裂頭条虫症
左耳介欠損	耳介欠損	卵巣漿液性腺腫
尿路感染	尿路感染症	脛骨腓骨骨折
縦隔炎再発	縦隔炎	左室不全
前立腺肥大有	前立腺肥大症	下肢冷感
胆嚢腫瘍	胆のう腫瘍	胃管癌
胃がん	胃癌	四肢運動障害
左中大脳動脈梗塞	中大脳動脈塞栓症	上腕骨骨肉腫
Ｓｏｔｏｓ症候群	ソトス症候群	末梢性めまい症
必要認知症	認知症	小便不利
肝腫瘤性病変	肝腫瘤	発赤
大動脈瘤解離	解離性大動脈瘤	脳梗塞
挿入部出血	出血	血便
眠前発熱	発熱	前立腺痛
肺炎反復	肺炎	混合型肝癌
子宮内発育不全	子宮発育不全	上肢両側麻痺
左眼窩内腫瘤	眼窩腫瘤	咽頭のう
多発性腎梗塞	腎梗塞	尿管尿路上皮癌
多臓器不全状態	多臓器不全	膝窩部痛
再度痙攣発作	痙攣発作	脳血管障害
変動一過性徐脈	徐脈	ＨＤＬＳ
四肢色素沈着	皮膚色素沈着	嘔気
良性発作性頭位めまい	良性発作性頭位めまい症	心臓悪性リンパ腫
三角圧痛	肩部筋痛	腫瘍
両側声帯不全麻痺	声帯不全麻痺	腎盂拡張
舌痛	舌痛症	転移性脳腫瘍
肺動脈弁下狭窄	肺動脈弁下狭窄症	下腿皮膚潰瘍
乳癌局所再発	乳癌	脳室拡大
頚椎症性神経根炎	頚椎症性神経根症	咽頭発赤
痛みきつい	疼痛	食道びらん
両側顎下腺腫大	顎下腺肥大	結核性リンパ節炎
中等度咽頭期嚥下障害	嚥下障害	心電図左軸偏位
ビタミンＤ不足	ビタミンＤ欠乏症	下肺野陰影
日中下痢便	下痢症	ＨＤＬＳ
胸郭低形成	胸郭異常	侵襲性肺アスペルギルス症
肺スリガラス陰影	胸部異常陰影	甲状腺未分化癌
頻脈傾向変	頻脈症	鼡径ヘルニア
口蓋腫瘤	腫瘤	腰椎部腫瘍
パーキンソン病関連疾患	パーキンソン病	貧血
グラム陰性桿菌菌血症	グラム陰性桿菌敗血症	大腸ＭＡＬＴリンパ腫
右上肢腫脹	上肢腫脹	二次性認知症
左肩甲骨部痛	肩甲骨痛	ＭＲＣＮＳ敗血症
開腹子宮筋腫核	子宮筋腫	下葉肺癌
白内障手術	白内障	節性辺縁帯リンパ腫
腫瘤残存	腫瘤	手足症候群
直腸癌Ｒａ	直腸癌	副甲状腺多発性腺腫
カルボプラチンアレルギー	薬物過敏症	非定型肺炎
肺原発ホジキンリンパ腫	ホジキンリンパ腫	先天性腟異常
循環障害	末梢循環障害	クッシング症候群
原発性空腸癌	空腸癌	神経細胞腫瘍
右卵巣チョコレート嚢腫	チョコレートのう胞	夜間せん妄
重度精神運動発達遅滞	混合性特異的発達障害	膀胱腫瘍
左腎梗塞	腎梗塞	ゴム腫
筋緊張高く	筋強直	腟開放創
母指潰瘍治癒遅延	皮膚潰瘍	精巣破裂
歩行時呼吸困難感	労作時呼吸困難	上腕骨近位端粉砕骨折
滑液貯留	体液貯留	反復性気分障害
痰症状	喀痰	上肢痛
腸管血流障害	末梢循環障害	腹部圧痛
発赤強い	発赤	ＡＩＤＳ
全身性単純ヘルペスウイルス感染症	ヘルペスウイルス感染症	不整脈
冠動脈高度石灰化	冠動脈石灰化	発赤
劇症型腸アメーバ症	腸アメーバ症	溶連菌感染症
慢性痛	慢性疼痛	壊死
不適応行動	適応障害	血痰
心室内血栓	心室内血栓症	ヘモジデリン沈着症
腹膜播種結節摘出	腹膜播種	先天性股関節脱臼
緑色痰	喀痰	自閉性精神発達遅滞
冠動脈硬化	冠状動脈硬化症	化学外傷
右中葉肺癌	中葉肺癌	肋骨転移
ポンプポケット内血腫	血腫	胃進行癌
血管免疫芽球型Ｔ細胞リンパ腫	血管免疫芽球性Ｔ細胞リンパ腫	耳下腺腫脹
腹部緊満	腹部膨満	坐骨骨折
舌骨喉頭下垂	喉頭下垂症	局所出血
尿量低下	乏尿	急性膀胱炎
脳梗塞症	脳梗塞	腎腫大
左非浸潤性乳管癌	非浸潤性乳管癌	深部静脈血栓症
むつかぶれ	おむつ皮膚炎	疲労感
水平亜脱臼	亜脱臼	ＨＣＶ抗体検査陽性
右反復性膝蓋骨脱臼	反復性膝蓋骨脱臼	黄斑部白斑
早期癌	癌	胸水貯留
吻合部出血	出血	蜂窩織炎
子宮頸がん	子宮頚癌	食道静脈瘤破裂
腺扁平上皮癌	癌	再発性鼡径ヘルニア
喉頭蓋サルコイドーシス	サルコイドーシス	不安緊張状態
結核性	結核	カテーテル感染症
声門部狭窄	喉頭狭窄症	静脈瘤性動脈瘤
両側急性硬膜外血腫	急性硬膜外血腫	縦隔リンパ節腫脹
高レニン高血圧	高レニン性高血圧症	副腎腫瘍
頭蓋底髄膜腫	髄膜腫	膿尿
右前胸部痛	前胸部痛	脱色素性色素失調症
膵全体癌	膵癌	肺癌
両側血気胸	血気胸	疾病恐怖症
穿刺部位出血	出血	過食症
手掌黄色腫	黄色腫症	腸間膜腫瘤
皮膚湿疹	湿疹	慢性炎症性脱髄性多発神経炎
唾石	唾石症	四肢運動障害
非吻合部多発胆管狭窄	胆管狭窄症	急性ＨＩＶ感染症候群
軽度肥満歴	肥満症	胃痛
左腎嚢胞不変	腎のう胞	統合失調症
軽度発赤腫脹	発赤	両側性感音難聴
左手関節変形	変形性手関節症	血栓性微小血管症
蛋白尿（３＋）	蛋白尿	水頭症
左手首痛	手部痛	髄膜脳瘤
びまん性肺胞出血	肺胞出血	細菌感染症
続発性赤芽球癆	赤芽球ろう	リンパ節炎
インフルエンザ菌	インフルエンザ	腎無形成
左舌区小細胞癌	小細胞肺癌	腫瘤
左足背疼痛	足背痛	大量便
成人発症Ｓｔｉｌｌ病（ＡＯＳＤ）	成人スチル病	高血糖症
大球性正色素性貧血	正色素性貧血	ＫＲＡＳ遺伝子野生型直腸癌
双極Ⅱ型障害	２型双極性障害	甲状腺梗塞
限局型全身性強皮症	全身性強皮症	多部位リンパ節転移
右水晶体脱臼	水晶体脱臼	多発性脳神経障害
心サルコイト゛ーシス	心サルコイドーシス	声門癌
Ｓ状結腸高分化腺癌	Ｓ状結腸癌	転移性肺腫瘍
右側頬部腫脹	頬部腫脹	胸水貯留
右上背部痛	背部痛	不安緊張状態
両下肢痛み	疼痛	色素性母斑
多発海綿状血管腫	多発性海綿状血管腫	丘疹
結核歴	結核	混合性難聴
ＳＭＡ浸潤	膵癌	全身倦怠感
微小癌	癌	ＴＦＣＣ損傷
慢性疼痛性障害	慢性疼痛	肺胞低換気症候群
高Ｃｌ血症	高クロール血症	水疱性類天疱瘡
乳頭状腺癌	癌	反復性精神病性うつ病
帯状疱疹ウイルス脊髄炎	ウイルス脊髄炎	悪性リンパ腫
内臓播種性ＶＺＶ感染症	汎発性帯状疱疹	うつ病
様皮疹	発疹	びまん性大細胞型・バーキット中間型分類不能Ｂ細胞性リンパ腫
左帯状疱疹	帯状疱疹	口腔粘膜炎
骨形成不全症Ⅲ型	骨形成不全症	末期腎不全
高度肥満症	病的肥満症	飛蚊症
右前頭葉脳内血腫	血腫	心尖部肥大型心筋症
マルチミニコア病	マルチコア病	脱水症
四肢関節腫脹	関節炎	卵管留血腫
右腸骨静脈血栓症	腸骨静脈圧迫症候群	低血糖性脳症
脳底動脈閉塞	脳底動脈閉塞症	傍矢状洞髄膜腫
胸背部圧迫感	背部圧迫感	心室中隔欠損を伴う肺動脈閉鎖症
眼瞼結膜軽度貧血	貧血	胸痛
子宮頸癌Ⅲｂ期	子宮頚癌	ピリピリ感
傍卵巣嚢胞	傍卵巣のう胞	膿胸
肝内腫瘤性病変	腫瘤	ＭＲＳＡ腸炎
血管性紫斑病	症候性紫斑病	膀胱直腸障害
時々右股関節痛	股関節痛	急性ウイルス性肝炎
ＡＳＤ	心房中隔欠損症	肺動静脈瘻
緑膿菌肺感染症	緑膿菌肺炎	頬部痛
母子感染歴	母子感染	習慣性便秘
ふらつきあり転倒リスク高い	めまい	急性心不全
頸腕症候群	頚肩腕症候群	多発性骨盤内臓器損傷・骨盤腔に達する開放創合併あり
食道癌術後リンパ節転移	リンパ節転移	角膜瘢痕
亜急性期小脳梗塞	小脳梗塞	一側性肺気腫
喘息コントロール	咳喘息	良性副腎皮質腫瘍
右膝違和感	全身違和感	Ｂ群溶連菌感染症
腓骨神経麻痺徴候	腓骨神経麻痺	乳癌
中高分化型腺癌	癌	喘鳴
軽度脳梗塞	脳梗塞	大腸癌
身体外傷	外傷	高血圧性心不全
心源性塞栓症	心原性脳塞栓症	呼吸困難
左上腕骨近位端骨折	上腕骨近位端骨折	脳浮腫
神経根性痛	疼痛	脱出性内痔核
白色壊死組織付着	壊死	肺扁平上皮癌
夜間中途覚醒	睡眠障害	原発性胆汁性胆管炎
軽度肺動脈弁狭窄	肺動脈弁狭窄症	変形性膝関節症
転移性肝癌術後再発	転移性肝癌	後腹膜尿貯留
無涙症	涙液分泌不全	咽喉頭知覚麻痺
劇症Ａ型肝炎	Ａ型劇症肝炎	ポリープ
ｃｒｉｔｉｃａｌ　ｉｌｌｎｅｓｓ　ｐｏｌｙｎｅｕｒｏｐａｔｈｙ	多発ニューロパチー	椎間板ヘルニア
右眼増殖性糖尿病網膜症	増殖性糖尿病性網膜症	脂肪腫
右上腕腫脹	上腕部腫脹	先天性耳瘻孔
右側胸水貯留	胸水貯留	膀胱癌
水疱瘡	水疱症	発達遅滞
軽度高Ｋ血症	高カリウム血症	胃周囲リンパ節転移
肝性脳症再発	肝性脳症	硬膜損傷
水様便流出	下痢症	手指先しびれ
二絨毛膜二羊膜性双胎第	二絨毛膜二羊膜性双胎	耳閉感
浮腫傾向	浮腫	食道胃接合部癌
骨Ｐａｇｅｔ病	骨パジェット病	遺伝性大腸癌
Ｅｎｔａｍｏｅｂａ　ｈｉｓｔｏｌｙｔｉｃａ	アメーバ赤痢	急性腎不全
左頚部内頸動脈狭窄	内頚動脈狭窄症	爪剥離症
大腿筋横紋筋肉腫	横紋筋肉腫	頚静脈小体腫瘍
腸炎性関節炎	関節炎	腋窩リンパ節腫脹
ＰＭＳ	月経前症候群	紅皮症型薬疹
腓腹部圧痛	腹部圧痛	陰唇ヘルニア
非チフス性Ｓａｌｍｏｎｅｌｌａ菌血症	菌血症	間欠性跛行
微小多発肝膿瘍	肝膿瘍	下肢浮腫
卵管狭窄	卵管狭窄症	低浸透圧血症
胸部大動脈解離	急性大動脈解離	高血糖症
蜂窩織炎発症	蜂窩織炎	腎結核
輪状披裂関節炎	関節炎	傾眠症
左下肢蜂窩織炎	下肢蜂巣炎	脳外主幹動脈閉塞脳梗塞
肺塞栓	肺塞栓症	貧血
咽頭残留	嚥下障害	限局性前立腺癌
低髄圧症状	低髄液圧症	心膜液貯留
左腓骨開放骨折	腓骨開放骨折	ＳＡＰＨＯ症候群
大量水様下痢	下痢症	結石性腎盂腎炎
処方右乳癌	乳癌	妊娠後期嘔吐
症候性けいれん	症候性てんかん	卵巣のう腫
低血糖回避	低血糖	縦隔リンパ節腫脹
左慢性閉塞隅角緑内障	慢性閉塞隅角緑内障	腹皮拘急
弧発性古典的ＣＪＤ	孤発性クロイツフェルト・ヤコブ病	腟上皮異形成・異型度２
呼吸機能低下	呼吸機能検査異常	大腿骨軟骨肉腫
右大腿リンパ節転移	リンパ節転移	頭部打撲
左第３趾潰瘍	趾皮膚潰瘍	周期性腹痛
足変形	足部変形	心肥大
膝関節水腫	膝関節水症	大動脈弁閉鎖不全症
腹部瘢痕ヘルニア	腹壁瘢痕ヘルニア	先天性僧帽弁閉鎖不全症
月経困難	月経困難症	悪心
左局所進行乳癌	進行乳癌	関節痛
好酸球性胆嚢炎	胆のう炎	腫瘍
左下腿骨幹部骨折	骨折	胸鎖乳突筋炎
即時型アレルギー	アレルギー	クッシング症候群
ふらつき有	めまい	不眠症
ループス腎炎Ｖ型	ループス腎炎	外転足
閉塞性睡眠時無呼吸症侯群	睡眠時無呼吸症候群	巨大左心房
右下肢しびれ	下肢しびれ	新生児一過性多呼吸
頭部脂漏性皮膚炎	脂漏性皮膚炎	ＡＤＨ異常
結核性ブドウ膜炎	結核性ぶどう膜炎	肺炎
左真珠腫性中耳炎再発	真珠腫性中耳炎	前胸部痛
傍大動脈ＬＮ転移	大動脈周囲リンパ節転移	発熱
痙直型四肢麻痺	四肢麻痺	背部石灰化上皮腫
角化性紅斑散在	紅斑症	心臓合併症
労作時呼吸苦自覚	労作時呼吸困難	声帯不全麻痺
慢性腎炎	慢性腎炎症候群	副甲状腺機能亢進症
間質性肺炎像	間質性肺炎	人工肘関節の破損
嘔気様	嘔気	歯槽膿瘍
左側頭葉皮質化出血	出血	背部悪性黒色腫
左上腕骨開放骨折	上腕骨開放骨折	僧帽弁逆流症
腹部膨満継続	腹部膨満	蜂窩織炎
右足底腱膜炎	足底筋膜炎	過剰喀痰
両側顎関節症	顎関節症	小脳動脈狭窄
出血性黄体	出血性黄体のう胞	ＭＲＣＮＳ肺炎
右鼡径部疼痛	鼡径部痛	爪甲肥厚
高～中分化型管状腺癌	癌	苔癬
Ｌａｍｉｖｕｄｉｎｅ耐性Ｂ型肝硬変	Ｂ型肝硬変	原発性アルドステロン症
遺伝性腎炎	家族性腎炎	ＫＲＡＳ遺伝子野生型直腸癌
湿疹化	湿疹	急性大腸炎
左大腿部蜂窩織炎	大腿部蜂巣炎	転移性肝腫瘍
下肢対麻痺	対麻痺	瞳孔不同症
成長発達遅滞	発達遅滞	尿管結石症
下腿点状出血	点状出血	紅斑症
脈管奇形	奇形	インフルエンザ菌感染症
手指欠損	手指欠損症	精神運動興奮状態
咽頭粘膜軽度発赤	咽頭発赤	前頭葉神経膠腫
可動時痛	疼痛	膵臓癌骨転移
下垂手	垂れ手	薬物性肝障害
左陰嚢内容腫大	陰のう腫大	小腸大腸クローン病
痰がからみ	喀痰	痙攣重積型急性脳症
朝出血	出血	習慣性嘔吐
右鼠経ヘルニア修復術	鼡径ヘルニア	自傷
ステロイド骨粗鬆症	ステロイド性骨粗鬆症	亜脱臼
足趾冷感	下肢冷感	脊髄痛
不整腫瘤	腫瘤	片側感覚鈍麻
腎前性脱水	脱水症	気胸
左肩部痛	肩部痛	膠原病
頸部皮下膿瘍	皮膚膿瘍	血腫
ウイルス性感冒	感冒	不定愁訴症
多発腫大リンパ節	リンパ節腫大	頭蓋咽頭腫
腹部自発痛	腹痛症	尿失禁症
中分化型前立腺癌	前立腺癌	開放性外傷性くも膜下出血
左一側性形成不全性股関節症	一側性形成不全性股関節症	耳介周囲湿疹
好酸球性気道炎症	好酸球性気管支炎	膵漿液性のう胞腺腫
腸管蠕動障害	腸管運動障害	痙攣
褥瘡形成リスク高い	褥瘡	薬物性光アレルギー性反応
腰椎変性辷り症	腰椎変性すべり症	頚部痛
手術高血圧	高血圧症	ＬＥ蝶形皮疹
嚥下下困難	嚥下障害	頬粘膜癌
てんかん脳波	異常脳波	急性疼痛
巨大血腫	血腫	肺胞出血
十二指腸原発神経内分泌腫瘍	十二指腸神経内分泌腫瘍	総胆管十二指腸瘻
腹水多量貯留	腹水症	月経痛
内腸骨リンパ節転移	腸骨リンパ節転移	陰茎アポクリン腺癌
ＣＭＶ胃腸炎	サイトメガロウイルス腸炎	食道狭窄
瘢痕痙性	瘢痕	転移性肝腫瘍
両Ｔ字杖歩行	歩行障害	脾腫瘍
便性状変化	便異常	倦怠感
右血栓閉塞	血栓塞栓症	鈍痛
出血付着程度	出血	非特異性低血圧症
右海綿静脈洞髄膜腫	髄膜腫	肺扁平上皮癌
虚血性心疾患合併	虚血性心疾患	浮腫
壊死性筋炎	筋炎	網膜動脈分枝閉塞症
全肺腫瘍	肺腫瘍	刺創感染
軽度構音障害	構音障害	中足骨脱臼骨折
両下腿紅斑	紅斑症	下腿痛
低Ｃａ血症	低カルシウム血症	総肺静脈還流異常
二次性副腎不全	副腎クリーゼ	肝周囲膿瘍
一週間程度眠気	非器質性過眠症	空気塞栓症
子宮内腔癒着	子宮内膜症	肩関節痛症
項部硬直軽度	項部硬直	逆行性胆管炎
下熱	発熱	顎関節痛
右母指陳旧性尺側側副靱帯損傷	靱帯損傷	２型糖尿病
左気管支狭窄	気管支狭窄症	高ＬＤＬ血症
皮膚型ＰＮ	結節性多発動脈炎	肝障害
肺線維化	肺線維症	サイトメガロウイルス感染症
副鼻腔軽度粘膜肥厚	副鼻腔炎	アメーバ性非赤痢性大腸炎
味覚異常Ｇｒ１	味覚異常	赤色湿疹
中心視野欠損	視野欠損	卵巣膿瘍
昨晩低血糖	低血糖	膿疱
両水腎症	両側水腎症	努力性呼吸
前回貧血	貧血	直腸障害
骨粗鬆症性圧迫骨折	骨粗鬆症・病的骨折あり	麻疹様紅斑
右肺原発肺腺癌	肺腺癌	副腎腺腫
脊髄原発悪性リンパ腫	悪性リンパ腫	亜急性連合性脊髄変性症
手指浮腫	浮腫	部分的脂肪萎縮症
口内炎再発	口内炎	発赤
皮質性認知症	皮質下認知症	ウイルス性皮膚炎
足背発赤	発赤	出血傾向
後縦隔腫瘤	縦隔腫瘍	軽躁病
頚椎症性脊椎症	脊椎症	肝硬化性血管腫
中部延髄右外側脳梗塞	脳梗塞	耳下腺腫瘤
仙骨部瘻孔	難治性瘻孔	骨盤子宮内膜症
軽鎖沈着症	単クローン性軽鎖重鎖沈着症	持続痛
右傍気管リンパ節転移	リンパ節転移	血性胸水
ｓｍａｌｌ　ｃｅｌｌ　ｃａｒｃｉｎｏｍａ	癌	高ＴＳＨ血症
遺伝性出血性毛細血管拡張症	オスラー病	慢性胆管炎
胸椎後縦靭帯骨化症	胸椎後縦靱帯骨化症	大腿骨遠位部骨腫瘍
重症敗血症性ショック	敗血症性ショック	頭部損傷
間質性肺炎評価	間質性肺炎	第３度房室ブロック
右腎損傷	腎損傷	骨盤内リンパ節の悪性腫瘍
右肺門部原発	原発性肺癌	初期硬結
再発食道癌	食道癌	イレウス
不定愁訴多い	不定愁訴症	尺骨肘頭開放骨折
発熱再燃	発熱	姿勢異常
左肩関節痛	肩関節痛症	腎機能検査異常
瘢痕様変化	瘢痕	胸部音異常
元々頻尿	頻尿症	外陰部帯状疱疹
浮腫対策	浮腫	足関節腫脹
核下性顔面神経麻痺	顔面神経麻痺	腫瘤
皮膚原発悪性リンパ腫	悪性リンパ腫	顔面神経麻痺
市中感染型ＭＲＳＡ	ＭＲＳＡ感染症	胸部帯状疱疹
左尿管結石	尿管結石症	ＡＩＤＳ
乾性咳嗽頻回	乾性咳	再発性十二指腸潰瘍
首痛	頚部痛	腰部血管腫
右側頭部紫斑	紫斑病	下腿痛
薬剤過敏性症候群	薬物過敏症	転移性肺腫瘍
延長症候群	ＱＴ延長症候群	卵巣腫瘍
紫斑形成軽度	紫斑病	転移性胸膜腫瘍
両側肺動脈狭窄症	肺動脈狭窄症	脛骨骨折
子宮筋腫核出後妊娠	妊娠	痙攣発作
ＡＲＤＳ合併	急性呼吸窮迫症候群	化膿性口腔粘膜肉芽腫
胆道系閉塞	胆道閉塞	活動性肺結核
軟骨損傷	肋軟骨損傷	椎骨動脈狭窄症
右副腎原発	副腎腫瘍	急性甲状腺炎
ｋｌｅｂｓｉｅｌｌａ　ｐｎｅｕｍｏｎｉａｅ感染症	クレブシェラ属感染	四肢麻痺
パ−キンソン症候群	パーキンソン症候群	先天性風疹症候群
右原発性肺癌	原発性肺癌	不全足位
敗血症性ショック状態	敗血症性ショック	膜性腎症
時々発疹	発疹	膝関節滑膜炎
めまい軽度	めまい	中枢性めまい症
右横隔膜筋欠損	筋欠損	鎖骨上リンパ節腫脹
脳症後遺症	脳症	運動失調
胸膜悪性中皮腫	悪性胸膜中皮腫	子宮頚部微小浸潤癌
漿膜損傷	損傷	環状紅斑
頸椎症性	頚椎症	意識障害
多発外傷	多発性外傷	しびれ感
皮膚損傷起	皮膚損傷	転移性肺腫瘍
ふらつき目立	めまい	胆のう結石症
近位筋痛	筋肉痛	パニック障害
採血上脱水	脱水症	代謝性アシドーシス
脳血管芽腫	小脳血管芽腫	骨軟骨腫
右慢性中耳炎	慢性中耳炎	続発性緑内障
アレルギー様	アレルギー	肋間痛
ノカルジア脳膿瘍	ノカルジア症	間代性痙攣
大腸ポリープ有	大腸ポリープ	橈骨神経麻痺
右後頭部帯状疱疹	後頭部帯状疱疹	糸球体性血尿
右頚部結核性リンパ節炎	結核性リンパ節炎	股関節亜脱臼
陳旧性多発アテローム血栓性脳梗塞	陳旧性アテローム血栓性脳梗塞	多発性小脳梗塞
誤嚥徴候	異物誤嚥	全身性紫斑病
右前腕皮疹	発疹	耳小骨の先天奇形
多発肺腫瘤	肺腫瘤	病原性大腸菌感染症
後腹膜浸潤	後腹膜悪性腫瘍	腫瘤
網状紫斑	紫斑病	高血糖症
胚細胞腫瘍	腫瘍	上下顎骨骨折
ゲノタイプ１ｂ型Ｃ型肝硬変	Ｃ型肝硬変	脳腫瘍
類円形腫大	リンパ節腫大	尿失禁症
中枢性気管支拡張像	気管支拡張症	しびれ感
小股歩行	歩行異常	遊走性紅斑
脳血管傷害	脳血管障害	神経性緊張
糖尿病末梢神経障害	糖尿病性単ニューロパチー	腫瘍
ルンバール後頭痛	腰椎穿刺後頭痛	カテーテル感染症
急性重症Ｂ型肝炎	Ｂ型肝炎	下肢静脈血栓症
下垂時疼痛	疼痛	脳出血
頚部蜂窩織炎	頚部蜂巣炎	慢性尿細管間質性腎炎
腹満不変	腹部膨満	異常反射
一過性心筋虚血	心筋虚血	過眠
日勤帯発熱	発熱	放射線性肺線維症
結核性喉頭狭窄	喉頭狭窄症	過剰喀痰
両側鼻内ポリープ	鼻茸	圧痛
手掌潮紅	紅潮	ＨＤＬＳ
低血糖歴何年	低血糖	膵頭部癌
離床時眩暈	めまい	下肢筋萎縮
高齢者Ｃ型慢性肝炎	Ｃ型慢性肝炎	結核性硬膜炎
ＳＬＥ発症	全身性エリテマトーデス	遷延性抑うつ反応
軽度咽頭違和感	咽頭異常感症	リンパ管腫症
体熱感	不明熱	腹部膨満
悪性腫瘍評価	悪性腫瘍	重症心身障害
発赤領域	発赤	肋骨転移
閉塞性大腸癌	大腸癌	腫瘍
子宮頚部ポリープ	子宮頚管ポリープ	下肢冷感
両側大腰筋血腫	血腫	中咽頭良性腫瘍
ＰＳＬＮ転移	大動脈周囲リンパ節転移	口腔外傷性腫脹
咽頭部疼痛	咽頭痛	肺腫瘍
肺腫瘍塞栓症	肺腫瘍	肝障害
羊水過多	羊水過多症	転移性膵腫瘍
筋肉痛症状	筋肉痛	発赤
心外膜石灰化	心膜石灰化	頚部脊柱管狭窄症
右下肢急性動脈閉塞症	下肢急性動脈閉塞症	不眠症
４型進行胃癌	胃進行癌	眼痛
圧迫性脊髄症	脊髄症	人工骨頭破損
出血源不明	出血	多発性血腫
貧血性網膜症	貧血網膜症	ＧＢＳ敗血症
椎間板突出	椎間板症	不整脈
カルチノイド腫瘍	カルチノイド	ＡＶＭ
心臓内腫瘤	腫瘤	慢性脳炎
日中気分不快	悪心	若年性関節リウマチ
多発性嚢胞肝	多発性肝のう胞	趾骨髄炎
仙骨奇形	仙骨部奇形	水疱症
けいれん再発	痙攣	卵巣粘液性腺腫
遊走性静脈炎	遊走性血栓性静脈炎	精神運動発作
左胸膜炎	胸膜炎	足部浮腫
直腸癌術後異時性肝転移	転移性肝癌	大腸肉腫
手指痺れ	しびれ感	手舟状骨骨折
左卵管水腫	卵管留水症	そう痒
歩行時呼吸困難	労作時呼吸困難	転移性直腸腫瘍
ガーゼ出血	出血	胸腔内腫瘤
老人性紅皮症	紅皮症	陰茎海綿状血管腫
右被殻脳梗塞	被殻出血	全身痙攣
自律神経ニューロパチー	自律神経性ニューロパチー	季肋部痛
子宮頚部嚢胞	子宮頚部腫瘍	大動脈狭窄症
右原発閉塞隅角緑内障	原発閉塞隅角緑内障	眼窩悪性リンパ腫
腺腫内癌	癌	見当識障害
両下肢浮腫軽度	下肢浮腫	発熱
右化膿性肩関節炎	化膿性関節炎・肩関節	舌咽神経損傷
膣転移	腟癌	ストレス潰瘍
体力低下著明	体力低下	喉頭浮腫
左小脳陳旧性梗塞	陳旧性脳梗塞	皮膚色素沈着
淡黄色粘稠痰	喀痰	鎖骨上リンパ節転移
外傷所見	外傷	加齢黄斑変性
発赤局面	発赤	二次性肺高血圧症
膀胱癌既往	膀胱癌	単頚双角子宮
左末梢性肺動脈狭窄	肺動脈狭窄症	先天性糖代謝異常
骨代謝異常	代謝障害	夜間低血糖症
心陰影拡大	胸部異常陰影	肘関節痛
腎動脈下腹部大動脈瘤	腹部大動脈瘤	アレルギー性鼻炎
腸管壁内気腫	皮下気腫	虚脱
慢性活動性ＥＢＶ感染症	ＥＢウイルス感染症	腟炎
足関節圧痛	関節痛	光線過敏症
夕方発熱	発熱	骨髄異形成症候群
顔面紅班	紅斑症	出血性脳梗塞
排便痛	排便障害	絶対緑内障
左水腎	水腎症	歯周症
代謝異常	代謝障害	歯性上顎洞炎
両下肢リンハ゜浮腫	下肢リンパ浮腫	急性扁桃炎
左頸部ＬＮ腫脹	肘リンパ節腫脹	鎖骨痛
肺門部リンパ節腫脹	リンパ節腫大	副腎腫瘍
呼吸困難感軽度	呼吸麻痺	腹部膨満
左膝窩動脈血栓症	動脈血栓症	異物誤嚥
左股関節脱臼	股関節脱臼	甲状腺未分化癌
ルーフ゜ス腎炎	ループス腎炎	爪囲炎
鼠径部腫脹	鼡径部腫脹	水分欠乏症
内鼠径ヘルニア	内鼡径ヘルニア	背部褥瘡
左頬部血管腫	頬部血管腫	回転性めまい
開口制限	開口不全	そう痒
変形性関節炎	変形性関節症	脱力感
初回歩行時ふらつき	よろめき歩行	外傷性中耳炎
洞性頻脈	洞頻脈	心電図異常
腹膜播種巣	腹膜播種	糖尿病
アレルギ—性結膜炎	アレルギー性結膜炎	大腸ポリープ
鼠径部血腫	血腫	帯下
暗赤色嘔吐	嘔吐症	周期性呼吸
直腸癌ＯＰ	直腸癌	尺骨神経麻痺
左増殖性糖尿病網膜症	糖尿病網膜症	ウイルス感染症
レム睡眠行動異常	異常行動	左室不全
左大腿有棘細胞癌	大腿有棘細胞癌	播種性ムコール症
声帯癌	声門癌	先天性水頭症
左大腿部疼痛	大腿痛	術後腎盂腎炎
右顎関節症	顎関節症	大腿骨骨肉腫
骨頭壊死	骨壊死	２型糖尿病
中枢神経浸潤	中枢神経系損傷	自然気胸
直腸皮下瘻孔	難治性瘻孔	ＭＲＳＡ敗血症
胆嚢腫大	胆のう肥大	出血傾向
Ｈｅｅｒｆｏｒｄｔ症候群	ぶどう膜耳下腺熱	浮腫
前立腺癌既往	前立腺癌	腎細胞癌
ダグラス窩腹水	腹水症	子宮筋腫
失見当障害	見当識障害	顔面真菌性湿疹
ツツガムシ感染症	つつが虫病	咳喘息
特発性血小板減少症紫斑病	特発性血小板減少性紫斑病	低血糖
前立腺浮腫	浮腫	転移性肝腫瘍
胞性腫瘤	腫瘤	足関節痛
右鼠径リンパ節腫脹	鼡径部リンパ節腫脹	食道圧迫症
ＡＡＡ破裂	腹部大動脈瘤	咀嚼障害
夜間覚醒	不眠症	不眠症
初発癌	癌	温度感覚異常
右迷走神経鞘腫	神経鞘腫	肺動脈弁閉鎖不全症
痙攣様	痙攣	ＨＤＬＳ
機会誤嚥	嚥下障害	膝関節屈曲拘縮
大腿静脈血栓	静脈血栓症	急性腎不全
股関節部骨折	股関節骨折	下血
吸収不全症侯群	吸収不良症候群	急性疼痛
新生血管緑内障	緑内障	網膜裂孔
甲状腺低下症	甲状腺機能低下症	椎間板ヘルニア
アメーバ肝膿瘍	肝アメーバ症	インスリン抵抗性糖尿病
先天性真珠腫	真珠腫	下血
頭部皮膚欠損	頭部皮膚欠損創	ＨＤＬＳ
右肺門部浸潤影	胸部異常陰影	左旋転位
食道悪性腫瘍	食道癌	ＣＡＤＡＳＩＬ
傍大動脈リンパ節転移	大動脈周囲リンパ節転移	腎疾患
ビタミンＤ欠乏	ビタミンＤ欠乏症	両側性感音難聴
レントゲン異常	胸部異常陰影	圧迫骨折
器質的心疾患	心疾患	肺腫瘤陰影
温痛覚	温痛覚過敏	悪性リンパ腫
両側内反足	内反足	リンパ節転移
低酸素症状	低酸素性脳症	急性乳様突起炎
粘稠痰少量	喀痰	被包型胸腺腫
ダンベル型腫瘍	腫瘍	被害妄想
催不整脈作用	不整脈	椎骨動脈狭窄症
左腋窩汗腺癌	汗腺癌	膝部メルケル細胞癌
感染性仮性嚢胞	仮性膵のう胞	声門上癌
乳房熱感	ほてり	膠原病
大腸穿孔	腸穿孔	膝関節滑膜炎
腎瘢痕	瘢痕	併発白内障
孤立性左室緻密化障害	孤立性心筋緻密化障害	転移性膵腫瘍
進行性顔面片側萎縮症	顔面痙攣症	腎細胞癌
左手関節痛	手関節痛	難聴
右鼠径部腫脹	鼡径部腫脹	気逆
びりびりしたしびれ	しびれ感	侵襲性髄膜炎菌感染症
発赤軽減	発赤	夜驚症
悪寒等	悪寒	ＨＤＬＳ
非逆流性食道炎	食道炎	両側性感音難聴
甲状腺萎縮	後天性甲状腺萎縮	リンパ節腫大
呼吸苦自覚症状	呼吸困難	気管支肺炎
多発単神経障害	多発性単ニューロパチー	収縮期高血圧症
中毒性	中毒	気分異常
右肺上葉結節影	胸部異常陰影	便異常
骨膜肥厚	肥厚性皮膚骨膜症	ループスアンチコアグラント
リステリア感染症	リステリア症	ＨＤＬＳ
アルコール性脂肪性肝炎	アルコール性脂肪肝	上肢両側麻痺
脳室穿破	脳出血	ダンピング症候群
鼠径部リンパ節腫大	鼡径部リンパ節腫脹	鎖骨上転移性腫瘍
吐気治	嘔気	炎症性ミオパチー
右鼡径部リンパ節腫脹	鼡径部リンパ節腫脹	急性右室梗塞
多発肺塞栓	肺塞栓症	胸膜肥厚
右腋窩リンパ節転位	腋窩リンパ節転移	感覚異常症
重度右片麻痺	片麻痺	多発性第２度熱傷
両側乳房腫瘤	乳房腫瘤	牽引性頭痛
原発不明癌頸部リンパ節転移	頚部リンパ節転移	総腸骨動脈狭窄
後腹膜脂胞肉腫	後腹膜脂肪肉腫	直腸癌
胆管閉塞機転	胆管閉塞症	褥瘡・ＤＴＩ
右下葉原発扁平上皮癌	下葉肺扁平上皮癌	頭痛
腰椎圧迫骨折既往	腰椎圧迫骨折	ベーチェット病
便秘悪化	便秘症	夜間頻尿症
潜血３	顕微鏡的血尿	躁うつ病
アレルギー性血管浮腫	浮腫	小脳出血
肺動脈分岐部狭窄	肺動脈分岐部狭窄症	浮腫
顕微的血尿	血尿	先天性眼球運動障害
右鼡径リンパ節腫脹	鼡径部リンパ節腫脹	嘔気
左足多趾症	多趾症	前立腺肥大症
日中痛み	疼痛	十二指腸びらん
不安感	不安障害	そう痒
眼球運動痛	疼痛	浮腫
腰椎変性側弯症	腰椎側弯症	皮膚萎縮症
右腎低形成	低形成腎	多発性胆のうポリープ
Ｙｅｒｓｉｎｉａ　ｅｎｔｅｒｏｃｏｌｉｔｉｃａ感染症	エルシニア菌食中毒	側腹部痛
膿胸合併肺放線菌症	肺放線菌症	劇症型Ａ群連鎖球菌感染症
チクチク痛む	チクチク感	呼吸促迫
左水尿管症	水尿管症	めまい発作
多発肺内転移	転移性肺癌	ＡＶＭ
左下葉肺癌断端再発	下葉肺癌	初期う蝕小窩裂溝填塞材脱離
右大腿部発赤	下腿発赤	帯状疱疹
右顔面打撲	顔面打撲傷	上顎洞乳頭腫
糖尿病性自律神経障害	糖尿病性自律神経ニューロパチー	先天性眼瞼下垂
分破水	破水	末梢循環不全
重症マイコプラズマ肺炎	マイコプラズマ肺炎	接合部調律
卵巣嚢腫破裂	卵巣のう腫破裂	神経障害性疼痛
抗原血症	サイトメガロウイルス感染症	足爪白癬
褥瘡発症	褥瘡	皮脂欠乏性湿疹
甲状軟骨浸潤	甲状軟骨の悪性腫瘍	下腿腫脹
潜在性副腎皮質機能低下症	副腎皮質機能低下症	夜尿症
眼球陷凹	眼球陥没	転移性縦隔腫瘍
両足趾潰瘍	趾皮膚潰瘍	転移性肺腫瘍
過換気症状	過換気症	心因性過食
左鎖骨下リンパ節転移	リンパ節転移	代謝性アシドーシス
上右卵管留血腫	卵管留血腫	感染性食道炎
濾胞性リンパ腫再発	濾胞性リンパ腫	神経性食欲不振症
両眼糖尿病性網膜症	糖尿病網膜症	ヘルペス角膜炎
左外傷性大腿骨頭壊死	外傷性大腿骨頭壊死	足切創
肝臓病変	肝疾患	急性意識障害
右第１趾潰瘍	趾皮膚潰瘍	四肢しびれ
腋窩痛	腋窩部痛	足部浮腫
踵部発赤	発赤	異所性拍動
両側ぶどう膜炎	ぶどう膜炎	腹痛症
右アスペルギルス肺炎	肺アスペルギルス症	網膜静脈分枝閉塞症
痔疾患	痔核	足底皮膚潰瘍
無疱疹帯状疱疹	帯状疱疹	発語障害
吐き気軽度	嘔気	低血糖
非結核性抗酸菌性人工関節感染症	非結核性抗酸菌症	下肢壊疽
両下肢不随意運動	不随意運動症	ステロイド糖尿病
前胸痛	胸痛	換気量減少
洞結節不全症候群	洞不全症候群	蜂窩織炎
結腸皮膚瘻	皮膚瘻	右室肥大
患肢熱感	ほてり	栄養失調性浮腫
両側腎膿瘍	腎膿瘍	廃用性弱視
右喉頭腫瘍	喉頭腫瘍	腓骨神経麻痺
潜血	顕微鏡的血尿	吐血
細菌性脳動脈瘤破裂	脳動脈瘤破裂	胸水貯留
右鼡径部皮下出血	皮下出血	気胸
右下腿筋肉内出血	筋肉内血腫	ループスアンチコアグラント
痒感	そう痒	圧痛
大動脈リンパ節転移	大動脈周囲リンパ節転移	残尿感
心内血栓	心内血栓症	手指湿疹
術後出血	後出血	ヒステリー反応
気分悪	悪心	発赤
腰部脊椎管狭窄症	腰部脊柱管狭窄症	白血病
遠位弓部嚢状動脈瘤	動脈瘤	発赤
左総腸骨動脈狭窄	総腸骨動脈狭窄	侵襲性肺アスペルギルス症
尿潜血遷延	顕微鏡的血尿	第２度房室ブロック
夜間悪寒	悪寒	片側感覚鈍麻
造骨性骨転移	骨転移癌	肺炎
腫瘍制御	腫瘍	三尖弁閉鎖不全症
失調性構音障害	構音障害	痙性めまい
右上腕骨頸部骨折	上腕骨頚部骨折	橈骨頭脱臼
リンハ゜節腫大	リンパ節腫大	炎症性腸疾患
皮疹拡大傾向	発疹	こわばり
依然浮腫	浮腫	膝関節痛
右足底部蜂窩織炎	足蜂巣炎	アレルギー
血栓閉塞型大動脈解離	早期血栓閉鎖型大動脈解離	若年性ポリープ
急性期脳血管障害	脳血管障害	高ＩｇＥ症候群
朝方痰	喀痰	皮膚腫瘤
進行性直腸癌	直腸癌	不眠症
小腸型クローン病	小腸クローン病	上腕浮腫
軽度すりガラス影	胸部異常陰影	食道腫瘤
二次性血小板増多症	血小板増加症	脳外主幹動脈閉塞脳梗塞
胃膵嚢胞	膵のう胞	急性上腸間膜動脈閉塞症
最近浮腫	浮腫	鼻口蓋管のう胞
右顔面疼痛	顔面痛	アトニー性非特異性てんかん発作
便失禁多量	便失禁	全身性浮腫
労作時頻脈	頻脈症	手関節痛
両下肢結節性紅斑	結節性紅斑	下肢拘縮
重症胆管炎	胆管炎	胸壁血管肉腫
右側胸部痛	胸痛	葉酸欠乏症
右小指基節骨骨折	小指基節骨骨折	細菌性骨髄炎
右足背腫脹	足背腫脹	腫瘤
右上肢発赤	発赤	ＡＩＤＳ
呂律のまわりにくさ	構音障害	混合腫瘍
アミオダロン誘発性甲状腺中毒症	薬剤性甲状腺機能障害	腹部大動脈瘤
左胸部痛	胸痛	手背部痛
右大腿痛	大腿痛	先天性のう胞肺
左下腿ＤＶＴ	下腿静脈血栓症	多量出血
動悸等症状	動悸	多発性髄膜腫
紫斑	紫斑病	腎腫瘤
致死性不整脈出現	不整脈	乳癌
顆粒膜細胞腫	卵巣顆粒膜細胞腫	血腫
一瞬痛み	疼痛	肺部異常陰影
意識障害患者	意識障害	聴神経腫瘍
切迫早産腹緊	切迫早産	エバンス症候群
難治性皮膚非定型抗酸菌症	非結核性抗酸菌症	中咽頭側壁癌
頚部鈍痛	鈍痛	未破裂脳動脈瘤
発赤範囲	発赤	頚部蜂巣炎
左腕腫脹	前腕腫脹	会陰部血腫
右肺上葉陰影	胸部異常陰影	急性低音障害型感音難聴
右上葉肺結節	結節性肺結核	ポリープ
空腹時高血糖	高血糖症	気胸
右麻痺	片麻痺	下葉肺扁平上皮癌
味覚変化	味覚障害	卵管筋腫
器質化肺炎	特発性器質化肺炎	重度ストレス反応
浮腫悪化	浮腫	外鼡径ヘルニア
凝固異常症	血液凝固異常	こわばり感
右側頭葉脳梗塞	脳梗塞	喉頭肉芽腫
両側下顎骨折	下顎骨骨折	薬剤性過敏症症候群
左頭頂葉神経膠腫	頭頂葉神経膠腫	頭部打撲
骨盤内多発リンパ節転移	骨盤内リンパ節転移	ペースメーカ不全
直腸閉塞	直腸閉鎖	異常脳波
運動ニューロン病	運動ニューロン疾患	甲状腺機能亢進症
肺犬糸状虫症	犬糸状虫症	結核性胸膜炎
軽度骨棘	骨棘	眼瞼下垂症
疲労感少	疲労感	骨盤内リンパ節の悪性腫瘍
多発性肝腫瘤	肝腫瘍	細菌性腸炎
意味性錯語	文意失語症	肺好酸球性肉芽腫症
ｃｏａｒｓｅ　ｃｒａｃｋｌｅｓ	湿性ラ音	口苦
緑色下痢便	下痢症	イレウス
皮膚損傷リスク	皮膚損傷	椎間板ヘルニア性腰痛症
左母指痛	母指痛	皮膚感染症
ＡＶブロック	房室ブロック	特発性末梢性顔面神経麻痺
前縦隔ＬＮ転移	縦隔リンパ節転移	頻拍症
間質性肺炎発症	間質性肺炎	細菌感染症
外側脱臼	脱臼	術後性反回神経麻痺
右環指基節骨骨折	環指基節骨骨折	術後膵炎
左殿部疼痛	殿部痛	せん妄
両側錐体路障害	錐体路障害	総胆管結石
両足しびれ	下肢しびれ	皮膚びらん
膜性増殖性	膜性増殖性糸球体腎炎	筋疲労
頻脈性心房粗動	心房粗動	幻聴
下肢血流障害	下肢血行障害	過敏性腸症候群
左肺上葉大細胞癌	上葉肺大細胞癌	併発白内障
結核性肋膜炎	結核性胸膜炎	鼻中隔弯曲症
疼痛有	疼痛	水中毒
実質外腫瘤	腫瘤	鉄代謝障害
骨盤部リンパ節転移	骨盤内リンパ節転移	心音図異常
左三叉神経帯状疱疹	三叉神経帯状疱疹	ＭＲＣＮＳ敗血症
間質性肺炎悪化	間質性肺炎	腫瘤
仙骨部骨折	仙骨骨折	ステロイド糖尿病
重症低体温症	低体温	胸部不快感
関節炎悪化	関節炎	原発性肺癌
右尖足	尖足	丘疹
両手指浮腫	浮腫	膵石灰化症
左主気管支狭窄	気管支狭窄症	冠状動脈狭窄症
浸潤癌化	癌	咽頭発赤
就寝後呼吸困難	呼吸困難	上腕脂肪腫
仮性膵嚢胞	仮性膵のう胞	リンパ節腫大
右肺上葉癌	上葉肺癌	慢性びまん性管内増殖性糸球体腎炎
訪室時疼痛	疼痛	顔面帯状疱疹
膠原病様症状	膠原病	陳旧性前壁中隔心筋梗塞
軽度黄染	黄疸	後頭蓋窩髄膜腫
転移性膵癌	膵癌	副腎出血
除皮質硬直様	除皮質硬直	腸出血
間歇跛行	間欠性跛行	血便
動脈瘤コイル塞栓術	動脈瘤	鼡径部痛
紅斑散在	紅斑症	手骨骨折
右膝疼痛	膝関節痛	二次性高脂血症
食思不振傾向	食欲不振	発赤
皮内腫瘍	腫瘍	喀血
左前床突起部髄膜腫	髄膜腫	高血圧症
右脳梗塞	脳梗塞	尿管結石症
軽度腹部痛	腹痛症	正中頚のう胞
多発毛細血管拡張	オスラー病	外腸骨動脈狭窄
不整脈誘発	不整脈	眼瞼黄色腫
左肺動脈ＰＥ	肺動脈血栓塞栓症	特発性副甲状腺機能低下症
胃潰瘍再発	胃潰瘍瘢痕	続発性ヘモクロマトーシス
境界域精神発達遅滞	知的障害	近視
胆石膵炎	胆石性膵炎	急性脳症
右腕頭動脈瘤	腕頭動脈瘤	ＡＩＤＳ
外陰部ｐａｇｅｔ癌	外陰部パジェット病	胸膜肥厚
リウマチ様症状	関節リウマチ	足部腫脹
肺癌性リンパ管症	癌性リンパ管症	正球性正色素性貧血
左上腕骨顆部骨折	上腕骨顆部骨折	パニック発作
骨盤位妊娠	骨盤位	前足部痛
大腿骨骨折後	大腿骨骨折	ヒステリー反応
左椎間孔狭窄	結合組織性椎間孔狭窄症	せん妄
前立腺軽度腫大	前立腺肥大症	腰椎破裂骨折
下顎腫脹	下顎部腫脹	中足骨骨折
鼻中隔弯曲	鼻中隔弯曲症	高ＨＤＬ血症
大腸憩室症	多発性大腸憩室症	過敏症
逆流性食道炎無	逆流性食道炎	夜間低血糖症
致死性偽膜性腸炎	偽膜性腸炎	嘔吐症
眼窩蜂窩織炎	眼窩蜂巣炎	白内障
排尿後痛	排尿痛	足背骨折
右腹痛	腹痛症	多発性のう胞腎
嚥下耳痛	耳痛症	びまん性大細胞型Ｂ細胞性リンパ腫
茶色出血	出血	過外転症候群
左下葉扁平上皮癌	下葉肺扁平上皮癌	下腿皮膚潰瘍
右腎梗塞	腎梗塞	総指伸筋腱脱臼
原発性ヘモクロマトーシス	ヘモクロマトーシス	僧帽弁狭窄兼閉鎖不全症
右前頭葉膠芽腫	前頭葉膠芽腫	調節不全
急性水頭症	水頭症	皮膚落屑
活動性肺結核所見	活動性肺結核	尿管回腸導管吻合部狭窄
右眼白内障	白内障	播種性クリプトコッカス症
本日胸痛	胸痛	動揺病
直腸膀膀胱窩	直腸膀胱瘻	下肢痙攣
頚部結核性リンパ節炎	結核性リンパ節炎	肩関節痛症
左橈骨遠位骨折	橈骨遠位端骨折	醜形恐怖症
逆行性Ｐ波	心電図異常	ＬＧＬ症候群
しびれない	しびれ感	外鼡径ヘルニア
臀部圧痛	圧痛	外耳道閉鎖
咽頭血腫	咽頭部血腫	内頚動脈狭窄症
膀胱癌再発	膀胱癌	転移性肝腫瘍
多発皮下転移	皮下腫瘍	環指基底細胞癌
両側肺動脈血栓塞栓症	肺動脈血栓塞栓症	リンパ節腫大
副鼻腔病変	副鼻	急性リンパ性白血病
安静時呼吸苦	呼吸困難	クラミジア頚管炎
左胸膜播種	胸膜播種	血尿
陰嚢疼痛	陰のう痛	視神経脊髄炎
上眼瞼腫脹	眼瞼浮腫	上腹部痛
右下肢複雑骨折	開放骨折	術後悪心
可動性良好腫瘤	腫瘤	胸椎側弯症
両頬部発赤	発赤	ＨＩＶ網膜症
感染性肝嚢胞	肝のう胞	上葉非小細胞肺癌
左鼡径部腫脹	鼡径部腫脹	舌扁桃炎
突然呼吸困難	呼吸困難	嚥下障害
皮下出血斑	皮下出血	腸骨動脈血栓症
右下腿骨髄炎	大腿骨骨髄炎	劇症型Ａ群連鎖球菌感染症
平行機能障害	平衡異常	反復性気分障害
元々杖歩行	歩行障害	嘔吐症
両下肢腫脹	下肢腫脹	下顎正中部骨折
左傍矢状洞髄膜腫	傍矢状洞髄膜腫	アレルギー性鼻炎
限局性皮膚硬化型全身性強皮症	全身性強皮症	肺癌
毎回失禁	尿失禁症	関節拘縮
右小脳腫瘍	小脳腫瘍	１型糖尿病
続発性サルコペニア	サルコペニア	コレステロール尿症
非医原性左尿管狭窄	尿管狭窄	慢性下痢症
下腿血腫	血腫	下肢冷感
逆流性膀胱炎	膀胱尿管逆流	片麻痺
覚醒時疼痛	疼痛	サルコイドーシス
左大転子部発赤	発赤	大動脈石灰化症
卵巣原発腫瘍	卵巣腫瘍	てんかん大発作
リンパ腫再発	悪性リンパ腫	徐脈
重度運動障害性構音障害	構音障害	正中神経麻痺
右肩周囲炎	肩周囲炎	ＨＢｓ抗原検査陽性
軽度動悸	動悸	漏出性胸水
左ポスナーシュロスマン症候群	ポスナーシュロスマン症候群	縦隔膿瘍
液体貯留	体液貯留	不眠症
低張性低ナトリウム血症	低ナトリウム血症	異常蛋白血症
癌性胸腹膜炎	癌性腹膜炎	間欠性跛行
心臓内腫瘍	心臓腫瘍	多量出血
左坐骨神経麻痺	坐骨神経麻痺	急性疼痛
リステリア髄膜脳炎	リステリア性髄膜脳炎	腫瘤
点圧痛	圧痛	動脈瘤様骨のう腫
帯状疱疹ウイルス脳炎	帯状疱疹性脳炎	下腿浮腫
齲蝕	う蝕	Ｓ状結腸粘膜下腫瘍
腎性急性腎障害	腎障害	腹部膨満
喉頭嚢胞	喉頭のう胞	頭蓋底腫瘍
甲状腺乳頭腺癌	甲状腺乳頭癌	異常頭部運動
左上下肢しびれ	半身しびれ	変形性肩関節症
心筋傷害	心筋疾患	非定型うつ病
圧迫性骨折	圧迫骨折	肩部悪性軟部腫瘍
胆嚢胆石	胆泥	ムコール症
縱隔リンパ節転移	縦隔リンパ節転移	見当識障害
悪性細胞	癌	胎児胸水
Ｌｉｓｔｅｒｉａ　ｍｏｎｏｃｙｔｏｇｅｎｅｓ敗血症	敗血症	先天性大腸閉鎖
パニック症侯群	パニック障害	亀頭部潰瘍
アレルギー性肺アスペルギルス症	アレルギー性気管支肺アスペルギルス症	急性膵炎
左下肢原発性リンパ浮腫	リンパ浮腫	片側痛覚消失
呼気時喘鳴	喘鳴	直腸癌
落ち着かない	多動性障害	側頭葉海綿状血管腫
苦悶症状	胸内苦悶	顎下リンパ節腫脹
トルーソー症候群	トルソー症候群	狭心症
全身浮腫不変	全身性浮腫	多呼吸
左側頭円蓋部髄膜腫	円蓋部髄膜腫	直腸閉鎖
周術期喘息発作	気管支喘息発作	変形性脊椎症
薬剤性副腎不全	副腎皮質機能低下症	環指末節骨骨折
乳がん	乳癌	アレルギー性鼻炎
巣状分節状糸球体硬化症	巣状糸球体硬化症	環状紅斑
口腔乾燥感	口腔乾燥症	肛門潰瘍
右手関節尺側部痛	手関節痛	完全左脚ブロック
右上顎洞真菌症	上顎洞炎	内耳先天奇形
鮮血便	血便	しびれ感
心配症	心配	閉塞性肥大型心筋症
アシドーシス進行	アシドーシス	粉瘤
右足滑液包炎	滑液包炎	僧帽弁逆流症
第５胸椎転移	胸椎転移	ネフローゼ症候群
表出性言語発達遅滞	言語発達遅滞	胃血管腫
発作性心房細動既往	発作性心房細動	結核性腹膜炎
左リウマチ性膝関節症	関節リウマチ・膝関節	上肢痛
左大腿部痛	大腿痛	後腹膜尿貯留
隆起性病変	胃ポリープ症	腟内異物
腫瘤状構造	腫瘤	食道癌
細菌性赤痢感染症	赤痢	肛門疾患
多数骨折	骨折	膠原病
門脈右枝血栓	門脈血栓症	肺炎
３型進行癌	癌	腟断端出血
倦怠感等	倦怠感	胃液分泌過多
全頭脱毛症	脱毛症	浮腫
筋攣縮	筋痙縮	ＮＳＡＩＤ腎症
元々徐脈	徐脈	うっ血肝
特発性側彎症	特発性側弯症	内頚動脈血栓症
回盲部放線菌症	放線菌症	拘束型心筋症
ｆａｎ症候群	マルファン症候群	痔核
脊椎椎間板炎	椎間板炎	化膿性耳下腺炎
起始異常	冠動脈起始異常	老人性夜間せん妄
右眼球破裂	眼球破裂	浮腫
介助　疼痛	疼痛	急性冠症候群
前失神	失神	中枢性難聴
ふらつき感自覚	よろめき歩行	頭部血腫
低分化型肝細胞癌	肝細胞癌	腸疾患
右葉間胸水	葉間胸水	発赤
子宮内膜症性卵巣嚢胞	卵巣子宮内膜症のう胞	結核性腹膜炎
腎嚢胞出血	傍腎盂のう胞	内頚動脈狭窄症
無症候性キャリア	ＨＴＬＶ−１キャリア	肺良性腫瘍
中等度腹水	腹水症	大動脈狭窄症
受容体脳炎	抗ＮＭＤＡ受容体脳炎	非アトピー性喘息
肛門部軽度発赤	肛門部周囲炎	変形性股関節症
側方リンパ節転移	リンパ節転移	下血
左硝子体混濁	硝子体混濁	耳下腺腫脹
統合失調症既往	統合失調症	肘関節骨折
平衡機能障害	平衡障害	原発性肺癌
肺腫瘤影	胸部異常陰影	単眼性視力障害
複雑型異型子宮内膜増殖症	腺腫性子宮内膜増殖症	肩関節痛症
皮膚潰瘍形成	皮膚潰瘍	転移性脳腫瘍
肝肥大	肝型糖原病	痛風
紅斑腫脹	紅斑症	生検後感染
腰部圧痛	腰痛症	尿閉
元々不眠症	不眠症	持続腹痛
左肩甲骨軟骨肉腫	肩甲骨軟骨肉腫	レビー小体型認知症
肺血症性ショック	敗血症性ショック	固縮性扁平足
凝固線溶系異常	血液凝固異常	ＨＴＬＶ−１感染症
異所性静脈瘤	静脈瘤	後縦隔腫瘍
腫瘍崩壊	腫瘍	上葉非小細胞肺癌
破壊性甲状腺炎	甲状腺炎	腰部脊柱管狭窄症
右腸骨ＬＮ転移	腸骨リンパ節転移	全身型重症筋無力症
右腎被膜下血腫	血腫	鎖骨下動脈起始異常
全身性サルコイドーシス	サルコイドーシス	気分異常
脱分化型脂肪肉腫	脂肪肉腫	股関節変形
非機能性下垂体腫瘍	下垂体腫瘍	四肢痛
ＡＣＴＨ分泌不全	ＡＣＴＨ分泌低下症	糖尿病
時々残尿感	残尿感	腰部有棘細胞癌
小人症	低身長症	子宮頚部上皮内腫瘍
右臼蓋転移	骨盤転移	眼瞼結膜出血
右頭頂葉脳梗塞	脳梗塞	急性毛様体炎
マルファン症候群合併	マルファン症候群	腓骨剥離骨折
右眼網膜症	網膜症	脊柱管狭窄症
咽喉頭炎	咽頭喉頭炎	肥厚性幽門狭窄症
右下葉肺扁平上皮癌	下葉肺扁平上皮癌	ＭＮＧＩＥ
足趾壊疽	趾壊死	超皮質性失語
左肺尖部腺癌	肺腺癌	高ＩｇＤ血症
潰瘍型間質性膀胱炎	間質性膀胱炎	アダムス・ストークス症候群
紅色皮疹	発疹	上顎歯肉癌
遺尿	遺尿症	記銘力低下
頚管狭窄	子宮頚管狭窄症	高グロブリン血性紫斑病
右腎門部腹側脂肪肉腫	腎周囲脂肪肉腫	閉鎖性膵臓破裂
左中頭蓋窩髄膜腫	中頭蓋窩髄膜腫	爪囲炎
脳梗塞後後遺症	脳梗塞	刺虫症
含歯性嚢胞	含歯性のう胞	類皮のう胞
紅斑熱	日本紅斑熱	回腸閉鎖
多発頭蓋骨転移	骨転移癌	多剤耐性緑膿菌感染症
Ｄａｎｌｏｓ症候群	エーラス・ダンロス症候群	虫刺性皮膚炎
運動低下性構音障害	構音障害	ポリープ
右重症下肢虚血	重症虚血肢	踵痛
両側腸腰筋血腫	血腫	大腿骨遠位端骨折
亀頭部発赤	発赤	視野障害
肝嚢胞感染	肝のう胞	縦隔原発大細胞型Ｂ細胞性リンパ腫
重症強迫性障害	強迫性障害	鼻涙管閉鎖症
顔面骨圧痛	圧痛	先天性鼻咽腔閉鎖不全
左椎間板ヘルニア	椎間板ヘルニア	熱性痙攣
会陰部疼痛	外陰部痛	早期食道癌
咀嚼時痛	咀嚼筋痛障害	腫瘍
左膝関節偽痛風	膝関節偽痛風	創傷
２次性副甲状腺機能亢進症	副甲状腺機能亢進症	水腎症
右上腕蜂窩織炎	上腕蜂巣炎	横隔神経麻痺
右前大脳動脈未破裂動脈瘤	前大脳動脈瘤	多房性腎のう胞
リウマチ性胸水	リウマチ性肺疾患	肝細胞癌
右眼白内障手術	白内障	関節痛
悪性リンハ゜腫	悪性リンパ腫	真菌症
胆管腫瘍栓	胆管腫瘍	異常呼吸
右基底核梗塞	脳梗塞	頚椎化膿性椎間板炎
境界型耐糖能障害	耐糖能異常	髄膜癌腫症
リウマチ疾患	関節リウマチ	筋痙直
白内障Ｏ	白内障	不全型ベーチェット病
心房細動停止	心房細動	びまん性軸索損傷
帯状疱疹既往	帯状疱疹	悪性腫瘍
腫瘤所見	腫瘤	気管支狭窄症
ＶＨＬ病	フォンヒッペル・リンダウ病	慢性腎不全
時折血痰	血痰	低酸素血症
陰嚢部腫脹	陰のう腫大	未破裂脳動脈瘤
帰室時疲労感	疲労感	そう痒
高分化型腺癌	癌	疲労感
糖尿病等	糖尿病	鼻閉
Ｍｙｃｏｂａｃｔｅｒｉｕｍ　ｓｈｉｇａｅｎｓｅ感染症	非結核性抗酸菌症	腹壁ヘルニア
後腹膜腫瘍切除術	後腹膜腫瘍	頚性耳鳴
肺転移発覚	転移性肺腫瘍	静脈瘤性皮膚炎
右中咽頭癌	中咽頭癌	肺動脈血栓塞栓症
両側肺動脈血栓塞栓	動脈血栓症	中咽頭癌
臀部炎症性粉瘤	粉瘤	転移性肺腫瘍
左耳耳鳴	耳鳴症	後腹膜腫瘍
鼠経ヘルニア	鼡径ヘルニア	ＭＲＣＮＳ感染症
鼻閉塞	鼻閉	糖尿病
疲労感等	疲労感	甲状腺未分化癌
日中掻痒感	そう痒	疲労感
前交通動脈未破裂脳動脈瘤	未破裂脳動脈瘤	胸部腫脹
夜間低酸素血症	低酸素血症	血痰
薬剤性腎不全	薬剤性腎障害	ＨＤＬＳ
気管支狭窄	気管支狭窄症	腫瘤
腫瘍増悪	腫瘍	帯状疱疹
急性軸索障害	びまん性軸索損傷	心房細動
完全型ベーチェット病	ベーチェット病	白内障
筋肉痙攣	痙攣	リウマチ性肺疾患
癌性髄膜腫症	悪性髄膜腫	糖質不耐性吸収不良症
化膿性脊椎椎間板炎	化膿性椎間板炎	再発性脳梗塞
呼吸性雑音	胸部音異常	胆管腫瘍
真菌塊	真菌症	鼡径部リンパ節腫脹
両肩関節圧痛	圧痛	白内障術後
多発肝細胞癌	肝腫瘍	血性胸水
右腎小嚢胞	傍腎盂のう胞	未破裂脳動脈瘤
左横隔膜神経麻痺	横隔神経麻痺	上腕蜂巣炎
右高度水腎症	水腎症	二次性甲状腺機能亢進症
創傷治癒遅延	創傷	膝関節偽痛風
上腫瘍	腫瘍	鼡径部痛
進行性食道癌	食道癌	陰茎部疼痛
複雑性熱性痙攣	熱性痙攣	椎間板ヘルニア
先天性鼻咽腔閉鎖不全症	先天性鼻咽腔閉鎖不全	骨痛
右眼鼻涙管閉塞症	鼻涙管閉鎖症	強迫性障害
縦隔原発Ｂ細胞大細胞型リンパ腫	縦隔原発大細胞型Ｂ細胞性リンパ腫	巨大肝蛭感染症
左半視野障害	視野障害	発赤
大腿骨近位部骨折	大腿骨骨折	腰部血管腫
左踵部痛	踵痛	重症虚血肢
ポリープ様隆起	ポリープ	運動障害性構音障害
刺激性皮膚炎	皮膚炎	ＭＥＬＡＳ症候群
慢性緑膿菌感染	緑膿菌感染症	転移性頭蓋骨腫瘍
回腸閉塞	回腸狭窄	紅斑症
尾部嚢胞	膵のう胞	含歯性のう胞
虫刺症	蜂刺症	脳梗塞後遺症
第二趾爪囲炎	爪囲炎	中頭蓋窩髄膜腫
膵仮性嚢胞破裂	仮性膵のう胞	腎周囲脂肪肉腫
シェーンラインヘノッホ紫斑病	ＩｇＡ血管炎	卵管狭窄症
記銘障害	記銘力低下	遺尿症
上歯肉癌	上顎歯肉癌	紅色汗疹
チャーグ－ストラウス症候群	好酸球性多発血管炎性肉芽腫症	間質性膀胱炎
低ＡＴⅢ血症	アンチトロンビン欠乏症	肺門部腺癌
超皮質性感覚性失語	皮質下感覚性失語症	足壊疽
ＮＯＭＩ	腸壊死	下葉肺扁平上皮癌
肥厚性幽門狭窄	肥厚性幽門狭窄症	咽頭喉頭炎
問題なし脊柱管狭窄症	脊柱管狭窄症	近視性網膜症
左踵骨裂離骨折	踵骨骨折	マルファン症候群
慢性糸球体炎	糸球体腎炎	脳幹梗塞
左眼結膜下出血	結膜下出血	側頭部転移性腫瘍
子宮頸部上皮内腫瘍	子宮頚部上皮内腫瘍	小児性愛
左腰部有棘細胞癌	腰部有棘細胞癌	残尿感
糖尿病罹患	糖尿病	ＡＣＴＨ分泌低下症
四肢圧痛	圧痛	下垂体良性腫瘍
関節変形	関節奇形	線維脂肪肉腫
気分変動	気分変調症	サルコイドーシス
左鎖骨下動脈起始異常	鎖骨下動脈起始異常	外傷性腎被膜下血腫
立位バランス練習重症筋無力症	重症筋無力症	直腸癌骨転移
腰椎脊柱管狭窄	腰部脊柱管狭窄症	甲状腺炎
左上葉小細胞肺癌	上葉小細胞肺癌	腫瘍崩壊症候群
左後縦隔腫瘍	後縦隔腫瘍	静脈瘤性動脈瘤
食道カンジタ症合併ＨＩＶ感染症	ＨＩＶカンジダ病	先天性血液凝固因子異常
固縮無動	こわばり	出血性ショック
小体認知症	認知症	肩甲骨軟骨肉腫
突然腹痛	腹痛症	不眠症
尿閉気味	尿閉	腰殿部痛
生検部感染徴候	創傷感染症	多形滲出性紅斑
痛風症状	痛風	肝腫大
脳転移新出	転移性脳腫瘍	皮膚潰瘍
両側肩関節痛	肩関節痛症	複雑型子宮内膜異型増殖症
右眼下鼻側視野異常	視野障害	肺腫瘤陰影
右肺Ｓ４原発腺癌	肺腺癌	平衡障害
右肘関節骨折	肘関節骨折	統合失調症
両耳下腺腫脹	耳下腺腫脹	硝子体混濁
再下血	下血	多部位リンパ節転移
両変形性股関節症	変形性股関節症	咽頭発赤
喘息コントロール不良	咳喘息	続発性脳炎
腹部大動脈狭窄症	大腿動脈狭窄症	異常腹水
左肺良性腫瘍	肺良性腫瘍	ＨＥＶキャリア
頸動脈狭窄症	内頚動脈狭窄症	腎出血
若年結核性腹膜炎	結核性腹膜炎	卵巣子宮内膜症のう胞
発赤部分	発赤	葉間胸水
大腸疾患	腸疾患	肝細胞癌
頚部血腫	頚部表在損傷	感覚異常症
肺雑聴取	胸部音異常	失神
急性冠症候群発症	急性冠症候群	疼痛
皮下浮腫	浮腫	眼球破裂
低活動型せん妄	せん妄	勃起不全
左化膿性耳下腺炎	化膿性耳下腺炎	頚椎椎間板炎
痔核症状	痔核	ＣＦＣ症候群
拘束性心筋症	拘束型心筋症	放線菌症
右内頸動脈血栓閉塞	動脈血栓症	特発性側弯症
肝うっ血	うっ血肝	徐脈
ＣＮＩ腎症	薬剤性腎障害	筋痙縮
浮腫軽減	浮腫	全身性脱毛症
胃液様	嘔吐症	倦怠感
右鼡径部出血	出血	進行性前立腺癌
右肺上葉肺炎	肺炎	門脈血栓症
膠原病外来	膠原病	重複骨折
門亢症	門脈圧亢進症	細菌感染症
在型食道癌	食道癌	頭部腫瘤
創内異物	外傷性異物	持久性隆起性紅斑
膀胱内尿貯留	後腹膜尿貯留	大腿内側部痛
肢痛	疼痛	関節リウマチ・膝関節
肺結核性腹膜炎	結核性腹膜炎	発作性心房細動
腸管内血腫	血腫	言語発達遅滞
ネフローゼ状態	ネフローゼ症候群	胸椎転移
軽度僧帽弁逆流症	僧帽弁逆流症	足関節滑液包炎
前胸部粉瘤	粉瘤	アシドーシス
左室中部閉塞性肥大型心筋症	閉塞性肥大型心筋症	心配
しびれがきつい	しびれ感	血便
両側内耳奇形	内耳先天奇形	深在性皮膚真菌症
完全右脚ブロック指摘	完全右脚ブロック	手関節痛
肛門部潰瘍	肛門潰瘍	口腔乾燥症
臀部紅斑	紅斑症	巣状糸球体硬化症
アレルギ—性鼻炎	アレルギー性鼻炎	乳頭びらん
末節骨骨折	骨折	急性腎不全
脊椎症性変化	脊椎症	気管支喘息重積発作
腸閉塞気味	イレウス	円蓋部髄膜腫
浅呼吸	呼吸困難	全身性浮腫
無症候性狭心症	狭心症	トルソー症候群
右顎下リンパ節腫脹	顎下リンパ節腫脹	胸内苦悶
左側頭葉海綿状血管腫	側頭葉海綿状血管腫	落ち込み
直腸癌術後直腸癌	直腸癌	先天性喘鳴
痛覚消失	異常知覚	上下肢リンパ浮腫
膵炎再燃	膵炎	アレルギー性気管支肺アスペルギルス症
肘頭部潰瘍	前腕皮膚潰瘍	パニック障害
反復性腸閉塞	イレウス	ＭＲＣＮＳ敗血症
胎児腹水	胎児水腫	軟部悪性巨細胞腫
失見当識障害	見当識障害	鼡径部リンパ節転移
皮膚ツルゴール低下	脱水症	総胆管結石性胆のう炎
右肩悪性軟部腫瘍	悪性軟部腫瘍	圧迫骨折
非定型うつ	非定型うつ病	心筋症
右中指スワンネック変形肩関節	スワンネック変形	下肢しびれ
胸郭運動異常	胸郭異常	甲状腺乳頭癌
前頭蓋底腫瘍	頭蓋底腫瘍	喉頭蓋のう胞
腹部肥満	肥満症	急性腎性腎不全
Ｓ状結腸粘膜下腫瘤	腫瘤	腐蝕
両側下腿圧痕性浮腫	下腿浮腫	ウイルス性脳炎
動脈瘤様骨嚢腫	動脈瘤様骨のう腫	圧痛
軟性腫瘤	腫瘤	リステリア性髄膜脳炎
本日疼痛	疼痛	坐骨神経麻痺
出血軽度	出血	心臓腫瘍
軽度間歇性跛行	間欠性跛行	癌性胸膜炎
蛋白血症	異常蛋白血症	低ナトリウム血症
不眠時２錠	不眠症	体液貯留
後縦隔膿瘍	縦隔膿瘍	ポスナーシュロスマン症候群
胸水排出	胸水貯留	動悸
ＡＩＤＳ非定型抗酸菌症	非結核性抗酸菌症	肩周囲炎
尺側神経麻痺	尺骨神経麻痺	運動障害性構音障害
徐脈等	徐脈	リンパ腫
てんかんの発作	てんかん	卵巣腫瘍
腹部大動脈石灰化	大動脈石灰化症	下腿発赤
サルコイドーシス疑	サルコイドーシス	術後疼痛
左片麻痺	片麻痺	反復性膀胱炎
足部冷感	下肢冷感	下腿血管腫
下痢〜水様便	下痢症	先天性尿管狭窄症
コレステロールポリープ	ポリープ	サルコペニア
１型糖尿除	糖尿	小脳腫瘍
関節固縮	関節拘縮	切迫性尿失禁
肺多型癌	癌	全身性強皮症
慢性アレルギ—性鼻炎	アレルギー性鼻炎	傍矢状洞髄膜腫
下顎骨正中部骨折	下顎正中部骨折	下肢腫脹
後嘔吐	嘔吐症	痙性歩行
気分不快出現	悪心	知的障害・要治療の行動機能障害あり
劇症Ａ群溶連菌感染症	劇症型Ａ群連鎖球菌感染症	下腿骨骨髄炎
内腸骨静脈血栓症	静脈血栓症	下肢出血斑
軽度咽頭期嚥下障害	嚥下障害	呼吸困難
舌根扁桃炎	扁桃炎	鼡径部腫脹
右肺上葉小細胞癌	上葉小細胞肺癌	巨大肝蛭感染症
ＣＭＶ網膜症	サイトメガロウイルス網膜炎	咽頭発赤
脊椎側弯症	脊柱側弯症	眼瞼良性腫瘤
悪心Ｇ１	悪心	下肢多発骨折
上腹部鈍痛	上腹部痛	眼瞼外傷性腫脹
脊髄視神経炎	視神経炎	陰茎部疼痛
本日血尿	血尿	胸膜播種
クラミジア頸管炎	クラミジア頚管炎	夜間呼吸困難
性急性リンパ性白血病	急性リンパ性白血病	副鼻腔異物
周囲リンパ節腫大	リンパ節腫大	肺動脈血栓塞栓症
印環細胞癌	癌	テント上下転移性腫瘍
６月肝転移	転移性肝腫瘍	膀胱癌
左内頸動脈中等度狭窄	頚動脈硬化症	咽頭部血腫
左外耳道閉鎖	外耳道閉鎖	腹部圧痛
右鼡径部ヘルニア	鼡径ヘルニア	しびれ感
ＭＬＦ症候群	核間性眼筋麻痺	異常脳波
醜形恐怖	醜形恐怖症	橈骨遠位端骨折
肩関節疼痛	肩関節痛症	結核性リンパ節炎
右手痺れ	上肢しびれ	直腸膀胱瘻
逆流感	胃食道逆流症	胸痛
播種性クリプトコックス症	播種性クリプトコッカス症	白内障
左尿管導管吻合部狭窄	吻合部狭窄	活動性肺結核
口唇落屑	皮膚落屑	水頭症
時折不整	不整脈	前頭葉膠芽腫
僧帽弁狭窄症兼閉鎖不全症	僧帽弁狭窄症	続発性ヘモクロマトーシス
伸筋腱脱臼	脱臼	腎梗塞
両下腿潰瘍	下腿皮膚潰瘍	下葉肺扁平上皮癌
内転障害	眼球運動痙攣	出血
びまん性リンパ腫	リンパ腫	嚥下痛
多発嚢胞腎	多発性のう胞腎	下腹痛
足首骨折	足関節骨折	排尿痛
右目白内障	白内障	眼窩蜂巣炎
嘔吐１回	嘔吐症	偽膜性腸炎
深夜低血糖	夜間低血糖症	逆流性食道炎
過敏症状	過敏症	小腸憩室症
高Ｂｉｌ血症	高ビリルビン血症	鼻中隔弯曲症
右足小指骨折	小指骨折	下顎部腫脹
第一腰椎破裂骨折	腰椎破裂骨折	前立腺上皮内腫瘍
せん妄発言	せん妄	椎間板性椎間孔狭窄症
ヒステリー症状	ヒステリー反応	大腿骨骨折
歩行時創部痛	術創部痛	自然骨盤位分娩
パニック	パニック障害	上腕骨顆部骨折
正色素性正球性貧血	正球性正色素性貧血	癌性リンパ管症
右足腫脹	足部腫脹	リウマチ反応陽性
両肺胸膜肥厚	胸膜肥厚	外陰部アポクリン腺癌
ＡＰＳ	抗リン脂質抗体症候群	腕頭動脈瘤
脳圧亢進症状	頭蓋内圧亢進症	胆石性膵炎
眼鏡　近視	近視	自閉性精神発達遅滞
二次性ヘモクロマトーシス	ヘモクロマトーシス	再発性胃潰瘍
潜在性副甲状腺機能低下症	副甲状腺機能低下症	主要大動脈肺動脈側副血行路
両眼瞼黄色腫	眼瞼黄色腫	不整脈
右内腸骨動脈狭窄	動脈狭窄	毛細血管拡張症
正中頚嚢胞	正中頚のう胞	背部痛
両側尿管結石	尿管結石症	脳梗塞
高血圧状態	高血圧症	前頭髄膜腫
喀血症状	喀血	皮膚腫瘍
指発赤	発赤	食欲不振
Ⅱａ型高脂血症	高脂血症	膝窩部痛
右手橈骨骨折	橈骨骨折	紅斑症
右睾丸痛	精巣痛	脳底動脈先端塞栓症
本日血便	血便	跛行
回腸出血	腸出血	除皮質硬直
左副腎出血	副腎出血	転移性肝癌
後頭蓋下髄膜腫	髄膜腫	黄熱
急性前壁中隔梗塞	急性前壁中隔心筋梗塞	膠原病
右顔面部帯状疱疹	顔面帯状疱疹	急性疼痛
びまん性管内増殖性糸球体腎炎	慢性びまん性管内増殖性糸球体腎炎	上葉肺癌
傍腹部大動脈リンパ節腫大	リンパ節腫大	仮性膵のう胞
左上腕脂肪腫	上腕脂肪腫	夜間呼吸困難
尿道口発赤	発赤	肺未分化癌
冠動脈狭窄症	冠状動脈狭窄症	気管支狭窄症
膵石灰化	膵石灰化症	足部浮腫
丘疹様	丘疹	尖足
肺上葉原発性肺癌	原発性肺癌	慢性関節炎
労作時胸部不快	労作時呼吸困難	本態性高体温症
２型＋ステロイド性糖尿病	ステロイド糖尿病	仙骨骨折
腫瘤縮小	腫瘤	急性間質性肺炎
Ｓａｌｍｏｎｅｌｌａ　ｅｎｔｅｒｉｔｉｄｉｓ敗血症	サルモネラ敗血症	三叉神経帯状疱疹
グル音異常	異常腸音	骨盤内リンパ節転移
鉄吸収障害	鉄欠乏症	皮下腫瘤
水中毒症状	水中毒	疼痛
鼻中隔彎曲	鼻中隔弯曲症	結核性胸膜炎
本日右眼白内障	白内障	上葉肺大細胞癌
過敏性腸症侯群	過敏性腸症候群	下肢血行障害
会話性幻聴	幻聴	頻脈性心房細動
筋疲労感	筋疲労	強膜拡張症
水疱後びらん	水疱症	四肢しびれ
胆管内結石	胆管結石症	錐体路障害
時々せん妄	せん妄	急性疼痛
処置後膵炎	膵炎	環指基節骨骨折
術後右反回神経麻痺	術後性反回神経麻痺	前方脱臼
反復性細菌感染	細菌感染症	特発性間質性肺炎
ｗｉｄｅ　ＱＲＳ頻拍	頻拍症	テント上下転移性腫瘍
両側性末梢性顔面神経麻痺	末梢性顔面神経麻痺	ＡＶＭ
皮膚軟部組織感染症	皮膚感染症	母指痛
腰痛ヘルニア	椎間板ヘルニア性腰痛症	皮膚損傷
イレウス合併	イレウス	白色便性下痢症
息苦しく	呼吸困難	ＣＡＲＡＳＩＬ
肺好酸球性肉芽腫	肺好酸球性肉芽腫症	錯味
無菌性腸炎	非感染性腸炎	肝腫瘤
骨盤内リンパ嚢腫	骨盤部感染性リンパのう胞	疲労感
両側眼瞼下垂症	眼瞼下垂症	骨棘
両側性結核性胸膜炎	結核性胸膜炎	犬糸状虫症
甲状腺機能亢進症状	甲状腺機能亢進症	運動ニューロン疾患
平坦Ｔ波	心電図異常	直腸閉鎖
ペーシング不全	両室ペーシング機能付き植込型除細動器不全	骨盤内リンパ節転移
後頭部打撲	頭部打撲	頭頂葉神経膠腫
薬剤性過敏症候群	薬剤性過敏症症候群	下顎頭骨折
両側喉頭肉芽腫	喉頭肉芽腫	脳幹梗塞
ふらつきあり	めまい	凝固因子欠乏症
右鼡径ヘルニア	鼡径ヘルニア	全身性浮腫
職業性ストレス	急性ストレス反応	特発性器質化肺炎
卵管水腫	卵管留水症	味覚消失
左下葉原発性肺扁平上皮癌	肺扁平上皮癌	片麻痺
外気胸	気胸	高血糖症
ポリープ数個	ポリープ	皮下結節
右低音障害型感音難聴	急性低音障害型感音難聴	下肺野陰影
外陰部血腫	外陰血腫	前腕腫脹
左乳突蜂巣炎	乳様突起炎	発赤
未破裂左内頸動脈瘤	内頚動脈瘤	頚部痛
中咽頭側壁扁平上皮癌	癌	多剤耐性腸球菌感染症
ＥＶＡＮＳ症候群	エバンス症候群	切迫早産
右聴神経腫瘍	聴神経腫瘍	意識障害
両肺多発結節性陰影	胸部異常陰影	持続痛
左血腫	血腫	悪性顆粒細胞腫
早期乳癌	乳癌	術中心室性不整脈
脾臓腫瘤	腫瘤	紫斑病
多発髄膜腫	多発性髄膜腫	動悸
術中出血多	多量出血	多発性下腿血管損傷
先天性嚢胞肺	先天性のう胞肺	大腿痛
手背部疼痛	手背部痛	側胸部痛
腹部大動脈嚢状瘤	腹部大動脈瘤	人為的甲状腺中毒症
腫瘍感染合併	腫瘍	排便習慣の変化
ＩＰ合併	間質性肺炎	下腿発赤
左腫瘤	腫瘤	足背腫脹
ゾメタ骨髄炎	骨髄炎	小指基節骨骨折
葉酸欠乏	葉酸欠乏症	側胸部痛
右胸膜原発血管肉腫	血管肉腫	急性胆管炎
拘縮気味	筋拘縮症	結節性紅斑
手関節圧痛	圧痛	徐脈発作
浮腫残存	浮腫	便失禁
非てんかん性心因性発作	てんかん	顔面痛
鼻口蓋管嚢胞	鼻口蓋管のう胞	全身性浮腫
下腸間膜動脈閉塞	腸間膜動脈塞栓症	膵のう胞
右中大脳動脈領域梗塞	中大脳動脈閉塞症	二次性血小板増加症
消化管腫瘤	腫瘤	胸部異常陰影
脛骨前面圧痕性浮腫	浮腫	小腸クローン病
多少眠気	非器質性過眠症	胃進行癌
高濃度腫瘤	腫瘤	喀痰
ＤＧＥ症状	消化管術後後遺症	脳血管障害
過形成性ポリープ	胃過形成ポリープ	早期血栓閉鎖型大動脈解離
日光アレルギー	光線過敏症	蜂窩織炎
両膝痛	膝関節痛	全身性浮腫
こわばりあり	こわばり	全身発疹
慢性炎症性腸疾患	腸炎	鼡径部リンパ節腫脹
尺骨頭脱臼	脱臼	上腕骨頚部骨折
けいれん症状	痙攣	構音障害
重度三尖弁閉鎖不全症	三尖弁閉鎖不全症	腫瘍
肺炎併発	肺炎	骨盤転移
右下肢感覚鈍麻	感覚異常症	悪寒
第二度房室ブロック	第２度房室ブロック	便潜血
慢性進行性肺アスペルギルス症	肺アスペルギルス症	総腸骨動脈狭窄
点状発赤	発赤	弓部大動脈瘤
白血病化	白血病	腰部脊柱管狭窄症
消退性発赤	発赤	気分異常
ヒステリー	ヒステリー反応	後出血
手指皮疹	発疹	心内血栓症
残尿	残尿感	大動脈周囲リンパ節転移
腫脹圧痛	圧痛	そう痒
ループスアンチコアグラント陰性	ループスアンチコアグラント	大腿部皮下出血
両肺気胸	気胸	頭部皮下出血
右肺胸水貯留	胸水貯留	脳動脈瘤破裂
血性吐物	吐血	便潜血
両側腓骨神経麻痺	腓骨神経麻痺	喉頭腫瘍
廃用	廃用症候群	腎周囲膿瘍
浮動感	めまい	下肢冷感
軽度右室肥大	右室肥大	結腸瘻
右膝蜂窩織炎	膝部蜂巣炎	洞不全症候群
強制換気	人工呼吸器装着状態	前胸部痛
２型＋ステロイド糖尿病	ステロイド糖尿病	不随意運動症
左下肢ガス壊疽	ガス壊疽	非結核性抗酸菌性股関節炎
低血糖用	低血糖	嘔気
喚語障害	不全失語症	帯状疱疹
右足底潰瘍	足底皮膚潰瘍	胼胝
右網膜静脈分枝閉塞症	網膜静脈分枝閉塞症	肺アスペルギルス症
腹痛時	腹痛症	ぶどう膜炎
多動多弁	多動性障害	下腿発赤
右手背浮腫	限局性浮腫	腋窩部痛
足趾しびれ	下肢しびれ	趾皮膚潰瘍
突然意識障害	意識障害	肝疾患
足底痺れ	しびれ感	外傷性大腿骨頭壊死
角膜ヘルペス	ヘルペス角膜炎	２型糖尿病性網膜症
食思不振症状	食欲不振	濾胞性リンパ腫
細菌性食道炎	食道炎	卵管留血腫
開大代謝性アシドーシス	代謝性アシドーシス	鎖骨上リンパ節転移
心因性過食症	心因性過食	過換気症
術後肺転移	転移性肺腫瘍	手指皮膚潰瘍
転移性腫瘤	転移性腫瘍	眼瞼瘻孔
夜間尿意	夜間頻尿症	続発性副腎皮質機能低下症
右下腿腫脹	下腿腫脹	甲状軟骨裂
背部皮脂欠乏性湿疹	皮脂欠乏性湿疹	褥瘡
足爪白鮮	足爪白癬	循環性抗凝血因子症
神経性疼痛	神経痛	卵巣のう腫破裂
房室接合部調律	異所性調律	マイコプラズマ肺炎
末梢循環不全徴候	末梢循環不全	破水
眼瞼下垂自覚	眼瞼下垂症	糖尿病性末梢神経障害
右上顎洞乳頭腫	上顎洞乳頭腫	顔面打撲傷
帯状疱疹拡大	帯状疱疹	下腿発赤
左尾状核ラクナ硬塞	ラクナ梗塞	下葉肺癌
ＳＭＡ閉塞	急性上腸間膜動脈閉塞症	転移性肺腫瘍
めまいの発作	めまい	水尿管症
呼吸切迫	急性呼吸窮迫症候群	チクチク感
劇症型連鎖球菌感染症	連鎖球菌感染症	肺放線菌症
腹部疝痛	仙痛	ＭＲＣＮＳ感染症
胆嚢多発ポリープ	胆のうポリープ	低形成腎
柑皮症	カロチン血症	腰椎側弯症
浮腫状	浮腫	眼球運動痙攣
陰部掻痒	外陰部そう痒症	不安障害
十二指腸多発びらん	十二指腸びらん	全身痛
前立性肥大症	前立腺肥大症	多趾症
嘔気状況	嘔気	鼡径部リンパ節腫脹
両側眼球外転障害	眼球運動障害	顕微鏡的血尿
元々浮腫	浮腫	肺動脈分岐部狭窄症
左小脳出血	小脳出血	アレルギー性浮腫
躁うつ	躁うつ病	便潜血
夜間失禁	尿失禁症	習慣性便秘
ベージェット病	ベーチェット病	腰椎圧迫骨折
元来頭痛	頭痛	上葉肺扁平上皮癌
褥瘡発生リスク低い	褥瘡	胆管閉塞症
下部直腸癌	直腸癌	後腹膜脂肪肉腫
両側総腸骨動脈狭窄	総腸骨動脈狭窄	肺門リンパ節転移
牽引痛	牽引性頭痛	乳房腫瘤
Ⅱ度熱傷	熱傷	片麻痺
重度感覚障害	体感異常	腋窩リンパ節転移
両側肺尖部進行性胸膜肥厚	胸膜肥厚	肺塞栓症
婦人入院脳梗塞	脳梗塞	鼡径部リンパ節腫脹
炎症性ポリープ多発	ポリープ	嘔気
右坐骨結節転移再発	転移性腫瘍	リンパ節腫大
ダンピング症候群併発	ダンピング症候群	脳梁離断術後
右上肢痺れ	しびれ感	非アルコール性脂肪性肝炎
ＭＣＴＤ	混合性結合組織病	リケッチア感染症
ループスアンチコアグラント陽性	ループスアンチコアグラント	肥厚性皮膚骨膜症
昨日水様便	下痢症	肺野円形陰影
気分不快増強	悪心	中毒
拡張期高血圧	高血圧症	多発性神経障害
右気管支肺炎	気管支肺炎	外傷性呼吸困難症
左頸部リンパ節腫大	薬剤性自己免疫性溶血性貧血	先天性甲状腺萎縮
右低音部感音難聴	感音難聴	逆流性食道炎
ＰＨＴ	肺高血圧症	悪寒
夜間失見当	見当識障害	発赤
劇症型髄膜炎菌感染症	髄膜炎菌感染症	しびれ感
物忘れ気	健忘症	鼡径部腫脹
両難聴	難聴	手関節痛
左腎細胞癌	腎細胞癌	顔面半側萎縮症
多発膵転移	転移性膵腫瘍	房室伝導障害
両眼白内障手	白内障	腎瘻
右手関節滑膜炎	滑膜炎	小腸穿孔
膠原病由来	膠原病	乳房よう
声門上喉頭癌	喉頭癌	オザルド糸状虫感染
右膝メルケル細胞癌	メルケル細胞癌	汗腺癌
右椎骨動脈起始部狭窄	椎骨動脈狭窄症	不整脈
加害妄想	妄想反応	ＣＲＨ産生腫瘍
嚢胞性胸腺腫	胸腺腫	膿性痰
急性乳突洞炎	急性中耳炎	低酸素血症
舌内リンパ節転移	リンパ節転移	内反足
悪性リンパ腫既往	悪性リンパ腫	温痛覚過敏
左肺下葉腫瘤影	肺腫瘤	心疾患
Ｌ３圧迫骨折	圧迫骨折	フィブリノゲン異常症
左感音性難聴	感音難聴	ビタミンＤ欠乏症
腎臓疾患	腎疾患	大動脈周囲リンパ節転移
ＣＯＰＤＩ期	慢性閉塞性肺疾患	食道良性腫瘍
転倒歴多数	よろめき歩行	肺門部異常陰影
ＤＩＨＳ	薬疹	頭部皮膚欠損創
夜勤帯下血	下血	仮性真珠腫
インスリン依存性糖尿病	１型糖尿病	アメーバ性肝膿瘍
頸部椎間板ヘルニア	頚椎椎間板ヘルニア	副甲状腺機能低下症
右眼網膜裂孔	網膜裂孔	血管新生緑内障
拍動性疼痛	疼痛	吸収不良症候群
下血増悪	下血	股関節骨折
ＤＭ性腎不全	糖尿病性腎不全	大腿静脈血栓症
膝関節軽度屈曲拘縮	屈曲拘縮	異物誤嚥
ＡＴＬ	成人Ｔ細胞白血病リンパ腫	痙攣
肺動脈弁閉鎖不全	肺動脈弁閉鎖	神経鞘腫
熱感軽度	ほてり	癌
重度不眠	不眠症	深昏睡
咀嚼困難感	咀嚼障害	ＣＡＤ／ＣＡＭ冠破損
食道圧迫	食道圧迫症	縦隔リンパ節腫脹
両足関節痛	足関節痛	腫瘤
術後肝転移	転移性肝癌	全身性浮腫
朝低血糖	低血糖	特発性血小板減少性紫斑病
喘息疑い	咳喘息	アニサキス幼虫感染症
顔皮疹	発疹	失認
子宮筋腫有	子宮筋腫	腹水症
淡明細胞型腎細胞癌	腎細胞癌	前立腺癌
浮腫生	浮腫	ＭＥＲＲＦ症候群
再出血徴候	出血	胆管腫瘍
アシネトバクター敗血症	敗血症	直腸皮膚瘻
左自然気胸再発	自然気胸	中枢神経ループス
高度肥満２型糖尿病	２型糖尿病	骨壊死
右大腿骨骨肉腫	大腿骨骨肉腫	顎関節症
左腎盂腎炎治癒後	腎盂腎炎	大腿内側部痛
二次性水頭症	外傷後水頭症	仮声帯癌
ダグラス窩播種	腹膜播種	大腿有棘細胞癌
左室拡張能低下	左室不全	レム睡眠行動障害
ウィルス感染症	ウイルス感染症	増殖性糖尿病性網膜症
左手尺骨神経麻痺	尺骨神経麻痺	直腸癌
周期性呼吸時折	周期性呼吸	糞便性嘔吐
異常帯下	帯下	頭部血腫
多発性大腸ポリープ	大腸ポリープ	アレルギー性結膜炎
糖尿病用	糖尿病	腹膜播種
術前心電図異常	心電図異常	洞頻脈
中耳炎症状	中耳炎	よろめき歩行
脱力症状	脱力感	破壊性関節炎
上半身掻痒感	そう痒	開口障害
動揺性めまい	めまい	頬部血管腫
褥瘡発生歴	褥瘡	内鼡径ヘルニア
水分摂取困難	嚥下障害	鼡径部腫脹
趾爪囲炎	爪囲炎	ループス腎炎
右下葉原発低分化腺癌	癌	股関節脱臼
挙上期誤嚥	異物誤嚥	大腿静脈血栓症
腹部膨満増強	腹部膨満	呼吸困難
右副腎腫瘍摘出術	副腎腫瘍	肺門リンパ節腫脹
右鎖骨痛	鎖骨痛	縦隔リンパ節腫脹
細菌性扁桃炎	扁桃炎	上肢浮腫
左歯性上顎洞炎	歯性上顎洞炎	基礎代謝率異常
重度歯周病	歯周症	水腎症
正常圧緑内障	緑内障	排尿痛
梗塞後出血	出血性脳梗塞	顔面紅潮
骨髄異型性症候群	骨髄異形成症候群	発熱
光線過敏	光線過敏症	足関節痛
副睾丸炎	精巣炎	急性ＨＩＶ感染症候群
虚脱病変	虚脱	口腔粘膜下気腫
慢性アレルギー性鼻炎	季節性アレルギー性鼻炎	腎動脈瘤
肘痛	肘関節痛	異常心陰影
夕食前低血糖	低血糖	骨異栄養症
先天性代謝異常症	代謝障害	末梢性肺動脈狭窄症
単頸双角子宮	双角子宮	膀胱癌
原発性肺高血圧症	肺高血圧症	発赤
左眼加齢性黄斑変性症	加齢黄斑変性	頭部外傷
左鎖骨リンパ節転移	リンパ節転移	膿性痰
殿部色素沈着	色素異常症	陳旧性小脳梗塞
舌浮腫	浮腫	体力低下
ストレス性潰瘍	ストレス潰瘍	転移性腎腫瘍
舌損傷	損傷	化膿性関節炎・肩関節
発熱下	発熱	下肢浮腫
失見当識発言	見当識障害	大腸腺腫内癌
右眼内悪性リンパ腫	眼窩悪性リンパ腫	原発閉塞隅角緑内障
腹部大動脈狭窄	大動脈狭窄症	子宮頚部腫瘍
右季肋部自発痛	季肋部痛	自律神経性ニューロパチー
軽度痺れ	しびれ感	再発性脳梗塞
星芒状血管腫	血管腫	紅皮症
右房内腫瘤	腫瘤	点状出血
Ｓ状結腸転移	転移性消化器腫瘍	夜間呼吸困難
全身掻痒感	そう痒	胎児水腫
右手舟状骨骨折	手舟状骨骨折	手指こわばり
肉芽腫性腸疾患	腸疾患	転移性肝癌
両足圧痕性浮腫	浮腫	胸膜炎
発作後精神病	精神病	遊走性血栓性静脈炎
虫垂粘液嚢胞腺腫	虫垂粘液のう胞	てんかん様発作
四肢水疱	水疱症	仙骨部奇形
右足趾骨髄炎	趾骨髄炎	多発性肝のう胞
若年性リウマチ	関節リウマチ	気分異常
体陽性脳炎	脳炎	心臓腫瘍
境界域ＤＭ	糖尿病	胸腺カルチノイド
結節性不整脈	不整脈	椎間板変形
劇症敗血症	敗血症	貧血網膜症
慢性血腫	血腫	出血傾向
骨破壊病変	関節リウマチ	脊髄圧迫症
眼窩部痛	眼痛	胃進行癌
昨日不眠	不眠症	下肢急性動脈閉塞症
頚椎脊柱管狭窄症	頚部脊柱管狭窄症	心膜石灰化
発赤域	発赤	筋肉痛
膵頭部転移	転移性膵腫瘍	羊水過多症
高度肝障害	肝障害	肺塞栓症
右肺下葉腫瘍	肺腫瘍	咽頭痛
口腔内発赤腫脹	発赤	テント上下転移性腫瘍
中咽頭再発腫瘍	咽頭腫瘍	腰部血管腫
左下肢冷感	下肢冷感	子宮頚管ポリープ
大腫瘍	腫瘍	大腸癌
胸骨肋骨転移	肋骨転移	発赤
重症心身障害児	重症心身障害	悪性腫瘍
腹部軽度膨隆	腹部膨満	体感異常
リンパ管症	癌性リンパ管症	咽喉頭異常感症
遷延性抑うつ状態	うつ状態	ＬＧＬ症候群
結核性強膜炎	結核性胸膜炎	Ｃ型慢性肝炎
下腿筋萎縮	筋萎縮症	起立性眩暈
膵頭癌	癌	夜間低血糖症
ＶＡＨＳ	ウイルス関連血球貪食症候群	手掌紅斑
圧痛自発痛	圧痛	後鼻孔ポリープ
痰中等量引ける	喀痰	喉頭結核
放射線障害	放射線宿酔	発熱
浅眠	不眠症	心筋虚血
反射異常	異常反射	小腹硬満
慢性間質性腎炎	慢性尿細管間質性腎炎	蜂窩織炎
脳溢血	脳卒中	下肢痛
右下肢深部静脈血栓症	下肢静脈血栓症	Ｂ型急性肝炎
カテーテル感染	カテーテル感染症	典型的前兆に頭痛を伴う片頭痛
腫瘍多発	腫瘍	糖尿病性末梢神経障害
背部筋緊張高い	筋強直	脳血管障害
全身紅斑	紅斑症	内反歩行
しびれてる感	しびれ感	先天性気管支拡張症
少量尿失禁	尿失禁症	線維形成性小円形細胞腫瘍
脳腫瘍切除	脳腫瘍	Ｂ型肝硬変
右側下顎骨体部骨折	下顎骨骨折	卵巣胚細胞腫瘍
高血糖是正	高血糖症	色素性紫斑
腫瘤拡大	腫瘤	腹膜癒着
病原性大腸菌	病原性大腸菌感染症	肺腫瘤
耳小骨奇形	耳小骨の先天奇形	四肢発疹
全身性紫斑	全身性紫斑病	異物誤嚥
微小多発脳梗塞	多発性脳梗塞	陳旧性アテローム血栓性脳梗塞
右股関節亜脱臼	股関節亜脱臼	結核性リンパ節炎
糸球体血尿	血尿	後頭部帯状疱疹
左橈骨神経麻痺	橈骨神経麻痺	大腸ポリープ
全身性間代性痙攣	間代性痙攣	アメーバ性脳膿瘍
右肋間痛	肋間痛	アレルギー
右続発性緑内障	続発性緑内障	慢性中耳炎
軟骨腫	骨軟骨腫	小脳血管芽腫
開大性代謝性アシドーシス	代謝性アシドーシス	脱水症
パニック様症状	全般性不安障害	項背部筋痛
胆嚢充満結石	胆のう結石症	顔面せつ
左上葉肺転移	転移性肺腫瘍	皮膚損傷
軽度しびれ感	しびれ感	多発性外傷
意識レベル低	意識障害	頚椎症
爪囲紅斑	爪囲炎	硬膜損傷
子宮頸癌Ｉｂ１期	子宮頚癌	悪性胸膜中皮腫
感覚性運動失調	運動失調	脳手術後遺症
両側鎖骨上窩リンパ節腫大	リンパ節腫大	横隔膜欠損
中枢性めまい	中枢性めまい症	めまい症
関節滑膜炎	滑膜炎	発疹
続発性膜性腎症	膜性腎症	敗血症性ショック
立位保持困難	四肢筋力低下	原発性肺癌
先天性風疹症侯群	先天性風疹症候群	パーキンソン症候群
左足痺れ	しびれ感	ＥＳＢＬ産生菌感染症
Ｒｉｅｄｅｌ甲状腺炎	線維性甲状腺腫	副腎のう胞
椎骨動脈狭窄	椎骨動脈狭窄症	肋軟骨損傷
活動性肺結核症	活動性肺結核	胆道閉塞
鼻腔化膿性肉芽腫	細菌性肉芽腫症	ＡＩＤＳ
痙攣発作再発	痙攣発作	子宮筋層内妊娠
右脛骨内果骨折	足関節内果骨折	肺動脈狭窄症
左胸膜転移	胸膜播種	色素性紫斑
卵巣腫瘍再発	卵巣腫瘍	ＱＴ延長症候群
右肺中葉転移	転移性肺癌	薬剤性過敏症症候群
下腿筋痛	下肢筋肉痛	老人性紫斑
右大腰筋血腫	血腫	頚部痛
十二指腸潰瘍再発	慢性十二指腸潰瘍	慢性咳嗽
Ａｆ不変	心室細動	腎尿管結石
左下腿部帯状疱疹	帯状疱疹	ＭＲＳＡ感染症
顔面麻痺１	顔面神経麻痺	悪性リンパ腫
巨大腫瘤	腫瘤	中枢性顔面神経麻痺
右足関節腫脹	足関節腫脹	浮腫
外陰部湿疹	湿疹	頻尿症
両肺副雑音	胸部音異常	萎縮性瘢痕
腎機能異常	腎機能検査異常	肩関節痛症
姿勢障害	姿勢異常	発熱
左肘頭開放骨折	開放骨折	不定愁訴症
イレウス発生	イレウス	食道癌
若干硬結	硬結	原発性肺ペスト
左骨盤内リンパ嚢胞	骨盤部感染性リンパのう胞	腎損傷
発作性３度房室ブロック	第３度房室ブロック	急性間質性肺炎
身体損傷	損傷	敗血症性ショック
右大腿骨骨腫瘍	大腿骨腫瘍	胸椎後縦靱帯骨化症
慢性胆嚢炎	慢性胆のう炎	毛細血管拡張症
偽性高Ｋ血症	高カリウム血症	ＣＡＲＡＳＩＬ
反応性胸水	胸水貯留	気管支リンパ節転移
元々痛み	疼痛	単クローン性軽鎖重鎖沈着症
骨盤内膜症	骨盤子宮内膜症	仙骨部褥瘡
右耳下腺腫瘤	耳下腺腫瘤	延髄梗塞
肝形質細胞腫	形質細胞腫	頚椎症性脊髄症
躁病相	躁状態	横隔膜腫瘤
易出血傾向	出血傾向	発赤
ジューリング疱疹状皮膚炎	ジューリング病	皮質認知症
末梢発赤	発赤	口内炎
部分性脂肪萎縮症	部分的脂肪萎縮症	足部浮腫
亜急性脊髄連合変性症	亜急性連合性脊髄変性症	悪性リンパ腫骨髄浸潤
副腎偶発腫	良性副腎皮質腫瘍	原発性肺癌
右下腿紅斑	紅斑症	膝蓋骨不顕性骨折
腸管通過障害	消化管狭窄	先天性貧血
努力様呼吸	起坐呼吸	両側水腎症
膿疱形成	膿疱	低血糖
左卵巣膿瘍	卵巣膿瘍	視野欠損
発赤皮疹	発疹	味覚異常
赤痢アメーバ大腸炎	アメーバ赤痢	急性副鼻腔蓄膿症
サイトメガロウイルス感染	サイトメガロウイルス感染症	肺線維症
Ｇｒａｄｅ　３肝障害	肝障害	ＨＤＬＳ
低ＡＬＢ血症	低アルブミン血症	気管支狭窄症
Ⅱ型糖尿病	２型糖尿病	陳旧性母指側副靱帯損傷
両顎関節痛	顎関節痛	高熱
逆流性胆管炎	逆行性胆管炎	項部硬直
関節痛症状	関節痛	子宮頚部癒着
空気塞栓	空気塞栓症	不規則睡眠
肝膿瘍破裂	肝膿瘍	急性腎前性腎不全
総肺静脈還流異常症	肺静脈還流異常症	高ＨＤＬ血症
両下腿痛	下腿痛	手掌紅斑
左橈骨頭脱臼骨折	脱臼骨折	構音障害
正中創感染	創傷感染症	肺腫瘍
左網膜分枝動脈閉塞症	動脈閉塞症	壊死性筋膜炎
頸部浮腫	浮腫	虚血性心疾患
肺扁平上皮癌、病期不明	肺扁平上皮癌	傍矢状洞髄膜腫
低血圧自覚症状	低血圧症	出血傾向
常時痛み	疼痛	血栓塞栓症
倦怠感増	倦怠感	便異常
脾臓腫瘍	脾腫瘍	内転歩行
多発肝転移増大	転移性肝癌	瘢痕
頸部食道狭窄	食道狭窄	ＭＲＳＡ腸炎
陰茎アポクリン癌	陰茎アポクリン腺癌	腸骨リンパ節転移
元来月経痛	月経痛	胸水貯留
胆嚢十二指腸瘻	胆のう十二指腸瘻	十二指腸神経内分泌腫瘍
特発性肺胞出血	肺胞出血	血腫
左鼠径部疼痛	鼡径部痛	脳炎後てんかん
左側頬粘膜癌	頬粘膜癌	嚥下困難
円盤状皮疹	円板状エリテマトーデス	術中低血圧
左手首疼痛	手部痛	腰椎側弯症
アレルギー反応	アレルギー	褥瘡・ＤＴＩ
夜間痙攣	痙攣	腸管運動障害
膵体部小嚢胞	腫瘍性膵のう胞	好酸球性気管支炎
耳介脂漏性湿疹少	脂漏性皮膚炎	一側性形成不全性股関節症
両側急性硬膜下出血	急性硬膜下血腫	前立腺小細胞癌
毎回尿失禁	尿失禁症	側胸部痛
喉頭蓋腫脹	喉頭蓋炎	リンパ節腫大
愁訴	不定愁訴症	ウイルス感染症
血腫不変	血腫	頚部膿瘍
各種膠原病	膠原病	肩部痛
肺気胸	気胸	脱水を伴う妊娠悪阻
深部感覚鈍麻	感覚異常症	腫瘤
脊柱圧痛	圧痛	趾擦過創
亜脱臼傾向	亜脱臼	ステロイド性骨粗鬆症
自傷痕	自傷	腹壁瘢痕ヘルニア
嘔吐持続	嘔吐症	出血
痙攣重積後脳症	痙攣重積型二相性急性脳症	喀痰喀出困難
小腸大腸型	小腸大腸クローン病	陰のう腫大
薬剤肝障害	薬物性肝障害	下垂足
転移性膵体部癌	膵体部癌	痙攣陣痛
左前頭葉神経膠腫	前頭葉神経膠腫	咽頭発赤
精神運動興奮	精神運動興奮状態	手指欠損症
インフルエンザＡ型感染症	インフルエンザＡ型	脳静脈奇形
紅斑反応	紅斑症	大腿部皮下出血
右尿管結石症	尿管結石症	発達遅滞
瞳孔不同	瞳孔不同症	下肢麻痺
多発肝転移巣	転移性肝腫瘍	大腿部蜂巣炎
顕微鏡的大腸炎	大腸炎	汗疹湿疹化
直腸Ｒａ癌	直腸癌	家族性腎炎
原発性アルドステロン	原発性アルドステロン症	Ｃ型非代償性肝硬変
苔癬局面	苔癬	環指基底細胞癌
足趾爪混濁肥厚	ころもじらみ寄生症	慢性疼痛
ＣＭＶ肺炎	サイトメガロウイルス肺炎	出血性黄体のう胞
右ＩＣＡ狭窄	内頚動脈狭窄症	顎関節症
痰貯留	喀痰	膝部腱膜炎
足趾蜂窩織炎	足蜂巣炎	腹部膨満
僧帽弁狭窄兼逆流症	僧帽弁狭窄症	上腕骨開放骨折
中背部悪性黒色腫	背部悪性黒色腫	皮質脳内出血
歯槽膿漏	歯周炎	嘔気
左肘関節破壊	関節リウマチ・肘関節	間質性肺炎
副甲状腺亢進症	副甲状腺機能亢進症	腎炎
右声帯不全麻痺	声帯不全麻痺	労作時呼吸困難
心合併症	心臓合併症	多形紅斑
皮下石灰化	皮膚石灰沈着症	痙性四肢麻痺
薬剤性発熱	発熱	大動脈周囲リンパ節転移
労作時前胸部痛	前胸部痛	真珠腫性中耳炎
肺炎等	肺炎	結核性腹膜炎
軽度ＡＤＨＤ	注意欠陥多動障害	脂漏性皮膚炎
新生児一過性多呼	新生児一過性多呼吸	下肢しびれ
両心房拡大	心肥大	睡眠時無呼吸症候群
上転障害	眼球運動障害	ループス腎炎
不眠状態	不眠症	よろめき感
プレクリニカルクッシング症候群	クッシング症候群	アレルギー
左胸鎖乳突筋炎	胸鎖乳突筋炎	大腿骨骨幹部骨折
腫瘍性	腫瘍	自己免疫性胆管炎
時々関節痛	関節痛	進行乳癌
嫌悪感	悪寒	月経困難症
二次性僧帽弁閉鎖不全症	僧帽弁閉鎖不全症	腹壁瘢痕ヘルニア
急性大動脈弁閉鎖不全	大動脈弁閉鎖不全症	関節水腫
左心肥大	心肥大	足部変形
腹痛嘔気	嘔気	趾皮膚潰瘍
前頭部打撲	頭部打撲	多部位リンパ節転移
左大腿部骨外性粘液型軟骨肉腫	軟骨肉腫	肺性呼吸困難
高度異形成相当	子宮頚部高度異形成	ＩＣＵ症候群
腹緊なし	腹部膨満	慢性閉塞隅角緑内障
右頚部ＬＮ腫大	リンパ節腫大	低血糖
側卵巣嚢腫	卵巣のう腫	症候性てんかん
哺乳後嘔吐	嘔吐症	異所性乳癌
右結石性腎盂腎炎	結石性腎盂腎炎	発酵性下痢
Ｃｒｏｎｋｈｉｔｅ−Ｃａｎａｄａ症候群	クロンカイト・カナダ症候群	腓骨開放骨折
心嚢液貯留	心膜液貯留	低髄液圧症
臓器限局性前立腺癌	限局性前立腺癌	咽頭腐蝕
貧血傾向	貧血	肺塞栓症
右中大脳動脈梗塞	内頚動脈塞栓症	蜂窩織炎
日中傾眠	傾眠症	破壊性関節炎
脾臓結核	結核	蜂窩織炎
食後高血糖	高血糖症	急性大動脈解離
高浸透圧血症	高血糖高浸透圧症候群	卵管狭窄症
両下肢軽度浮腫	下肢浮腫	多発性肝膿瘍
右間歇性跛行	間欠性跛行	ＢＬＮＡＲ感染症
陰嚢ヘルニア	陰のうヘルニア	腓腹部痛
多形紅斑型薬疹	薬疹	ＨＤＬＳ
右腋窩リンパ節腫脹	腋窩リンパ節腫脹	肺炎球菌性関節炎
静脈内腫瘍栓	腫瘍	大腿横紋筋肉腫
爪甲剥離症	爪剥離症	内頚動脈狭窄症
再度急性腎不全	急性腎不全	ＣＡＲＡＳＩＬ
進行再発大腸癌	大腸癌	骨パジェット病
胃接合部癌	胃癌	浮腫
耳閉塞感	耳閉感	二絨毛膜二羊膜性双胎
手足しびれ	しびれ感	排便後出血
内膜損傷	損傷	肝性脳症
胃小彎側ＬＮ転移	胃周囲リンパ節転移	高ＨＤＬ血症
軽度発達遅滞	発達遅滞	水疱性類天疱瘡
非浸潤性膀胱癌	膀胱癌	胸水貯留
右先天性耳瘻孔	先天性耳瘻孔	上腕部腫脹
脂肪腫摘出	脂肪腫	増殖性糖尿病性網膜症
椎間板ヘルニア有	椎間板ヘルニア	ＣＡＲＡＳＩＬ
扁平ポリープ	ポリープ	Ａ型劇症肝炎
咽頭知覚障害	咽頭異常感症	無汗症
腸液貯留	体液貯留	転移性肝癌
両変形性膝関節症	変形性膝関節症	肺動脈弁狭窄症
急性胆嚢胆管炎	胆管炎	深昏睡
扁平上皮癌	癌	皮膚壊死
内痔核脱出	内痔核	慢性神経痛
びまん性脳浮腫	脳浮腫	上腕骨近位端骨折
呼気困難	呼吸困難	心原性脳塞栓症
重症鬱血性心不全	うっ血性心不全	頭部外傷
大腸早期癌	大腸癌	脳梗塞
喘鳴聴取	喘鳴	甲状腺未分化癌
左乳癌特	乳癌	腓骨神経麻痺
Ａ型溶連菌感染症	溶連菌感染症	全身違和感
悪性副腎外褐色細胞腫	褐色細胞腫	非アトピー性喘息
傍隔壁型肺気腫	肺気腫	多発性小脳梗塞
角膜糜爛	角膜びらん	胃周囲リンパ節転移
骨盤内播種新生	骨盤転移	頚肩腕症候群
急性非代償性心不全	心不全	タングクリブ不適合
最近便秘	便秘症	母子感染
右頬部痛	頬部痛	緑膿菌感染症
右肺動静脈瘻	肺動静脈瘻	ＡＩＤＳ
１型高ウイルスＣ型慢性肝炎	Ｃ型慢性肝炎	股関節痛
問題なし膀胱直腸障害	膀胱直腸障害	血管拡張性環状紫斑症
Ｌｉｓｔｅｒｉａ腸炎	細菌性腸炎	肝腫瘤
右膿胸	膿胸	傍卵巣のう胞
ヒリヒリ感	疼痛	子宮頚部微小浸潤癌
時折胸痛	胸痛	眼瞼結膜出血
大動脈弁下心室中隔欠損	心室中隔欠損症	背部圧迫感
右傍矢状静脈洞髄膜腫	髄膜腫	脳底動脈閉塞症
無自覚性低血糖	低血糖	腸骨動脈血栓症
両側卵管留血腫	卵管留血腫	足関節腫脹
脱水注意	脱水症	マルチコア病
心尖部型肥大型心筋症	肥大型心筋症	外傷性脳内血腫
右飛蚊症	飛蚊症	肥満症
腎不全保存期	腎不全	骨形成不全症２型
口腔内炎	口内炎	帯状疱疹
びまん性大細胞	びまん性大細胞型Ｂ細胞性リンパ腫	斑状皮疹
大うつ病	単極性うつ病	ＨＴＬＶ−１感染症
肝門部悪性リンパ腫	肝門部リンパ節転移	ウイルス脊髄炎
精神病性うつ病	うつ病	乳頭腺管癌
水疱性類天疱	水疱症	高ＬＤＬ血症
中枢性低換気	換気量減少	慢性疼痛
右膝ＡＣＬ損傷	前十字靱帯損傷	小細胞肺癌
全身倦怠感軽度	全身倦怠感	ＭＲＳＡ感染症
混合難聴	難聴	結核
毛孔一致性丘疹	丘疹	多発性海綿状血管腫
先天性巨大色素性母斑	巨大母斑細胞母斑	下肢痛
不安大	不安障害	背部痛
胸骨下液体貯留	体液貯留	頬部腫脹
新出肺転移	転移性肺腫瘍	Ｓ状結腸癌
左聴器癌	癌	心サルコイドーシス
多発脳神経障害	多発性脳神経障害	水晶体脱臼
上腹部リンパ節転移	リンパ節転移	限局性強皮症
被殻梗塞	被殻出血	２型双極性障害
直腸Ｒａｂ癌	直腸癌	正球性正色素性貧血
軽度高血糖	高血糖症	ＨＤＬＳ
本日硬便少量	便異常	足背痛
２型腫瘤	腫瘤	肺門部非小細胞癌
右腎無形成	腎無形成	インフルエンザ菌感染症
リンパ節圧痛	圧痛	慢性後天性赤芽球ろう
全身性細菌感染症	細菌感染症	肺胞出血
脳髄膜瘤	髄膜脳瘤	手関節痛
水頭症症状	水頭症	蛋白尿
小血栓	血液凝固異常	変形性手関節症
右耳失聴	聴覚消失	発赤
統合失調症合併	統合失調症	単純性腎のう胞
胃痛症状	胃痛	肥満症
急性期ＨＩＶ感染症	ＨＩＶ感染症	術後胆管狭窄
右下肢運動障害	四肢運動障害	唾石症
炎症性脱髄性多発根神経炎	慢性炎症性脱髄性多発神経炎	湿疹
上行結腸腫瘤	腫瘤	偽黄色腫
過食症状	過食症	出血
疾病不安	不安障害	血気胸
肺癌手術	肺癌	膵体部癌
色素脱失	炎症後色素脱失	前胸部痛
膿貯留	膿瘍	中頭蓋窩髄膜腫
片側副腎腫瘍	副腎腫瘍	高レニン性高血圧症
リンパ節腫脹	リンパ節腫大	急性硬膜外血腫
右椎骨動脈巨大血栓化動脈瘤	椎骨動脈瘤	先天性声門下狭窄症
カテ感染	カテーテル感染症	結核
安心感	心気症	皮膚サルコイドーシス
左鼡径ヘルニア再発	鼡径ヘルニア	肺腺扁平上皮癌
胃食道静脈瘤破裂	食道静脈瘤破裂	子宮頚部びらん
左足背蜂窩織炎	足背蜂巣炎	咽頭出血
右胸水貯留	胸水貯留	末期癌
暗青色斑	青色母斑	反復性膝蓋骨脱臼
ＨＣＶ陽性	Ｃ型肝炎ウイルス感染	水晶体亜脱臼
疲労感生	疲労感	つかえ感
感染性静脈血栓症	静脈血栓症	非浸潤性乳管癌
両側腎腫大	腎腫大	脳梗塞
過敏性膀胱炎	膀胱炎	腹圧性尿失禁
包交時出血	出血	喉頭下垂症
右坐骨骨折	坐骨骨折	腹部膨満
右耳下腺腫脹	耳下腺腫脹	血管免疫芽球性Ｔ細胞リンパ腫
進行肺癌	肺癌	縦隔血腫
肋骨起始部骨転移	肋骨転移	中葉肺癌
外傷性変化	外傷	冠状動脈硬化症
中等度精神遅滞	中等度知的障害	膿性痰
先天性左股関節脱臼	先天性股関節脱臼	腹膜播種
リポフスチン沈着	神経セロイドリポフスチン症	心室内血栓症
鮮血痰	血痰	適応障害
壊死性変化	壊死	慢性疼痛
溶連菌感染	溶連菌感染症	腸アメーバ症
局所発赤	発赤	冠動脈石灰化
不整脈チーム	不整脈	ＨＩＶヘルペスウイルス感染症
中等度ＣＯＰＤ	慢性閉塞性肺疾患	発赤
胸部圧痛	圧痛	脳血管障害
両上肢痛	上肢痛	膿性痰
気分不快症状	悪心	体液貯留
右上腕骨近位端粉砕骨折	上腕骨近位端粉砕骨折	呼吸困難
乳突蜂巣	乳様突起炎	指尖難治性皮膚潰瘍
褥創形成	褥瘡	筋緊張性障害
ガマ腫	がま腫	腎梗塞
膀胱腫瘍再発	膀胱腫瘍	自閉性精神発達遅滞
夜間せん妄状態	せん妄	チョコレートのう胞
神経系腫瘍	腫瘍	空腸癌
クッシング徴候	クッシング症候群	末梢循環障害
先天性側弯	肋骨異常を伴う先天性側弯症	ＨＩＶ非ホジキンリンパ腫
非定型抗酸菌肺炎	肺炎	ラテックスアレルギー
軽度甲状腺腫大	甲状腺腫	ＫＲＡＳ遺伝子野生型直腸癌
手足痺れ	四肢しびれ	腫瘤
節外性濾胞辺縁帯リンパ腫	脾辺縁帯リンパ腫	白内障術後
左下葉肺癌	下葉肺癌	巨大子宮筋腫
Ｋｌｅｂｓｉｅｌｌａ　ｐｎｅｕｍｏｎｉａｅ敗血症	新生児クレブシエラ敗血症	肩甲骨痛
若年性認知症	認知症	上肢腫脹
外腸骨域リンパ節腫大	リンパ節腫大	グラム陰性桿菌感染症
貧血高度	貧血	若年性パーキンソン病
腰部腫瘍	腰椎部腫瘍	顎部腫瘤
鼠径ヘルニア	鼡径ヘルニア	頻脈症
分化型管状腺癌	癌	肺門部異常陰影
侵襲性肺アスペルギウス症	侵襲性肺アスペルギルス症	右室低形成
孤発性ＣＪＤ	孤発性クロイツフェルト・ヤコブ病	慢性下痢症
右下葉結節影	胸部異常陰影	ビタミンＤ過剰症
軽度左軸偏位	心電図左軸偏位	嚥下障害
左頚部結核性リンパ節炎	結核性リンパ節炎	顎下腺多形腺腫
食道がん	食道癌	片側痛覚過敏
肛門部発赤	発赤	軸椎骨髄炎
脳室拡大進行	脳室拡大	乳癌再発
下腿潰瘍	下腿皮膚潰瘍	肺動脈弁下狭窄症
小脳転移	転移性脳腫瘍	舌痛症
腎盂軽度拡張	腎盂拡張	声帯不全麻痺
腫瘍指摘	腫瘍	圧痛
心臓原発性悪性リンパ腫	心臓悪性リンパ腫	良性発作性頭位めまい症
準夜帯嘔気	嘔気	皮膚色素沈着
成人Ｓｔｉｌｌ病	成人スチル病	徐脈性不整脈
脳血管疾患	脳血管障害	痙攣発作
左膝窩部痛	膝窩部痛	多臓器不全
非浸潤性尿路上皮癌	尿管尿路上皮癌	外傷性腎梗塞
下咽頭がん	下咽頭癌	眼窩腫瘤
両上肢痺れ	上肢しびれ	子宮発育不全
混合性肝癌	肝癌	急性肺炎
甲状腺痛	甲状腺炎	発熱
少量血便	血便	出血
脳梗塞有	脳梗塞	解離性大動脈瘤
痕発赤	発赤	肝腫瘤
不消化便	消化不良性下痢	認知症
末梢性めまい	めまい症	ＳＡＰＨＯ症候群
左上腕骨肉腫	上腕骨骨肉腫	脳外主幹動脈閉塞脳梗塞
四肢型運動失調	運動失調	胃びらん
産生胃癌	胃癌	胆管腫瘍
下肢冷感軽度	下肢冷感	前立腺肥大症
左室内同期不全	左室不全	縦隔炎
左脛腓骨骨折	腓骨骨折	尿路感染症
漿液性腺腫	卵巣漿液性腺腫	耳介欠損
日本海裂頭条虫	日本海裂頭条虫症	高度難聴
先天性脳血管異常	脳動静脈奇形	早期血栓閉鎖型大動脈解離
臀部皮疹	発疹	紫斑病
歩行時軽度跛行	跛行	上腕浮腫
心室中隔扁平化	心室中隔欠損症	転移性肝癌
フルニエ壊疽	外陰部壊死性筋膜炎	小脳梗塞
肝芽腫再発	肝芽腫	多部位リンパ節転移
状血管腫	血管腫	意識消失
卵巣癌破裂	卵巣癌	続発性血小板減少性紫斑病
右下腿疼痛	下腿痛	上行結腸癌
軽度眼球突出	眼球突出症	上部胆管癌
前頭葉障害	前頭葉症候群	一次性頭痛
歯牙損傷	切歯破折	肺野円形陰影
両側乳糜胸水	胸水貯留	閉鎖性胸部気管損傷
肺門部リンパ節腫大	肺門リンパ節腫脹	子宮内膜間質肉腫
麻疹罹患歴	麻疹	静脈炎後症候群
尿漏れ	尿失禁症	不整脈
心膜播種	腹膜播種	血腫
髄液播種	腹膜播種	頭痛
左腎動脈狭窄症	腎動脈狭窄症	ＰＣＷＨ
体動時創部痛	術創部痛	踵骨骨折
後頭部皮下血腫	頭部皮下血腫	骨髄機能低下
ＭＲＳＡ菌血症	ＭＲＳＡ感染症	外陰炎
篩骨蜂巣	篩骨洞炎	悪性グロームス腫瘍
左退形成性星細胞腫	退形成性星細胞腫	皮膚腫瘍
仮性動脈瘤切除	偽性動脈瘤	内頚動脈眼動脈分岐部動脈瘤
鼻中隔血腫	血腫	Ａ型劇症肝炎
左嗅裂ポリープ	ポリープ	右室低形成
労作時疲労	疲労感	肝細胞癌
不定愁訴多	不定愁訴症	糖尿病性末梢神経障害
軽度失調性構音障害	構音障害	大腿骨骨幹部骨折
びらんからの出血	出血	そう痒
動揺性精神神経症状	神経症	尿管結石症
過呼吸気味	過換気症	先天性腎性尿崩症
真菌性感染性心内膜炎	細菌性心内膜炎	上腹壁ヘルニア
気道狭窄音	気道狭窄	血痰
未分類関節炎	関節炎	しびれ感
左視床出血	視床出血	先天性水腎症
骨突出部発赤	発赤	筋短縮症
神経症性うつ病	抑うつ神経症	乳児偽白血病
右浸潤影	胸部異常陰影	意識消失
四肢近位筋筋力低下	筋力低下	間代強直性痙攣
左耳後部腫瘤	耳後部腫瘤	ＨＤＬＳ
右乳腺良性腫瘍	乳腺腫瘍	不安緊張状態
左尿管結石性腎盂腎炎	結石性腎盂腎炎	残胃癌
イレウス気味	偽性イレウス	急性胃腸障害
筋力低下可能性	筋力低下	足壊疽
咽喉頭違和感	咽喉頭異常感症	出血
前立腺癌死	前立腺癌	Ｂ群溶連菌感染症
再度皮疹	発疹	聴神経腫瘍
左肩腱板損傷	肩腱板損傷	肩関節亜脱臼
低形成	骨髄低形成	精巣上体炎
再脱臼	脱臼	ＶＩＰ産生腫瘍
左肺動脈狭窄症	肺動脈狭窄症	ＣＡＲＡＳＩＬ
肺動脈弁上狭窄	肺動脈弁上狭窄症	下肺野陰影
後頸部発赤	発赤	胸水検査異常
血管原性浮腫	浮腫	２型自己免疫性膵炎
偽粘液腫	粘液腫	純型肺動脈弁閉鎖症
毛包向性菌状息肉症	菌状息肉症	シャイ・ドレーガー症候群
Ｂｌｕｅ　ｔｏｅ　ｓｙｎｄｒｏｍｅ	末梢動脈疾患	熱疲労
嚢胞様腫瘤像	腫瘤	結核
右足不随意運動	不随意運動症	発赤
婦人科癌	癌	四肢白癬
両側眼振	眼振	人工骨頭破損
爪水虫	爪白癬	歩行困難
子宮体癌Ｉａ期	子宮体癌	胆のう管破裂
過活動型せん妄	せん妄	外傷性脊椎症
左下肢鬱滞性皮膚炎	うっ滞性皮膚炎	肋骨部打撲
ＢＰＳＤ	認知症に重なったせん妄	腓腹筋痛
進行性核上麻痺	進行性核上性麻痺	慢性微熱
汎発性水痘感染症	水痘	クッシング症候群
えん下障害	嚥下障害	視力障害
左上腕悪性黒色腫	上腕部悪性黒色腫	尾骨骨折
左側頭葉挫傷	脳挫傷	腎機能低下
虚血性肝炎	肝炎	上肢筋萎縮
重症敗血症	敗血症	背部痛
幽門前部狭窄	幽門狭窄症	発赤
圧迫移植部ネクローシス	壊死	急性湿疹
子宮頸癌子宮頚癌	子宮頚癌	腎結石症
舌乾燥	口腔乾燥症	白内障
足痛い	足痛	高ＩｇＤ血症
円形紅斑	紅斑症	ＣＡＤＡＳＩＬ
左眼後発性白内障	白内障	形質細胞腫
徐脈気味	徐脈	陰茎部疼痛
境界性パーソナリティ障害	境界型パーソナリティ障害	適応障害
鼻骨折	鼻骨骨折	斑状皮疹
膵尾部腫瘤性病変	膵腫瘤	下肢痙攣
重症腸炎	腸炎	下肢麻痺
左大腿骨転子下骨折	転子下骨折	夜間低血糖症
左低形成腎	低形成腎	足関節炎
肺野すりガラス状陰影	肺野異常陰影	双線弧線装置破損
アテローム性血栓性脳梗塞	血栓性脳梗塞	眼瞼乾皮症
結腸癌肝転移	転移性肝癌	胃体部癌
診察時皮疹	発疹	肺門部非小細胞癌
切開関連性心房粗動	心房粗動	呼吸困難
硬性白斑	白斑	膵体尾部腫瘍
術後不整脈	不整脈	炭疽敗血症
広範囲脊柱管狭窄症	広範脊柱管狭窄症	腟スメア細胞診陽性
中～低分化肝細胞癌	肝細胞癌	呼吸困難
起床時咳嗽	咳	充実性偽乳頭状腫瘍
腰骨骨折	腰椎骨折	前房出血
血性腹水貯留	腹水症	良性腎硬化症
心理的不安	不安障害	下葉非小細胞肺癌
カンジダ肺炎	肺カンジダ症	術後胆管狭窄
右小細胞癌	小細胞肺癌	不定愁訴症
頬部悪性腫瘍	頬部腫瘍	腹部圧痛
多源性ＰＶＣ散発	心室期外収縮	単純型表皮水疱症
原発性甲状腺機能低下	甲状腺機能低下症	脳梁形成不全
ヨードアレルギー	ヨード過敏症	腸骨軟骨肉腫
右ＩＣ動脈瘤	内頚動脈脳動脈瘤	アルコール離脱状態
顔面形成	顔面形成異常	下葉肺癌
活動性肝炎	肝炎	悪性脊髄髄膜腫
インフルエンザ陽性	インフルエンザ	術後性反回神経麻痺
眼球結膜浮腫	結膜浮腫	乳腺線維腫
排便なし	便秘症	肝癌骨転移
全身性Ｃａｎｄｉｄａ感染症	カンジダ症	両側性反回神経麻痺
顔面神経痛	三叉神経痛	脳悪性リンパ腫
多発肺膿瘍	肺膿瘍	大腸血管腫
疣贅様構造物	疣贅	化膿性疣贅
アルコ−ル性肝硬変	肝硬変症	僧帽弁狭窄症
皮質層状壊死	壊死	直腸皮膚瘻
発熱随伴症状	発熱	低アルドステロン症
急性肺動脈血栓塞栓症	肺動脈血栓塞栓症	続発性高尿酸血症
両下肢深部静脈血栓症	下肢静脈血栓症	狭心症３枝病変
右上腕骨近位端骨折	上腕骨近位端骨折	内転歩行
脳炎脳症	脳症	下肢浮腫
辺縁性脳炎	脳炎	糖尿病網膜症
易疲労性強い	易疲労感	マイコプラズマ感染症
せん妄生	せん妄	母趾痛
右第３趾爪囲炎	爪囲炎	低形成腎
多発縦隔リンパ節転移	縦隔リンパ節転移	多飲症
家族性ＣＪＤ	家族性クロイツフェルト・ヤコブ病	糖尿病性潰瘍
圧迫時疼痛	疼痛	単純型表皮水疱症
症型Ａ群溶連菌感染症	溶連菌感染症	発声障害
末梢肺動脈塞栓症	動脈塞栓症	総排泄腔外反症
歩容困難	歩行障害	Ｅｕｔｈｙｒｏｉｄ　Ｓｉｃｋ症候群
脳室出血	出血	大動脈弁狭窄症
顔面痺れ	しびれ感	小細胞肺癌
尿失禁状態	尿失禁症	眼窩腫瘍
重度失調性構音障害	構音障害	解離性動脈瘤
卵巣癌Ⅲｃ期	卵巣癌	気管支喘息発作
低血糖鞘状	低血糖	ＡＩＤＳ
発赤潰瘍	発赤	日本紅斑熱
左下肺浸潤影	肺部異常陰影	鼻腔内びらん
右大脳動脈未破裂動脈瘤	脳動脈瘤	卵巣腫瘍
失語正常	失語症	脛骨腓骨開放骨折
先週頭痛	頭痛	網膜静脈分枝閉塞症
ｃｅｌｌ　ｌｅｕｋｅｍｉａ	白血病	小脳橋角部腫瘍
失語持続	失語症	先天性のう胞肺
ＧＣＡ	巨細胞動脈炎	下腿発赤
大動脈弁硬化症	大動脈弁狭窄症	腹水症
多発筋炎	多発性筋炎	急性骨髄性白血病
呼吸促迫症状	呼吸促迫	関節リウマチ・膝関節
大腿骨骨頭壊死	大腿骨頭壊死	高血圧症
呼気喘鳴	喘鳴	ポリープ
サイトメガロ網膜炎	サイトメガロウイルス網膜炎	単純性便秘
ＡＣＴＨ非依存性Ｃｕｓｈｉｎｇ症候群	クッシング症候群	食道未分化癌
次週左気胸	気胸	運動誘発性喘息
内分泌機能不全	内分泌機能異常	家族性高リポ蛋白血症２ｂ型
熱	発熱	上腸間膜動脈解離
Ｍａｌｌｏｒｙ−Ｗｅｉｓｓ症候群	マロリ・ワイス症候群	上肢浮腫
軽度音声障害	音声障害	外耳炎
緑膿菌腸炎	緑膿菌性腸炎	転移性肝腫瘍
ドレーン出血	出血	ＭＲＣＮＳ感染症
副鼻腔転移	副鼻腔癌	大腿部腫脹
原発不明癌頸部転移	原発不明癌	仮性膵のう胞
発熱中	発熱	大腿骨外顆骨折
再発腫瘤	腫瘤	結核腫
右錐体路障害	錐体路障害	ＨＣＡＨＣ
犬吠様咳嗽	咳	血性胸水
両下肢筋痛	下肢筋肉痛	小細胞肺癌
左室ブロック波形	心電図異常	膀胱腸瘻
有痛性腫瘤	腫瘤	神経細胞腫瘍
難治性冠攣縮性狭心症	冠攣縮性狭心症	増殖性網膜症
起床時頭痛	頭痛	足痛
Ⅱ型房室ブロック	房室ブロック	心室内血栓症
眼白内障	白内障	前頭部痛
慢性下気道感染	急性気管支炎	重症急性膵炎
乳頭様腎盂腫瘍	腎盂乳頭状癌	脱出性内痔核
喀痰付着	喀痰	肺未分化癌
両側下腿潰瘍	下腿皮膚潰瘍	急性小脳性失調症
心肺停止後蘇生	心肺停止	細菌感染症
ＳＣＤ	脊髄小脳変性症	出血傾向
無症候性腸アメーバ症	腸アメーバ症	上葉非小細胞肺癌
手首痛	手部痛	慢性疼痛
頸部食道癌	頚部食道癌	ＭＲＣＮＳ敗血症
症候性てんかん発症	症候性てんかん	二次性糖尿病
左腎血管腫	腎血管腫	くも膜のう胞
地誌的失認	失認	胸部異常陰影
命令性幻聴	幻聴	紅色丘疹
子宮体癌Ⅱ期	子宮体癌	反射亢進
両側副腎腫瘍	副腎腫瘍	運動失行
左顔面神経麻痺症状	顔面神経麻痺	下肢痛
左顔面痛覚障害	片側痛覚鈍麻	口腔乾燥症
顎部痛	顎痛	新生児皮膚硬化症
元々疼痛	疼痛	急性網膜壊死
粘膿性鼻汁	鼻汁	脊柱管狭窄症
膣原発横紋筋肉腫	横紋筋肉腫	発赤
卵巣嚢腫ＯＰ	卵巣のう腫	手指腫脹
遅発性ペースメーカー感染症	ペースメーカ植え込み後感染症	アレルギー
子宮筋肉腫	子宮肉腫	多発性のう胞腎
肺血管陰影増強	肺血管疾患	サルモネラ感染症
頭頸部放線菌症	放線菌症	共通房室口
腎機能障害	腎機能低下	椎骨脳底動脈循環不全
Ｈｏｄｇｋｉｎ　Ｌｙｍｐｈｏｍａ	ホジキンリンパ腫	遺残性頚動脈脳底動脈吻合
冠動脈−肺動脈瘻	肺動脈瘻	過換気症
嚥下時疼痛	嚥下痛	多発性肝のう胞
術後創感染	術後膿瘍	股関節症
大腸ポリープ後	大腸ポリープ	特発性腎出血
右下葉扁平上皮癌	下葉肺扁平上皮癌	噴門狭窄
咳嗽法	咳	胃進行癌
高リスク前立腺癌	前立腺癌	臼蓋形成不全
門脈圧亢進	門脈圧亢進症	視野欠損
認知面低下	軽度認知障害	内出血
ノカルジア	ノカルジア症	扁桃腫瘍
右人工膝関節感染	人工膝関節感染	空気飢餓感
膿梗塞	脳梗塞	遺伝性脳腫瘍
下大静脈狭窄	大静脈狭窄症	ジベルばら色粃糠疹
十二指腸穿通性潰瘍	穿通性十二指腸潰瘍	中皮腫
左横隔膜弛緩症	横隔膜弛緩症	鼡径部腫脹
火傷	熱傷	ビッカースタッフ脳幹脳炎
入眠困難感	不眠症	子宮頚部びらん
非定型カルチノイド腫瘍	カルチノイド	転移性縦隔腫瘍
軽度食欲低下	食欲不振	異物肉芽腫
尿管結石有	尿管結石症	神経症性抑うつ状態
両下腿壊疽性膿皮症様潰瘍	膿皮症	鼻涙管閉鎖症
冠攣縮型狭心症	冠攣縮性狭心症	刺虫アレルギー
恥骨骨髄炎	骨髄炎	肺野円形陰影
かすみ目	視力低下	そう痒
眩暈消失	めまい	頭部皮下血腫
手指関節腫脹	関節炎	動脈狭窄
ＳＰＮ	充実性偽乳頭状腫瘍	運動ニューロン疾患
夜間嘔気	嘔気	濾胞性甲状腺腺腫
左足背発赤	下腿発赤	腎明細胞肉腫
女性器クラミジア感染症	クラミジア感染症	好酸球増加症
血液凝固障害	血液凝固異常	急性小脳性失調症
慢性的な呼吸困難	呼吸困難	上葉無気肺
右肺下葉肺炎	肺炎	胸痛
低酸素虚血性脳症	低酸素性脳症	連合弁膜症
左大葉性肺炎	大葉性肺炎	高血糖症
膵臓癌術後再発	膵癌	覚醒剤依存症
足底湿疹	足湿疹	慢性滲出性中耳炎
歩行ふらつき	めまい	甲状腺腫
結腸縫合不全	縫合不全	多量出血
多発肝血管腫	多発性肝血管腫	尿管癌
紅色腫瘤	腫瘤	急性呼吸窮迫症候群
気管支閉鎖症	気管支閉鎖	胸壁腫瘍
神経アミロイドーシス	アミロイドーシス	耳下部痛
夜疼痛	疼痛	環指膿瘍
咽頭粘膜発赤	発赤	慢性疼痛
時々不整脈	不整脈	鼻腔腫瘍
多発性リンパ節転移	多部位リンパ節転移	心室性二段脈
新生児死亡	原因不明の死亡	縦隔リンパ節腫脹
最近花粉症	花粉症	ガス壊疽
食道空腸吻合部狭窄	吻合部狭窄	肝腫瘍
クリオグロブリン性血管炎	クリオグロブリン血症性血管炎	仙骨部褥瘡
右頬部擦過傷	頬部擦過創	副腎出血
右肺下葉癌	下葉肺癌	血性胸水
腎結石多発	腎結石症	腰椎すべり症
ＥＢウイルス初感染	ＥＢウイルス感染症	筋肉痛
外表奇形	奇形	発作性上室頻拍
急性膵臓炎	急性膵炎	腹腔内膿瘍
Ｉｓｐポリープ	大腸ポリープ	転移性肝腫瘍
咽頭部発赤	発赤	下肢麻痺
頭部腫瘍	頭部皮下腫瘍	多発性皮下腫瘤
遅発性発疹	発疹	行動緩慢
肺炎悪化	肺炎	大動脈弁弁膜症
朝痰	喀痰	多発性小脳梗塞
子宮体癌Ⅳ期	子宮体癌	ＭＥＬＡＳ症候群
骨外腫瘤形成	腫瘤	女性化乳房症
低悪性度Ｂ細胞性リンパ腫	びまん性大細胞型Ｂ細胞性リンパ腫	脳挫傷
視神経脊髄炎（ＮＭＯ）	視神経脊髄炎	そう痒
左下副甲状腺腺腫	副甲状腺腺腫	慢性感染性貧血
単形性ＶＴ	非持続性心室頻拍	特発性大腿骨内顆骨壊死
特発性心室細動	心室細動	気管支喘息
高脂血症高脂血症	高脂血症	下腿痛
白色調腫瘍	腫瘍	膝関節痛
左頬部有棘細胞癌	頬部有棘細胞癌	帯状疱疹
Ｇｏｔｔｒｏｎ徴候	ゴットロン丘疹	脾悪性リンパ腫
脊柱起立筋膿瘍	筋膿瘍	肺未分化癌
左踵骨骨折	踵骨骨折	踵部悪性黒色腫
胃癌幽門狭窄	幽門狭窄症	Ｃ型肝硬変
拡張能障害	心不全	脊索腫
小腸静脈瘤破裂	食道静脈瘤破裂	Ｅｕｔｈｙｒｏｉｄ　Ｓｉｃｋ症候群
右上肢振戦	一側上肢振戦	周期性浮腫
中枢性甲状腺機能低下症	甲状腺機能低下症	脳室内出血
左肺動脈閉塞	肺動脈狭窄症	脳血管障害性パーキンソン症候群
単純性網膜症	網膜症	側頭葉膠芽腫
両眼性複視	複視	慢性顎骨骨髄炎
Ｈｅｎｏｃｈ−Ｓｃｈｏｎｌｅｉｎ紫斑病	ＩｇＡ血管炎	未破裂脳動脈瘤
右胸腔内腫瘍	腫瘍	腫瘤
尿もれ	尿失禁症	幻覚
下肢筋力低下自覚	筋力低下	難治性腹水
右足静脈瘤	静脈瘤	下肢皮膚潰瘍
上気道浮腫	咽頭浮腫	ざんごう足
複雑型熱性痙攣	熱性痙攣	皮下結節
吻合部浮腫	浮腫	Ｂ型肝硬変
右膀胱側壁部膀胱癌	膀胱側壁部膀胱癌	声帯ポリープ
Ｃａｐｎｏｃｙｔｏｐｈａｇａ　ｃａｎｉｍｏｒｓｕｓ感染症	グラム陰性菌感染症	下痢症
子宮頸部頸管狭窄	子宮頚管狭窄症	脳悪性リンパ腫
呼吸喘鳴	喘鳴	網膜中心動脈閉塞症
口腔内乾燥	口腔乾燥症	肥満症
脊椎管狭窄症	脊柱管狭窄症	骨髄増殖性疾患
ヘルペス髄膜炎	髄膜炎	多指症
左股関節破壊	股関節症	腹膜癒着
左前庭障害	前庭障害	眼球偏位
膠原繊維性腸炎	腸炎	頭痛
食道期軽度障害	嚥下障害	不規則睡眠
右外腸骨静脈狭窄	静脈狭窄	顎下腺多形腺腫
妊娠発覚	妊娠	縦隔腫瘍
両膝関節症	膝関節症	関節リウマチ
類もやもや病	もやもや病	頭痛
呼内疾患ベース肺炎	肺炎	ポリープ
左足関節開放性脱臼骨折	足関節開放性脱臼骨折	原発性胆汁性胆管炎
白色粘性痰	喀痰	下腿皮膚潰瘍
食道癌２病変	食道癌	口腔乾燥症
右卵巣奇形腫	卵巣奇形腫	好酸球増加症
感冒罹患	感冒	ＱＴ短縮症候群
血腫像	血腫	ヘルペス脳炎
ｌｙｍｐｈｏｍａ	悪性リンパ腫	気管支狭窄症
左足首骨折	足関節骨折	膵漿液性のう胞腫瘍
慢性血栓性肺高血圧症	慢性血栓塞栓性肺高血圧症	小脳動脈狭窄
眼振誘発	眼振	先天性蜂巣状肺
急性ウイルス性脳炎	ウイルス性脳炎	慢性疼痛
掻痒等	そう痒	下痢症
労作時呼吸困難感軽度	労作時呼吸困難	頚部転移性腫瘍
逆流性食道炎症状	逆流性食道炎	ＡＬＫ融合遺伝子陽性非小細胞肺癌
非代償性Ｃ型肝硬変	Ｃ型非代償性肝硬変	左心不全
子宮筋腫大	子宮筋腫	肝機能障害
ヘルペス感染症	ヘルペスウイルス感染症	ＶＡＴＥＲ症候群
抑うつあり	うつ状態	上肢痛
出血腫脹	出血	甲状腺乳頭癌
急性感音性難聴	感音難聴	ピーナッツアレルギー
肺塞栓既往	肺塞栓症	胸骨周囲炎
リンパ節多発転移	多部位リンパ節転移	無気肺
ｉｎｖａｓｉｖｅ　ｔｈｙｍｏｍａ	悪性胸腺腫	吻合部狭窄
イレウスリスク高い	イレウス	リンパ浮腫
左肺下葉扁平上皮癌	下葉肺扁平上皮癌	洞不全症候群
分類不能型免疫不全	免疫不全	閉塞性動脈硬化症
高度拘束性換気障害	拘束性換気障害	胆道閉鎖症
非典型的胸痛	胸痛	末梢前庭障害
ＭＲＳＡ感染	ＭＲＳＡ感染症	上皮性顎骨のう胞
肝多発腫瘤	肝腫瘤	慢性咳嗽
左大腿骨病的骨折	大腿骨病的骨折	誤嚥性肺炎
Ｓ状結腸癌術後肝転移	転移性肝癌	声門浮腫
棘波	心電図異常	ＭＲＳＡ腸炎
黄色痰自己喀出	膿性痰	ケトン性低血糖症
心膜腔内播種	転移性心腫瘍	椎骨動脈瘤
耳痛	耳痛症	腹部圧痛
四肢末端しびれ	しびれ感	脂質異常症
内頸動脈狭窄	内頚動脈狭窄症	ＨＴＬＶ−１感染症
胃部分壊死	壊死	腰殿部痛
転倒受傷	外傷	粉瘤
左急性感音難聴	感音難聴	顔面骨骨折
タール便少量	黒色便	大動脈弁狭窄症
切除不能胃癌	胃癌	下顎骨骨折
後頭葉脳出血	脳出血	認知症
隅角結節	虹彩結節	慢性腎臓病
落ち着かなさ	多動性障害	腹壁下血腫
脊椎多発圧迫骨折	圧迫骨折	逆向性健忘
左傍脊柱筋膿瘍	筋膿瘍	放線菌症性敗血症
Ⅰ型ＤＭ	糖尿病	ＭＲＳＡ敗血症
多発ＬＮ転移	多部位リンパ節転移	反復性胸痛
右角膜ヘルペス	ヘルペス角膜炎	ＡＶＭ
大腸粘膜癌	癌	鎖骨下動脈閉塞症
大動脈損傷	上大動脈損傷	スルーダー神経痛
仙骨前腫瘤	腫瘤	無機能腎
前頭葉脳出血	脳出血	突発性発熱
社会不安症	不安神経症	後天性後鼻孔狭窄
左頚部食道傍リンパ節転移	リンパ節転移	湿疹
時折物忘れ	健忘症	腹水症
左頬部未分化腺癌	癌	多剤耐性腸球菌感染症
ＩＩ型ＤＭ	２型糖尿病	子宮頚管上皮内癌
脊椎管狭窄	脊柱管狭窄症	上腕骨骨髄炎
膨満　グル音正常	腹部膨満	心原性ショック
顔面神経麻痺静的再建	顔面神経麻痺	陰茎びらん
低分化性扁平上皮癌	癌	尿閉
左房内粘液腫	心臓粘液腫	嘔気
重症うつ病	うつ病	肺胞出血
左肺下葉浸潤影	胸部異常陰影	乳腺線維腫
中葉舌区症候群	中葉無気肺	化膿性関節炎・胸鎖関節
膵管炎	膵炎	２型糖尿病
軟部組織腫瘤	腫瘤	卵巣悪性腫瘍
腫瘤構造	腫瘤	腸間膜リンパ節腫脹
慢性誤嚥	嚥下障害	異常腹水
Ｇｍ敗血症	敗血症	多量出血
右大腿部蜂窩織炎	大腿部蜂巣炎	多発性ラクナ梗塞
病的腹水	腹水症	蛋白漏出性胃腸症
慢性疲労	疲労感	上腕骨粉砕骨折
膿性喀痰	膿性痰	大葉性肺炎
Ｃｈｏｌｅｄｏｃｈｏｃｅｌｅ	総胆管のう腫	胸部不快感
癌再発	癌	髄膜炎
胆汁うっ滞型	胆汁うっ滞	肛門部びらん
肺門腫瘤	縦隔腫瘍	放射線皮膚炎
両膝関節疼痛	膝関節痛	腸アメーバ症
右鎖骨転移	骨転移癌	直腸穿孔
緑内症	緑内障	正球性正色素性貧血
夕方痛み	疼痛	前立腺上皮内腫瘍
左側副部痛	側腹部痛	分水界梗塞
後腹膜腫瘍上行結腸浸潤	後腹膜腫瘍	ＰＣＷＨ
心窩部自発痛	心窩部痛	骨盤転移
リンパ節腫大傾向	リンパ節腫大	下大静脈血栓症
時々尿失禁	尿失禁症	睡眠障害
左臀部悪性軟部腫瘍	殿部悪性軟部腫瘍	慢性遊走性紅斑
低血糖遷延	低血糖	頚椎症性神経根症
右中大脳動脈閉塞症	中大脳動脈閉塞症	大腿腫瘍
重症ＣＭＶ腸炎	サイトメガロウイルス腸炎	胃腸奇形
発熱コントロール	発熱	眼精疲労
右下腿蜂窩織炎	下腿蜂巣炎	顔面浮腫
膿瘍形成	膿瘍	持続熱
右尿管損傷	尿管損傷	脳虚血症
感染性心内膜症	感染性心内膜炎	乾性角結膜炎
ブドウ球菌検出	ぶどう球菌感染症	内頚動脈閉塞症
副腎皮質機能不全	副腎皮質機能低下症	脊髄小脳変性症
Ｅｓｃｈｅｒｉｃｈｉａ　ｃｏｌｉ	大腸菌感染症	夢遊症
両側網膜剥離	網膜剥離	骨盤内良性軟部腫瘍
播種性血管内凝固症	播種性血管内凝固	夏期熱
肺野肺門部異常陰影	肺門部異常陰影	不規則睡眠
右房浸潤	乳房悪性腫瘍	肺動脈狭窄症
屈筋腱鞘炎	腱鞘炎	書字障害
肺結節陰影	胸部異常陰影	多形紅斑
呼吸困難感等自覚症状	呼吸困難	ウイルス性肺炎
原発性肺腫瘍	肺腫瘍	脊髄脂肪髄膜瘤
右下腿コンパートメント症候群	下腿コンパートメント症候群	パルボウイルス感染症
右鎖骨上窩リンパ節腫大	鎖骨上リンパ節腫脹	前立腺肥大症
右鼡径部腫脹	鼡径部腫脹	気分異常
低悪性度リンパ腫	ホジキンリンパ腫	下腿皮膚潰瘍
右側胸部皮下結節	皮下結節	関節リウマチ・肘関節
両側卵巣チョコレート嚢胞	チョコレートのう胞	脳塞栓症
回盲部悪性リンパ腫	悪性リンパ腫	倦怠感
陰部腫脹	陰のう腫大	胞状腺腫
腹水浸出	腹水症	クラミジア感染症
ＴＡＡ	胸部大動脈瘤	リンパ性白血病
腸管皮膚瘻	腸瘻	錐体外路系疾患
ライン感染	カテーテル感染症	再発卵巣癌
多発擦過傷	擦過創	急性疼痛
脂質異常	脂質異常症	膀胱尿管逆流
肺嚢胞感染	肺のう胞	腫瘍
Ｃｈｕｒｇ−Ｓｔｒａｕｓｓ　症候群	好酸球性多発血管炎性肉芽腫症	甲状腺未分化癌
脾結核	結核	マラセチア毛包炎
潰瘍性大腸炎急性増悪	潰瘍性大腸炎	麻疹
肺抗酸菌感染症	肺非結核性抗酸菌症	肩関節前方亜脱臼
２型大腸癌	大腸癌	急性肺クリプトコッカス症
両眼網膜症	網膜症	抗アレルギー薬中毒
左眼結膜炎	結膜炎	頬部痛
右肺原発腺癌	肺腺癌	骨盤子宮内膜症
ＣＲＥＳＴ症候群	クレスト症候群	人工気胸
感覚神経障害	知覚障害	先天性蜂巣状肺
物忘れ	健忘症	腹膜播種
脳筋症	ミトコンドリア脳筋症	歯痛
駆細胞型急性リンパ性白血病再発	急性リンパ性白血病	肺血栓塞栓症
左大腿骨骨腫瘍	大腿骨腫瘍	回盲部憩室炎
膿瘍縮小	膿瘍	夜間頻尿症
右後頭葉塞栓性脳梗塞	塞栓性脳梗塞	ＨＤＬＳ
肝内転移	転移性肝腫瘍	睡眠薬依存
膵管内乳頭粘液腫瘍	膵管内乳頭粘液性腫瘍	大腿骨転子部骨折
胃癌多発骨転移	胃癌骨転移	白斑
僧房弁疣贅	疣贅	項部痛
左膝窩動脈瘤	膝窩動脈瘤	症状精神病
腹部背部痛	背部痛	下肢の動脈瘤
アルコール性ニューロパチー	アルコール性多発ニューロパチー	直腸損傷
体幹部発赤	発赤	海綿状血管腫
慢性突発性血小板減少性紫斑病	血小板減少性紫斑病	動眼神経麻痺
下部消化管穿孔	腸穿孔	結節性紅斑
Ｔ字杖歩行可能	歩行障害	脊髄損傷
鎖骨上リンパ節腫大	鎖骨上リンパ節腫脹	骨腫瘤
右大腿ヘルニア嵌頓	大腿ヘルニア嵌頓	食道癌
大腫瘤影	腫瘤	趾皮膚潰瘍
双極２型障害	２型双極性障害	足部変形
感染性腹部動脈瘤	感染性腹部大動脈瘤	足部絞扼性神経障害
ヘルペス性脳炎	サル痘	ＨＤＬＳ
不安症様	不安神経症	顎変形症
右前額部痛	前頭部痛	ＡＩＤＳ
右胸膜播種	胸膜播種	肩部痛
骨折病変	骨折	前糖尿病
半月体形成糸球体腎炎	半月体形成性糸球体腎炎	鉄色素沈着
筋力低下著明	筋力低下	転移性肝癌
下肢骨折	骨折	多形紅斑
付属器圧痛	圧痛	感染後尿道狭窄
アスピリンアレルギー	アスピリン不耐症	心原性小脳梗塞
固形腫瘍	腫瘍	メサンギウム増殖性糸球体腎炎
嘔吐出現	嘔吐症	慢性膿皮症
統合失調症残遺状態	統合失調症	１型糖尿病性腎症第１期
右上肢不全片麻痺	不全片麻痺	後鼻漏
低血糖生	低血糖	くも膜下出血
劇症型肺炎球菌性敗血症	肺炎球菌性敗血症	胸髄神経根障害
左大腿蜂窩織炎	蜂窩織炎	下肢静脈血栓症
発熱有	発熱	巨大子宮筋腫
頭位性回転性めま	体位性めまい	眼窩悪性リンパ腫
不眠考	不眠症	寛骨臼骨折
全失語	全失語症	ＡＩＤＳ
口唇紅潮	紅潮	多形紅斑
開腹腫瘤	腫瘤	妊娠糖尿病
左尺骨神経障害	尺骨神経麻痺	感覚運動障害
外側部乳癌	乳癌	脊椎カリエス後遺症
脳幹部神経膠腫	脳幹神経膠腫	転移性肝腫瘍
両足関節以遠しびれ感	しびれ感	卵巣子宮内膜症のう胞
左再発性気胸	続発性気胸	胃食道逆流症
胃のむかつき	悪心	中耳炎
気管性喘息	気管支喘息	よろめき感
痒疹結節散在	痒疹	全身性浮腫
日中下痢	下痢症	行動緩慢
骨粗鬆症有	骨粗鬆症	ＣＡＤＡＳＩＬ
先天性胆管欠損	胆管先天奇形	手背部痛
左深部静脈血栓症	深部静脈血栓症	子宮頚管ポリープ
冠性Ｔ波	心電図異常	Ｘ連鎖無ガンマグロブリン血症
多発胸膜肥厚斑	胸膜肥厚	下部食道癌
カンジダ眼内炎	眼内炎	水疱性多形紅斑
副腎転移	転移性副腎腫瘍	大腿骨骨折
左緊張性気胸	緊張性気胸	直腸閉鎖
度腟壁裂傷	腟裂傷	気胸
仙骨部腫瘤	腫瘤	項部痛
帯状疱疹再燃	帯状疱疹	全身発疹
左前胸部腫瘤	前胸部腫瘤	鼡径部痛
喘息症状	咳喘息	体感消失
ふらつく気	よろめき歩行	大葉性肺炎
拡張障害型心不全	心不全	腰椎椎間板炎
アカシジア症状	錐体路障害	大腸ポリープ
間歇的腹痛	腹痛症	四肢浮腫
左肺舌区扁平上皮癌	肺扁平上皮癌	急性心筋梗塞後心室中隔穿孔
星状細胞腫	星細胞腫	頬部腫脹
急性腎障害	腎障害	下肢浮腫
左鎖骨上リンパ節腫脹	鎖骨上リンパ節腫脹	痙攣
陳旧性脳出血	脳出血	咽頭発赤
良性下垂体腫瘍	下垂体腫瘍	非浸潤性乳癌
腸雑音聴取可	異常腸音	陳旧性腰椎骨折
左側頭部帯状疱疹	帯状疱疹	膝窩部痛
左肺原発性肺癌	原発性肺癌	前房出血
頭蓋内出血性病変	非外傷性頭蓋内出血	腸管出血性大腸菌感染症
閉塞性睡眠呼吸障害	睡眠時無呼吸症候群	鼻副鼻腔腫瘍
右披裂部腫瘍	腫瘍	偽性イレウス
両膝変形	変形性膝関節症	眼角基底細胞癌
表在性腫瘍	腫瘍	再発性脳梗塞
左母指多指症	副母趾	足痛
両側側脳室軽度拡大	脳室拡大	ＡＩＤＳ
脈性右室心筋症	不整脈原性右室心筋症	口腔出血
アルコール性末梢神経障害	アルコール性多発ニューロパチー	鼻汁
縦隔炎併発	縦隔炎	顔面血管腫
暗紅色斑	紅斑症	嚥下痛
骨盤圧痛	骨盤痛	発赤
骨巨細胞腫瘍	骨巨細胞腫	腟癌
Ｌａｎｇｈａｎｓ巨細胞	ランゲルハンス細胞組織球症	上葉非小細胞肺癌
気管支喘息発症	気管支喘息	急性気管支炎
分葉状嚢胞性腫瘤	腫瘤	早発性黄疸
胆管拡張	胆管拡張症	代償性発汗
甲状腺肥大	甲状腺疾患	ＣＡＤＡＳＩＬ
患肢発赤	発赤	帯状疱疹
好中球浸潤	好中球増加症	抗癌剤漏出性皮膚障害
多房性腫瘤	腫瘤	Ｅｕｔｈｙｒｏｉｄ　Ｓｉｃｋ症候群
夜間不安	不安障害	膵炎
右上肢線状強皮症	線状強皮症	イレウス
左内耳障害	迷路障害	一側性反回神経麻痺
左耳介発赤	発赤	中心性漿液性網脈絡膜症
朝方倦怠感	倦怠感	小脳機能障害
後頚部脂肪腫	頚部脂肪腫	蛋白尿
副腎性クッシング症侯群	クッシング症候群	ＥＢウイルス感染症
混合性アルカローシス	アルカローシス	悪心
痛く	疼痛	肺門部異常陰影
皮疹再燃	発疹	肺扁平上皮癌
再発悪性リンパ腫	悪性リンパ腫	無動性無言症
子宮筋腫手術	子宮筋腫	肺水腫
時折心窩部痛	心窩部痛	多発性肝膿瘍
右足根骨骨折	足根骨骨折	脱髄疾患
腕頭静脈血栓症	静脈血栓症	急性膵炎
脊椎病変	脊椎異常	レム睡眠行動障害
歯状核	歯状核赤核淡蒼球ルイ体萎縮症	発赤
右脛骨骨幹部骨折	脛骨骨幹部骨折	鼻咽頭浮腫
両側腎盂軽度拡張	腎盂拡張	非感染性大腸炎
軽度屈曲拘縮	屈曲拘縮	大腿骨顆上骨折
左下肺野陰影	下肺野陰影	皮膚壊死
ＥＢＶ腸炎	細菌性腸炎	皮膚Ｔ細胞リンパ腫
左側舌癌	舌癌	過剰喀痰
足しびれ	下肢しびれ	ウェンケバッハ型第２度房室ブロック
膵内分泌腫瘍肝転移	転移性肝癌	副腎神経芽腫